of	of
to	että
in	sisään
for	varten
is	on
on	päällä
that	että
by	mennessä
this	Tämä
with	kanssa
i	minä
you	sinä
it	se
or	tai
be	olla
are	olemme
at	at
all	kaikki
have	omistaa
new	Uusi
we	me
will	tahtoa
home	Koti
us	meille
about	noin
if	jos
page	sivu
my	minun
has	on
search	Hae
free	vapaa
but	mutta
our	meidän
one	yksi
other	muut
do	tehdä
information	tiedot
time	aika
he	hän
which	joka
their	heidän
news	uutiset
use	käyttää
there	siellä
see	nähdä
so	niin
who	Kuka
web	verkko
also	myös
get	saada
pm	pm
view	näkymä
c	C
e	e
first	ensimmäinen
been	ollut
would	olisi
were	olivat
s	s
like	Kuten
x	x
than	kuin
find	löytö
price	hinta
back	takaisin
top	ylin
people	ihmiset
had	oli
list	lista
name	nimi
just	vain
year	vuosi
day	päivä
into	osaksi
two	kaksi
health	terveys
n	n
re	re
used	käytetty
go	mennä
b	b
last	kestää
make	tehdä
them	niitä
should	pitäisi
product	tuote
system	järjestelmä
post	lähettää
her	hänen
city	kaupunki
t	T
policy	politiikka
number	määrä
support	tuki
message	viesti
after	jälkeen
then	sitten
jan	tammikuu
good	hyvä
d	d
where	missä
info	tiedot
rights	oikeudet
books	kirjat
high	korkea
school	koulu
m	m
each	kukin
links	linkit
she	hän
years	vuotta
order	tilata
very	erittäin
book	kirja
items	kohdetta
company	yhtiö
r	R
read	lukea
group	ryhmä
sex	sukupuoli
many	monet
user	käyttäjä
de	de
set	sarja
general	yleinen
research	tutkimus
university	yliopisto
january	tammikuu
mail	posti
full	koko
reviews	arvostelut
program	ohjelmoida
know	tietää
games	pelit
way	tapa
days	päivää
p	p
part	osa
could	voisi
great	loistava
united	yhdistynyt
real	todellinen
f	f
international	kansainvälinen
center	keskusta
travel	matkustaa
comments	kommentit
made	tehty
development	kehitys
report	raportti
member	jäsen
details	yksityiskohdat
line	linja
terms	ehdot
before	ennen
hotels	hotellit
did	teki
send	lähettää
right	oikea
type	tyyppi
local	paikallinen
those	nuo
results	tulokset
office	toimisto
national	kansallinen
car	auto
design	design
take	ottaa
posted	lähetetty
address	osoite
community	Yhteisö
within	sisällä
states	valtiot
want	haluta
phone	puhelin
dvd	DVD
subject	aihe
between	välillä
forum	foorumi
family	perhe
l	l
long	pitkä
w	w
show	show
o	O
even	jopa
black	musta
special	erityinen
index	indeksi
being	ollessa
women	naiset
much	paljon
sign	merkki
file	tiedosto
link	linkki
open	avata
south	etelä
case	tapaus
project	projekti
pages	sivut
version	versio
section	jakso
own	oma
house	talo
security	turvallisuus
g	g
county	lääni
american	amerikkalainen
photo	kuva
game	peli
members	jäsenet
power	teho
network	verkko
computer	tietokone
systems	järjestelmät
three	kolme
place	paikka
end	pää
h	h
him	häntä
per	kohti
access	pääsy
think	ajatella
north	pohjoinen
resources	voimavarat
current	nykyinen
big	iso
media	tiedotusvälineet
law	laki
control	ohjaus
water	vesi
history	historia
size	koko
personal	henkilökohtainen
guide	opas
shop	myymälä
directory	hakemisto
change	muuttaa
white	valkoinen
text	teksti
small	pieni
rating	luokitus
rate	nopeus
government	hallitus
children	lapset
return	palata
students	opiskelijoille
v	v
account	tili
times	ajat
level	taso
digital	digitaalinen
profile	profiili
previous	Edellinen
form	muoto
events	Tapahtumat
love	rakkaus
old	vanha
john	Johannes
main	tärkein
call	puhelu
image	kuva
department	osasto
title	otsikko
non	ei
k	K
y	y
insurance	vakuutus
shall	on
property	omaisuus
class	luokka
cd	CD
quality	laatu
every	joka
listing	listaus
content	pitoisuus
country	maa
little	vähän
tools	Työkalut
low	matala
reply	Vastaa
customer	asiakas
december	joulukuu
compare	vertailla
movies	elokuvat
college	college
value	arvo
article	artikla
man	mies
jobs	työpaikkaa
j	j
food	ruoka
author	kirjailija
different	eri
u	U
learn	oppia
sale	myynti
print	Tulosta
course	kurssi
job	Job
room	huone
stock	kalusto
training	koulutus
too	liian
credit	luotto
point	kohta
science	tiede
men	miehet
categories	luokat
west	länsi
look	Katso
english	Englanti
team	tiimi
estate	omaisuus
box	laatikko
conditions	olosuhteet
photos	Valokuvat
gay	homo
thread	lanka
category	kategoria
note	Huomautus
live	elää
large	suuri
gallery	galleria
table	pöytä
however	kuitenkin
june	kesäkuu
october	lokakuu
november	marraskuu
market	markkinoida
library	kirjasto
action	toiminta
start	alkaa
series	sarja
features	ominaisuudet
air	ilma
industry	ala
plan	suunnitelma
human	ihmisen
yes	Joo
second	toinen
hot	kuuma
cost	kustannus
movie	elokuva
forums	foorumit
march	maaliskuu
la	la
september	syyskuu
say	sanoa
going	menossa
medical	lääketieteellinen
friend	ystävä
dec	joulukuu
server	palvelin
application	hakemus
staff	henkilöstö
play	pelata
issues	kysymykset
april	huhtikuu
users	käyttäjät
street	katu
topic	aihe
against	vastaan
got	sai
blog	blogi
party	juhla
payment	maksu
equipment	laitteet
let	antaa
programs	ohjelmat
legal	oikeudellinen
recent	viimeaikainen
park	pysäköidä
act	toimia
problem	ongelma
red	punainen
give	antaa
memory	muisti
performance	esitys
social	sosiaalinen
q	q
story	tarina
sell	myydä
options	vaihtoehtoja
experience	kokea
key	avain
body	ruumis
young	nuori
important	tärkeä
field	ala
few	harvat
east	itään
single	yksittäinen
ii	ii
age	ikä
club	klubi
example	esimerkki
girls	tytöt
z	z
road	tie
gift	lahja
question	kysymys
ca	ca
hard	kova
pay	maksaa
four	neljä
poker	pokeri
issue	ongelma
range	alue
building	rakennus
seller	myyjä
court	tuomioistuin
february	helmikuu
result	tulos
light	valo
write	kirjoittaa
war	sota
offer	tarjous
blue	sininen
groups	ryhmät
al	ai
easy	helppo
given	tietty
request	pyyntö
fax	faksi
china	Kiina
making	tehdä
picture	kuva
needs	tarpeisiin
possible	mahdollinen
month	kuukausi
major	suuri
star	tähti
future	tulevaisuus
space	tila
committee	komitea
hand	käsi
sun	aurinko
cards	kortit
london	Lontoo
meeting	tapaaminen
become	tulla
child	lapsi
keep	pitää
porn	porno
share	Jaa
similar	samankaltainen
garden	puutarha
schools	koulut
million	miljoona
added	lisättyä
reference	viite
companies	yritykset
baby	vauva
learning	oppiminen
energy	energia
run	juosta
delivery	toimitus
popular	suosittu
term	termi
film	elokuva
stories	tarinoita
put	laittaa
journal	päiväkirja
reports	raporttien
co	co
try	yrittää
images	kuvien
notice	ilmoitus
god	Jumala
original	alkuperäinen
head	pää
radio	radio
cell	solu
council	neuvosto
includes	sisältää
track	seurata
discussion	keskustelu
archive	arkisto
others	toiset
agreement	sopimus
format	muoto
society	yhteiskunta
months	kuukaudet
safety	turvallisuus
friends	ystävät
sure	varma
edition	painos
messages	viestien
marketing	markkinointi
tell	kertoa
association	yhdistys
provides	tarjoaa
fun	hauska
already	jo
green	vihreä
studies	opinnot
close	kiinni
common	yhteinen
specific	erityinen
several	useat
living	elävä
collection	kokoelma
called	nimeltään
short	lyhyt
arts	arts
lot	erä
ask	kysyä
limited	rajallinen
solutions	ratkaisut
director	johtaja
beach	ranta
past	menneisyys
natural	luonnollinen
electronics	elektroniikka
upon	päälle
period	aika
planning	suunnittelu
says	sanoo
official	virallinen
mar	maaliskuu
done	tehty
technical	tekninen
window	ikkuna
pro	ammattilainen
region	alue
island	saari
record	ennätys
direct	suoraan
conference	konferenssi
records	asiakirjat
st	st
district	piiri
calendar	kalenteri
costs	kustannukset
style	tyyli
statement	selvitys
miles	mailia
resource	resurssi
applications	sovellukset
document	asiakirja
word	sana
works	teokset
material	materiaali
bill	laskuttaa
written	kirjallinen
rules	säännöt
final	lopullinen
thing	asia
centre	keskusta
requirements	vaatimuksista
TRUE	TOTTA
minutes	minuutit
else	muu
mark	merkki
rock	rock
bad	huono
individual	yksilö
plus	plus
auto	auto
cover	peite
edit	muokata
together	yhdessä
videos	Videot
fast	nopeasti
function	toiminto
fact	tosiasia
getting	saada
global	maailmanlaajuinen
tech	teknologia
meet	tavata
far	pitkälle
economic	taloudellinen
en	fi
player	pelaaja
projects	hankkeet
amount	määrä
watch	katsella
included	Sisältää
feel	tuntea
bank	pankki
risk	riski
deals	tarjoukset
various	eri
words	sanat
production	tuotanto
commercial	kaupallinen
weight	paino
heart	sydän
treatment	hoito
points	pistettä
knowledge	tuntemus
magazine	aikakauslehti
error	virhe
camera	kamera
girl	tyttö
construction	rakentaminen
toys	lelut
registered	kirjattu
domain	verkkotunnuksen
methods	menetelmät
chapter	luku
protection	suojaus
policies	politiikkaa
wide	leveä
beauty	kauneus
manager	johtaja
india	Intia
position	asento
taken	otettu
sort	järjestellä
listings	listat
known	tunnettu
half	puoli
cases	tapauksissa
step	vaihe
engineering	tekniikka
simple	yksinkertainen
quick	nopea
license	lisenssi
lake	järvi
whole	koko
annual	vuotuinen
published	julkaistu
church	kirkko
method	menetelmä
active	aktiivinen
response	vastaus
figure	kuva
materials	tarvikkeet
enough	tarpeeksi
designed	suunnitellut
among	keskuudessa
death	kuolema
loss	menetys
face	kasvot
brand	brändi
discount	alennus
effects	tehosteet
created	luotu
standards	standardit
bit	bitti
political	poliittinen
kingdom	kuningaskunta
base	pohja
doing	tekemässä
loans	lainat
shoes	kengät
entry	merkintä
stay	pysyä
orders	tilaukset
availability	saatavuus
summary	yhteenveto
turn	vuoro
growth	kasvu
agency	toimisto
king	kuningas
european	eurooppalainen
activity	aktiviteetti
copy	kopio
western	Läntinen
force	pakottaa
employment	työllisyys
bay	lahti
river	joki
commission	komissio
package	paketti
seen	nähdään
players	pelaajat
engine	moottori
port	portti
album	albumi
regional	alueellinen
stop	Stop
started	aloitti
administration	antaminen
bar	baari
institute	instituutti
views	näkymät
double	kaksinkertainen
dog	koira
soon	pian
lines	linjat
electronic	elektroninen
benefits	hyötyjä
needed	tarvittu
printer	kirjoitin
condition	kunto
effective	tehokas
believe	uskoa
organization	organisaatio
effect	vaikutus
mind	mieli
selection	valinta
casino	kasino
pdf	PDF
tour	kiertue
cross	ylittää
hope	toivoa
corporation	yhtiö
wish	toive
solution	ratkaisu
mature	kypsä
role	rooli
weeks	viikkoa
certain	tietty
lower	alempi
necessary	välttämätön
union	liitto
mon	mon
com	com
particular	tietty
fine	hieno
hour	tunnin
gas	kaasu
skills	taidot
six	kuusi
bush	Puska
islands	saaret
advice	neuvot
career	ura
decision	päätös
leave	jättää
pre	pre
huge	valtava
woman	nainen
facilities	laitteisto
bid	tarjous
middle	keskimmäinen
cable	kaapeli
opportunities	mahdollisuudet
taking	ottaen
values	arvot
division	jako
coming	tuleva
object	esine
lesbian	lesbo
appropriate	sopiva
machine	kone
logo	logo
length	pituus
nice	kiva
score	pisteet
statistics	tilasto
client	asiakas
sample	näyte
investment	investointi
sent	lähetetty
shown	esitetty
christmas	joulu
culture	kulttuuri
flash	salama
ms	neiti
choice	valinta
courses	kurssit
consumer	kuluttaja
hi	Moi
foreign	ulkomainen
artist	taiteilija
furniture	huonekalut
channel	kanava
letter	kirje
mode	tila
phones	puhelimet
ideas	ideoita
structure	rakenne
degree	aste
contract	sopimus
super	Super
male	Uros
matter	asia
almost	melkein
located	sijaitsevat
multiple	moninkertainen
distribution	jakelu
editor	toimittaja
inn	majatalo
industrial	teollinen
potential	mahdollinen
song	laulu
los	los
fall	pudota
idea	ajatus
rooms	Huoneet
communications	viestintä
win	voittaa
primary	ensisijainen
cancer	syöpä
numbers	numerot
reason	syy
tool	työkalu
spring	kevät
foundation	perusta
answer	vastaus
voice	ääni
schedule	ajoittaa
documents	asiakirjat
purpose	tarkoitus
feature	ominaisuus
bed	sänky
comes	tulee
police	Poliisi
independent	itsenäinen
approach	lähestyä
brown	ruskea
physical	fyysinen
hill	mäki
maps	kartat
hold	pitää
ratings	luokitukset
happy	onnellinen
smith	seppä
developed	kehittyneillä
thank	kiittää
safe	turvallinen
unique	ainutlaatuinen
survey	tutkimus
prior	ennen
telephone	puhelin
sport	Urheilu
ready	valmis
animal	eläin
sources	lähteet
population	väestö
pa	pa
regular	säännöllinen
secure	turvallinen
operations	toiminnot
simply	yksinkertaisesti
evidence	näyttö
station	asema
understand	ymmärtää
option	vaihtoehto
valley	laakso
probably	todennäköisesti
sea	meri
publications	Julkaisut
improve	parantaa
connection	yhteys
publisher	kustantaja
hall	sali
anti	anti
networks	verkot
earth	maa
parents	vanhemmat
impact	vaikutus
transfer	siirtää
introduction	esittely
kitchen	keittiö
strong	vahva
wedding	häät
properties	ominaisuudet
hospital	sairaala
ground	maa
ship	alus
accommodation	majoitus
disease	tauti
excellent	erinomainen
perfect	täydellinen
hair	hiukset
opportunity	tilaisuus
kit	pakki
classic	klassikko
basis	perusta
command	komento
cities	kaupungit
express	ilmaista
award	myöntää
distance	etäisyys
tree	puu
assessment	arviointi
wall	seinä
involved	osallistuva
el	el
extra	ylimääräinen
especially	erityisesti
budget	talousarvio
guides	oppaita
success	menestys
maximum	enimmäismäärä
ma	äiti
operation	operaatio
existing	nykyinen
quite	melko
selected	valittu
boy	poika
restaurants	ravintolat
beautiful	kaunis
warning	Varoitus
locations	sijainnit
horse	hevonen
vote	äänestys
flowers	kukat
stars	tähdet
lists	luettelot
owner	omistaja
animals	eläimet
ways	tapoja
son	poika
providing	tarjoaminen
rule	sääntö
housing	kotelo
takes	kestää
bring	tuoda
catalog	luettelo
max	max
mother	äiti
authority	auktoriteetti
told	kertoi
programme	ohjelmoida
joined	liittyi
input	panos
strategy	strategia
feet	jalkaa
agent	agentti
valid	pätevä
modern	moderni
senior	vanhempi
sexy	seksikäs
teaching	opetus
door	ovi
grand	suuri
trial	oikeudenkäynti
units	yksiköt
cool	viileä
normal	normaali
enterprise	yritys
ships	laivat
entire	koko
positive	positiivinen
fitness	kunto
chinese	Kiinalainen
opinion	lausunto
football	jalkapallo
abstract	abstrakti
output	ulostulo
funds	varat
mr	Herra
likely	todennäköisesti
develop	kehittää
artists	Taiteilijat
alternative	vaihtoehto
responsibility	vastuu
java	Jaava
guest	vieras
publication	julkaisu
pass	kulkea
relations	suhteet
trust	luottamus
van	pakettiauto
contains	sisältää
multi	multi
republic	tasavalta
fees	palkkiot
components	komponentit
vacation	loma
century	vuosisata
academic	akateeminen
assistance	apu
completed	valmistunut
skin	iho
graphics	grafiikka
indian	intialainen
ring	rengas
grade	arvosana
mountain	vuori
organizations	organisaatioiden
filter	suodattaa
panel	paneeli
floor	lattia
buying	ostaminen
match	ottelu
proposed	ehdotettu
require	vaatia
boys	pojat
morning	aamu
allows	sallii
protein	proteiini
plant	kasvi
reported	raportoitu
hit	osuma
mm	mm
pool	pool
mini	mini
politics	politiikka
partner	kumppani
authors	kirjoittajat
boards	levyt
fish	kalastaa
membership	jäsenyys
mission	tehtävä
eye	silmä
string	jono
sense	tunne
modified	muokattu
released	julkaisi
stage	vaihe
internal	sisäinen
born	syntynyt
detailed	yksityiskohtainen
