of	of
to	että
in	sisään
for	varten
is	on
on	päällä
that	että
by	mennessä
this	Tämä
with	kanssa
i	minä
you	sinä
it	se
or	tai
be	olla
are	olemme
at	at
all	kaikki
have	omistaa
new	Uusi
we	me
will	tahtoa
home	Koti
us	meille
about	noin
if	jos
page	sivu
my	minun
has	on
search	Hae
free	vapaa
but	mutta
our	meidän
one	yksi
other	muut
do	tehdä
information	tiedot
time	aika
he	hän
which	joka
their	heidän
news	uutiset
use	käyttää
there	siellä
see	nähdä
so	niin
who	Kuka
web	verkko
also	myös
get	saada
pm	pm
view	näkymä
c	C
e	e
first	ensimmäinen
been	ollut
would	olisi
were	olivat
s	s
like	Kuten
x	x
than	kuin
find	löytö
price	hinta
back	takaisin
top	ylin
people	ihmiset
had	oli
list	lista
name	nimi
just	vain
year	vuosi
day	päivä
into	osaksi
two	kaksi
health	terveys
n	n
re	re
used	käytetty
go	mennä
b	b
last	kestää
make	tehdä
them	niitä
should	pitäisi
product	tuote
system	järjestelmä
post	lähettää
her	hänen
city	kaupunki
t	T
policy	politiikka
number	määrä
support	tuki
message	viesti
after	jälkeen
then	sitten
jan	tammikuu
good	hyvä
d	d
where	missä
info	tiedot
rights	oikeudet
books	kirjat
high	korkea
school	koulu
m	m
each	kukin
links	linkit
she	hän
years	vuotta
order	tilata
very	erittäin
book	kirja
items	kohdetta
company	yhtiö
r	R
read	lukea
group	ryhmä
sex	sukupuoli
many	monet
user	käyttäjä
de	de
set	sarja
general	yleinen
research	tutkimus
university	yliopisto
january	tammikuu
mail	posti
full	koko
reviews	arvostelut
program	ohjelmoida
know	tietää
games	pelit
way	tapa
days	päivää
p	p
part	osa
could	voisi
great	loistava
united	yhdistynyt
real	todellinen
f	f
international	kansainvälinen
center	keskusta
travel	matkustaa
comments	kommentit
made	tehty
development	kehitys
report	raportti
member	jäsen
details	yksityiskohdat
line	linja
terms	ehdot
before	ennen
hotels	hotellit
did	teki
send	lähettää
right	oikea
type	tyyppi
local	paikallinen
those	nuo
results	tulokset
office	toimisto
national	kansallinen
car	auto
design	design
take	ottaa
posted	lähetetty
address	osoite
community	Yhteisö
within	sisällä
states	valtiot
want	haluta
phone	puhelin
dvd	DVD
subject	aihe
between	välillä
forum	foorumi
family	perhe
l	l
long	pitkä
w	w
show	show
o	O
even	jopa
black	musta
special	erityinen
index	indeksi
being	ollessa
women	naiset
much	paljon
sign	merkki
file	tiedosto
link	linkki
open	avata
south	etelä
case	tapaus
project	projekti
pages	sivut
version	versio
section	jakso
own	oma
house	talo
security	turvallisuus
g	g
county	lääni
american	amerikkalainen
photo	kuva
game	peli
members	jäsenet
power	teho
network	verkko
computer	tietokone
systems	järjestelmät
three	kolme
place	paikka
end	pää
h	h
him	häntä
per	kohti
access	pääsy
think	ajatella
north	pohjoinen
resources	voimavarat
current	nykyinen
big	iso
media	tiedotusvälineet
law	laki
control	ohjaus
water	vesi
history	historia
size	koko
personal	henkilökohtainen
guide	opas
shop	myymälä
directory	hakemisto
change	muuttaa
white	valkoinen
text	teksti
small	pieni
rating	luokitus
rate	nopeus
government	hallitus
children	lapset
return	palata
students	opiskelijoille
v	v
account	tili
times	ajat
level	taso
digital	digitaalinen
profile	profiili
previous	Edellinen
form	muoto
events	Tapahtumat
love	rakkaus
old	vanha
john	Johannes
main	tärkein
call	puhelu
image	kuva
department	osasto
title	otsikko
non	ei
k	K
y	y
insurance	vakuutus
shall	on
property	omaisuus
class	luokka
cd	CD
quality	laatu
every	joka
listing	listaus
content	pitoisuus
country	maa
little	vähän
tools	Työkalut
low	matala
reply	Vastaa
customer	asiakas
december	joulukuu
compare	vertailla
movies	elokuvat
college	college
value	arvo
article	artikla
man	mies
jobs	työpaikkaa
j	j
food	ruoka
author	kirjailija
different	eri
u	U
learn	oppia
sale	myynti
print	Tulosta
course	kurssi
job	Job
room	huone
stock	kalusto
training	koulutus
too	liian
credit	luotto
point	kohta
science	tiede
men	miehet
categories	luokat
west	länsi
look	Katso
english	Englanti
team	tiimi
estate	omaisuus
box	laatikko
conditions	olosuhteet
photos	Valokuvat
gay	homo
thread	lanka
category	kategoria
note	Huomautus
live	elää
large	suuri
gallery	galleria
table	pöytä
however	kuitenkin
june	kesäkuu
october	lokakuu
november	marraskuu
market	markkinoida
library	kirjasto
action	toiminta
start	alkaa
series	sarja
features	ominaisuudet
air	ilma
industry	ala
plan	suunnitelma
human	ihmisen
yes	Joo
second	toinen
hot	kuuma
cost	kustannus
movie	elokuva
forums	foorumit
march	maaliskuu
la	la
september	syyskuu
say	sanoa
going	menossa
medical	lääketieteellinen
friend	ystävä
dec	joulukuu
server	palvelin
application	hakemus
staff	henkilöstö
play	pelata
issues	kysymykset
april	huhtikuu
users	käyttäjät
street	katu
topic	aihe
against	vastaan
got	sai
blog	blogi
party	juhla
payment	maksu
equipment	laitteet
let	antaa
programs	ohjelmat
legal	oikeudellinen
recent	viimeaikainen
park	pysäköidä
act	toimia
problem	ongelma
red	punainen
give	antaa
memory	muisti
performance	esitys
social	sosiaalinen
q	q
story	tarina
sell	myydä
options	vaihtoehtoja
experience	kokea
key	avain
body	ruumis
young	nuori
important	tärkeä
field	ala
few	harvat
east	itään
single	yksittäinen
ii	ii
age	ikä
club	klubi
example	esimerkki
girls	tytöt
z	z
road	tie
gift	lahja
question	kysymys
ca	ca
hard	kova
pay	maksaa
four	neljä
poker	pokeri
issue	ongelma
range	alue
building	rakennus
seller	myyjä
court	tuomioistuin
february	helmikuu
result	tulos
light	valo
write	kirjoittaa
war	sota
offer	tarjous
blue	sininen
groups	ryhmät
al	ai
easy	helppo
given	tietty
request	pyyntö
fax	faksi
china	Kiina
making	tehdä
picture	kuva
needs	tarpeisiin
possible	mahdollinen
month	kuukausi
major	suuri
star	tähti
future	tulevaisuus
space	tila
committee	komitea
hand	käsi
sun	aurinko
cards	kortit
london	Lontoo
meeting	tapaaminen
become	tulla
child	lapsi
keep	pitää
porn	porno
share	Jaa
similar	samankaltainen
garden	puutarha
schools	koulut
million	miljoona
added	lisättyä
reference	viite
companies	yritykset
baby	vauva
learning	oppiminen
energy	energia
run	juosta
delivery	toimitus
popular	suosittu
term	termi
film	elokuva
stories	tarinoita
put	laittaa
journal	päiväkirja
reports	raporttien
co	co
try	yrittää
images	kuvien
notice	ilmoitus
god	Jumala
original	alkuperäinen
head	pää
radio	radio
cell	solu
council	neuvosto
includes	sisältää
track	seurata
discussion	keskustelu
archive	arkisto
others	toiset
agreement	sopimus
format	muoto
society	yhteiskunta
months	kuukaudet
safety	turvallisuus
friends	ystävät
sure	varma
edition	painos
messages	viestien
marketing	markkinointi
tell	kertoa
association	yhdistys
provides	tarjoaa
fun	hauska
already	jo
green	vihreä
studies	opinnot
close	kiinni
common	yhteinen
specific	erityinen
several	useat
living	elävä
collection	kokoelma
called	nimeltään
short	lyhyt
arts	arts
lot	erä
ask	kysyä
limited	rajallinen
solutions	ratkaisut
director	johtaja
beach	ranta
past	menneisyys
natural	luonnollinen
electronics	elektroniikka
upon	päälle
period	aika
planning	suunnittelu
says	sanoo
official	virallinen
mar	maaliskuu
done	tehty
technical	tekninen
window	ikkuna
pro	ammattilainen
region	alue
island	saari
record	ennätys
direct	suoraan
conference	konferenssi
records	asiakirjat
st	st
district	piiri
calendar	kalenteri
costs	kustannukset
style	tyyli
statement	selvitys
miles	mailia
resource	resurssi
applications	sovellukset
document	asiakirja
word	sana
works	teokset
material	materiaali
bill	laskuttaa
written	kirjallinen
rules	säännöt
final	lopullinen
thing	asia
centre	keskusta
requirements	vaatimuksista
TRUE	TOTTA
minutes	minuutit
else	muu
mark	merkki
rock	rock
bad	huono
individual	yksilö
plus	plus
auto	auto
cover	peite
edit	muokata
together	yhdessä
videos	Videot
fast	nopeasti
function	toiminto
fact	tosiasia
getting	saada
global	maailmanlaajuinen
tech	teknologia
meet	tavata
far	pitkälle
economic	taloudellinen
en	fi
player	pelaaja
projects	hankkeet
amount	määrä
watch	katsella
included	Sisältää
feel	tuntea
bank	pankki
risk	riski
deals	tarjoukset
various	eri
words	sanat
production	tuotanto
commercial	kaupallinen
weight	paino
heart	sydän
treatment	hoito
points	pistettä
knowledge	tuntemus
magazine	aikakauslehti
error	virhe
camera	kamera
girl	tyttö
construction	rakentaminen
toys	lelut
registered	kirjattu
domain	verkkotunnuksen
methods	menetelmät
chapter	luku
protection	suojaus
policies	politiikkaa
wide	leveä
beauty	kauneus
manager	johtaja
india	Intia
position	asento
taken	otettu
sort	järjestellä
listings	listat
known	tunnettu
half	puoli
cases	tapauksissa
step	vaihe
engineering	tekniikka
simple	yksinkertainen
quick	nopea
license	lisenssi
lake	järvi
whole	koko
annual	vuotuinen
published	julkaistu
church	kirkko
method	menetelmä
active	aktiivinen
response	vastaus
figure	kuva
materials	tarvikkeet
enough	tarpeeksi
designed	suunnitellut
among	keskuudessa
death	kuolema
loss	menetys
face	kasvot
brand	brändi
discount	alennus
effects	tehosteet
created	luotu
standards	standardit
bit	bitti
political	poliittinen
kingdom	kuningaskunta
base	pohja
doing	tekemässä
loans	lainat
shoes	kengät
entry	merkintä
stay	pysyä
orders	tilaukset
availability	saatavuus
summary	yhteenveto
turn	vuoro
growth	kasvu
agency	toimisto
king	kuningas
european	eurooppalainen
activity	aktiviteetti
copy	kopio
western	Läntinen
force	pakottaa
employment	työllisyys
bay	lahti
river	joki
commission	komissio
package	paketti
seen	nähdään
players	pelaajat
engine	moottori
port	portti
album	albumi
regional	alueellinen
stop	Stop
started	aloitti
administration	antaminen
bar	baari
institute	instituutti
views	näkymät
double	kaksinkertainen
dog	koira
soon	pian
lines	linjat
electronic	elektroninen
benefits	hyötyjä
needed	tarvittu
printer	kirjoitin
condition	kunto
effective	tehokas
believe	uskoa
organization	organisaatio
effect	vaikutus
mind	mieli
selection	valinta
casino	kasino
pdf	PDF
tour	kiertue
cross	ylittää
hope	toivoa
corporation	yhtiö
wish	toive
solution	ratkaisu
mature	kypsä
role	rooli
weeks	viikkoa
certain	tietty
lower	alempi
necessary	välttämätön
union	liitto
mon	mon
com	com
particular	tietty
fine	hieno
hour	tunnin
gas	kaasu
skills	taidot
six	kuusi
bush	Puska
islands	saaret
advice	neuvot
career	ura
decision	päätös
leave	jättää
pre	pre
huge	valtava
woman	nainen
facilities	laitteisto
bid	tarjous
middle	keskimmäinen
cable	kaapeli
opportunities	mahdollisuudet
taking	ottaen
values	arvot
division	jako
coming	tuleva
object	esine
lesbian	lesbo
appropriate	sopiva
machine	kone
logo	logo
length	pituus
nice	kiva
score	pisteet
statistics	tilasto
client	asiakas
sample	näyte
investment	investointi
sent	lähetetty
shown	esitetty
christmas	joulu
culture	kulttuuri
flash	salama
ms	neiti
choice	valinta
courses	kurssit
consumer	kuluttaja
hi	Moi
foreign	ulkomainen
artist	taiteilija
furniture	huonekalut
channel	kanava
letter	kirje
mode	tila
phones	puhelimet
ideas	ideoita
structure	rakenne
degree	aste
contract	sopimus
super	Super
male	Uros
matter	asia
almost	melkein
located	sijaitsevat
multiple	moninkertainen
distribution	jakelu
editor	toimittaja
inn	majatalo
industrial	teollinen
potential	mahdollinen
song	laulu
los	los
fall	pudota
idea	ajatus
rooms	Huoneet
communications	viestintä
win	voittaa
primary	ensisijainen
cancer	syöpä
numbers	numerot
reason	syy
tool	työkalu
spring	kevät
foundation	perusta
answer	vastaus
voice	ääni
schedule	ajoittaa
documents	asiakirjat
purpose	tarkoitus
feature	ominaisuus
bed	sänky
comes	tulee
police	Poliisi
independent	itsenäinen
approach	lähestyä
brown	ruskea
physical	fyysinen
hill	mäki
maps	kartat
hold	pitää
ratings	luokitukset
happy	onnellinen
smith	seppä
developed	kehittyneillä
thank	kiittää
safe	turvallinen
unique	ainutlaatuinen
survey	tutkimus
prior	ennen
telephone	puhelin
sport	Urheilu
ready	valmis
animal	eläin
sources	lähteet
population	väestö
pa	pa
regular	säännöllinen
secure	turvallinen
operations	toiminnot
simply	yksinkertaisesti
evidence	näyttö
station	asema
understand	ymmärtää
option	vaihtoehto
valley	laakso
probably	todennäköisesti
sea	meri
publications	Julkaisut
improve	parantaa
connection	yhteys
publisher	kustantaja
hall	sali
anti	anti
networks	verkot
earth	maa
parents	vanhemmat
impact	vaikutus
transfer	siirtää
introduction	esittely
kitchen	keittiö
strong	vahva
wedding	häät
properties	ominaisuudet
hospital	sairaala
ground	maa
ship	alus
accommodation	majoitus
disease	tauti
excellent	erinomainen
perfect	täydellinen
hair	hiukset
opportunity	tilaisuus
kit	pakki
classic	klassikko
basis	perusta
command	komento
cities	kaupungit
express	ilmaista
award	myöntää
distance	etäisyys
tree	puu
assessment	arviointi
wall	seinä
involved	osallistuva
el	el
extra	ylimääräinen
especially	erityisesti
budget	talousarvio
guides	oppaita
success	menestys
maximum	enimmäismäärä
ma	äiti
operation	operaatio
existing	nykyinen
quite	melko
selected	valittu
boy	poika
restaurants	ravintolat
beautiful	kaunis
warning	Varoitus
locations	sijainnit
horse	hevonen
vote	äänestys
flowers	kukat
stars	tähdet
lists	luettelot
owner	omistaja
animals	eläimet
ways	tapoja
son	poika
providing	tarjoaminen
rule	sääntö
housing	kotelo
takes	kestää
bring	tuoda
catalog	luettelo
max	max
mother	äiti
authority	auktoriteetti
told	kertoi
programme	ohjelmoida
joined	liittyi
input	panos
strategy	strategia
feet	jalkaa
agent	agentti
valid	pätevä
modern	moderni
senior	vanhempi
sexy	seksikäs
teaching	opetus
door	ovi
grand	suuri
trial	oikeudenkäynti
units	yksiköt
cool	viileä
normal	normaali
enterprise	yritys
ships	laivat
entire	koko
positive	positiivinen
fitness	kunto
chinese	Kiinalainen
opinion	lausunto
football	jalkapallo
abstract	abstrakti
output	ulostulo
funds	varat
mr	Herra
likely	todennäköisesti
develop	kehittää
artists	Taiteilijat
alternative	vaihtoehto
responsibility	vastuu
java	Jaava
guest	vieras
publication	julkaisu
pass	kulkea
relations	suhteet
trust	luottamus
van	pakettiauto
contains	sisältää
multi	multi
republic	tasavalta
fees	palkkiot
components	komponentit
vacation	loma
century	vuosisata
academic	akateeminen
assistance	apu
completed	valmistunut
skin	iho
graphics	grafiikka
indian	intialainen
ring	rengas
grade	arvosana
mountain	vuori
organizations	organisaatioiden
filter	suodattaa
panel	paneeli
floor	lattia
buying	ostaminen
match	ottelu
proposed	ehdotettu
require	vaatia
boys	pojat
morning	aamu
allows	sallii
protein	proteiini
plant	kasvi
reported	raportoitu
hit	osuma
mm	mm
pool	pool
mini	mini
politics	politiikka
partner	kumppani
authors	kirjoittajat
boards	levyt
fish	kalastaa
membership	jäsenyys
mission	tehtävä
eye	silmä
string	jono
sense	tunne
modified	muokattu
released	julkaisi
stage	vaihe
internal	sisäinen
born	syntynyt
detailed	yksityiskohtainen
japanese	japanilainen
race	rotu
approved	hyväksytty
target	kohde
except	paitsi
character	merkki
maintenance	ylläpito
ability	kyky
ed	toim
rape	raiskata
battery	akku
youth	nuoret
pressure	paine
submitted	toimitettu
debt	velka
medium	keskikokoinen
television	televisio
interested	kiinnostunut
core	ydin
break	tauko
purposes	tarkoituksiin
sets	setit
dance	tanssi
wood	puu
defined	määritellyt
papers	paperit
awards	palkinnot
fee	maksu
studio	studio
reader	lukija
device	laite
established	perusti
answers	vastauksia
rent	vuokrata
las	las
dark	tumma
external	ulkoinen
apple	omena
le	le
instructions	ohjeet
min	min
offered	tarjotaan
theory	teoria
remove	poistaa
aid	apu
visual	visuaalinen
host	isäntä
variety	lajike
teachers	opettajat
manual	manuaalinen
block	lohko
subjects	aiheita
agents	aineet
repair	korjaus
fair	oikeudenmukainen
steel	teräs
understanding	ymmärtäminen
songs	lauluja
fixed	kiinteä
wrong	väärä
beginning	alku
hands	käsissä
az	az
paris	Pariisi
gets	saa
sector	sektori
capacity	kapasiteetti
un	un
fat	rasva
father	isä
electric	sähköinen
saw	näin
instruments	välineet
officer	upseeri
driver	kuljettaja
businesses	yritykset
dead	kuollut
unknown	tuntematon
restaurant	ravintola
mike	mikrofoni
trip	matka
mi	mi
poor	huono
relationship	yhteys
workers	työntekijöiden
peace	rauha
traditional	perinteinen
showing	osoittavat
creative	luova
coast	rannikko
benefit	hyöty
funding	rahoitus
devices	laitteet
lord	herra
grant	myöntää
sub	sub
fiction	kaunokirjallisuus
watches	kellot
careers	uraa
goes	menee
led	led
museum	museo
fan	tuuletin
transport	kuljetus
interesting	mielenkiintoista
blogs	blogit
evaluation	arviointi
former	entinen
zone	vyöhyke
complex	monimutkainen
th	th
cat	kissa
die	kuolla
presented	esittelyyn
flat	tasainen
flow	virtaus
agencies	virastojen
literature	kirjallisuus
parent	vanhempi
setting	asetus
dr	DR
scale	asteikko
economy	talous
helpful	hyödyllinen
monthly	kuukausittain
critical	kriittinen
frame	kehys
musical	musikaali
definition	määritelmä
secretary	sihteeri
path	polku
chief	päällikkö
gives	antaa
packages	paketit
detail	yksityiskohta
laws	lait
changed	muutettu
begin	alkaa
royal	kuninkaallinen
clean	puhdas
guy	kaveri
titles	otsikot
relevant	merkityksellinen
justice	oikeudenmukaisuus
connect	kytkeä
cup	kuppi
basket	kori
applied	soveltava
weekly	viikoittain
vol	vol
installation	asennus
pp	pp
attention	huomio
advance	edetä
skip	hyppiä
diet	ruokavalio
army	armeija
gear	vaihde
difference	ero
allowed	sallittu
correct	oikea
nation	kansakunta
selling	myynti
lots	paljon
piece	pala
sheet	arkki
firm	yritys
seven	seitsemän
elements	elementtejä
species	laji
jump	hypätä
cells	solut
module	moduuli
resort	lomakeskus
certificate	todistus
minister	ministeri
motion	liike
fashion	muoti
directions	ohjeet
visitors	vierailijat
documentation	dokumentointi
trading	kaupankäynti
forest	metsä
calls	puhelut
coverage	kattavuus
couple	pari
giving	antaminen
chance	mahdollisuus
vision	näkemys
ball	pallo
ending	pääte
clients	asiakkaat
actions	toimet
discuss	keskustella
goal	tavoite
successful	onnistunut
sold	myyty
wind	tuuli
communities	yhteisöt
clinical	kliininen
situation	tilanne
markets	markkinat
publishing	kustannustoiminta
appear	ilmestyä
developing	kehittämällä
lives	elämää
determine	määrittää
temperature	lämpötila
announcements	ilmoitukset
patient	potilas
actual	todellinen
historical	historiallinen
stone	kivi
bob	Bob
commerce	kaupankäynti
persons	henkilöt
difficult	vaikea
scientific	tieteellinen
satellite	satelliitti
tests	testit
village	kylä
accounts	tilit
amateur	amatööri
ex	entinen
met	tavannut
pain	kipu
factors	tekijät
coffee	kahvi
buyer	ostaja
poster	juliste
edge	reuna
functional	toiminnallinen
root	juuri
fi	fi
closed	suljettu
holidays	juhlapäivät
pink	vaaleanpunainen
balance	saldo
monitoring	seuranta
replies	vastaukset
shot	laukaus
initial	alkukirjain
label	etiketti
sec	sec
canon	kaanon
league	liiga
waste	jätteet
minute	minuutti
bus	bussi
provider	toimittaja
dictionary	sanakirja
accounting	kirjanpito
manufacturing	valmistus
sections	osiot
chair	tuoli
effort	ponnistus
phase	vaihe
fantasy	fantasia
po	po
va	va
professor	professori
install	Asentaa
shirt	paita
apparel	vaatteet
foot	jalka
breast	rinta
techniques	tekniikat
dollars	dollaria
religion	uskonto
permission	lupa
wild	villi
generation	sukupolvi
miss	neiti
chemical	kemiallinen
doctor	lääkäri
task	tehtävä
reduce	vähentää
brought	toi
exercise	liikunta
bug	vika
guarantee	takuu
leader	johtaja
se	SE
processes	prosessit
soft	pehmeä
meetings	kokoukset
seconds	sekuntia
flight	lento
congress	kongressi
fuel	polttoaine
walk	kävellä
produced	valmistettu
saint	pyhimys
argument	Perustelu
competition	kilpailu
drugs	huumeita
joint	yhteinen
premium	palkkio
fresh	tuore
characters	merkkiä
attorney	asianajaja
di	di
factor	tekijä
thousands	tuhansia
km	km
stream	virta
apartments	huoneisto
pick	valita
hearing	kuulo
eastern	itäinen
therapy	terapia
entries	merkinnät
signed	allekirjoitettu
administrative	hallinnollinen
serious	vakava
limit	raja
steps	askeleet
shops	kaupat
bondage	orjuus
del	del
efforts	pyrkimyksiä
informed	ilmoitti
ga	ga
thoughts	ajatuksia
creek	puro
ft	ft
quantity	määrä
essential	olennainen
tours	matkat
load	ladata
immediately	heti
machines	koneet
designated	nimetty
heavy	raskas
covered	katettu
recovery	elpyminen
integrated	integroitu
configuration	kokoonpano
cock	kukko
merchant	kauppias
comprehensive	kattava
expert	asiantuntija
protect	suojella
solid	vankka
presentation	esittely
became	tuli
orange	oranssi
compliance	noudattaminen
theme	teema
rich	rikas
campaign	kampanja
vs	vs
guitar	kitara
finding	havainto
examples	esimerkkejä
spirit	henki
ar	ar
claims	vaatimukset
acceptance	hyväksyminen
strategies	strategiat
mo	mo
affairs	asioihin
intended	tarkoitettu
sa	sa
goals	tavoitteet
hire	vuokraus
election	vaalit
suggest	ehdottaa
branch	haara
serve	palvella
affiliates	Kumppanit
mount	asentaa
latin	Latina
multimedia	multimedia
manage	hoitaa
corner	kulma
rank	arvo
element	elementti
birth	syntymä
virus	virus
interactive	interaktiivinen
requests	pyynnöt
separate	erillinen
quarter	neljännes
procedure	menettely
leadership	johto
define	määritellä
religious	uskonnollinen
facts	tosiasiat
breakfast	aamiainen
column	sarake
faith	usko
chain	ketju
identify	tunnistaa
avenue	katu
missing	puuttuva
recommendations	suosituksia
moved	siirretty
reach	saavuttaa
comparison	vertailu
moment	hetki
extended	laajennettu
sequence	jakso
inch	tuuma
attack	hyökkäys
centers	keskuksissa
opening	aukko
lab	laboratorio
reserve	varata
gamma	gamma
produce	tuottaa
truth	totuus
counter	laskuri
failure	vika
follows	seuraa
dollar	dollari
camp	leiri
des	des
films	elokuvat
bridge	silta
fill	täyttää
movement	liike
printing	painaminen
draft	luonnos
chart	kartoittaa
played	pelataan
contacts	yhteystiedot
readers	lukijoita
clubs	risti
wa	wa
adventure	seikkailu
offering	uhri
profit	voitto
leaders	johtajat
posters	Julisteet
institutions	laitokset
assistant	avustaja
variable	muuttuja
dj	dj
parking	pysäköinti
yesterday	eilen
determined	määritetty
workshop	työpaja
gone	mennyt
codes	koodit
kinds	Erilaisia
extension	laajentaminen
statements	lausuntoja
completely	täysin
teams	joukkueet
fort	linnake
cm	cm
senate	senaatti
funny	hauska
gene	geeni
turned	kääntyi
disc	levy
pattern	kuvio
boat	vene
theatre	teatteri
manufacturers	valmistajat
sponsor	sponsori
classical	klassinen
icon	ikoni
warranty	takuu
dedicated	omistautunut
direction	suunta
basketball	koripallo
objects	esineet
delete	poistaa
evening	ilta
assembly	kokoonpano
nuclear	ydinaseiden
mouse	hiiri
signal	signaali
criminal	rikollinen
issued	annettu
powerful	voimakas
dream	unelma
FALSE	VÄÄRÄ
da	da
cast	heittää
flower	kukka
personnel	henkilöstö
passed	läpäissyt
supplied	toimitetaan
falls	Falls
soul	sielu
promote	edistää
stated	totesi
stats	tilastot
professionals	ammattilaisten
appears	näyttää
carry	kuljettaa
flag	lippu
covers	kannet
em	em
advantage	etu
hello	Hei
designs	malleja
maintain	ylläpitää
tourism	matkailu
priority	prioriteetti
adults	aikuiset
graphic	graafinen
atom	atomi
payments	maksut
binding	sitova
brief	lyhyt
ended	päättyi
winning	voittoisa
anonymous	anonyymi
script	käsikirjoitus
served	palveli
wants	haluaa
prepared	valmis
void	mitätön
tag	tag
interview	haastatella
mix	sekoittaa
framework	puitteet
disk	levy
installed	asennetut
queen	kuningatar
credits	ov
clearly	selvästi
fix	korjata
handle	kahva
sweet	makea
criteria	kriteeri
associate	kumppani
ne	NE
behavior	käytös
enlarge	suurentaa
ray	säde
revenue	tulot
measure	mitata
votes	ääntä
du	du
duty	velvollisuus
discussions	keskustelut
bear	karhu
gain	saada
festival	festivaali
laboratory	laboratorio
ocean	valtameri
flights	lennot
experts	asiantuntijat
signs	merkkejä
depth	syvyys
train	kouluttaa
dry	kuiva
explore	tutkia
spa	kylpylä
concept	konsepti
nearly	lähes
handling	käsittely
origin	alkuperä
billion	miljardi
intelligence	älykkyys
bought	ostettu
con	huijaus
nations	kansakunnat
route	reitti
broken	rikki
battle	taistelu
speak	puhua
protocol	protokolla
query	tiedustelu
partnership	kumppanuus
expression	ilmaisu
es	es
speech	puhe
wire	johdin
suggestions	ehdotukset
replacement	korvaus
tape	nauha
strategic	strateginen
judge	tuomari
acid	happo
bytes	tavua
cent	sentti
forced	pakko
compatible	yhteensopiva
apartment	huoneisto
null	tyhjä
zero	nolla
speaker	kaiutin
consulting	konsultointi
designer	suunnittelija
pr	PR
marriage	avioliitto
roll	rulla
banks	pankit
fr	FR
participants	osallistujaa
secret	salaisuus
negative	negatiivinen
favorites	suosikit
theater	teatteri
springs	jouset
var	var
perform	suorittaa
translation	käännös
estimates	arvioiden
injury	vahinko
ministry	ministeriö
drivers	kuljettajat
lawyer	lakimies
figures	luvut
protected	suojattu
proposal	ehdotus
sharing	jakaminen
portal	portaali
beta	beeta
gratis	ilmaiseksi
toward	kohti
slightly	hieman
assist	avustaa
conduct	käytös
contained	sisälsi
legislation	lainsäädäntö
calling	kutsumus
parameters	parametrit
profiles	profiilit
matters	asioissa
houses	talot
controls	ohjaimet
combined	Yhdistetty
ultimate	perimmäinen
representative	edustaja
minor	vähäinen
departments	osastot
residents	asukkaat
displayed	näyttöön
mom	äiti
reduced	pelkistetty
rare	harvinainen
performed	suoritettu
extreme	äärimmäinen
samples	näytteet
bars	baarit
forecast	ennuste
removed	poistettu
cycle	sykli
contain	sisältää
accuracy	tarkkuus
sleep	nukkua
mg	mg
bird	lintu
pharmacy	apteekki
creation	luominen
static	staattinen
hunter	metsästäjä
addresses	osoitteet
lady	nainen
crystal	kristalli
famous	kuuluisa
writer	kirjailija
chairman	puheenjohtaja
drink	juoda
academy	akatemia
dynamic	dynaaminen
eat	syödä
permanent	pysyvä
cleaning	puhdistus
constitutes	muodostaa
portfolio	salkku
practical	käytännöllinen
delivered	toimitetaan
infrastructure	infrastruktuuri
colour	väri
vendor	myyjä
philosophy	filosofia
regulation	säätö
officers	upseerit
aim	tavoite
bids	tarjouksia
nutrition	ravitsemus
recording	äänite
junior	nuorempi
les	les
cape	viitta
rings	renkaat
tip	kärki
wonderful	ihana
ticket	lippu
announced	ilmoitti
guess	arvaus
whom	ketä
soccer	jalkapallo
math	matematiikka
import	tuonti
posting	komennus
presence	läsnäolo
automatic	Automaattinen
viewing	katselu
maintained	säilyy
ch	ch
dan	dan
dogs	koirat
directors	johtajat
aspects	näkökohdat
ahead	eteenpäin
moon	kuu
participation	osallistumista
scheme	ohjelma
fly	lentää
manner	tapa
matrix	matriisi
combination	yhdistelmä
amendment	muutos
strength	vahvuus
turkey	Turkki
libraries	kirjastot
proper	asianmukainen
degrees	astetta
enterprises	yrityksille
delta	delta
fear	pelko
seeking	etsiä
inches	tuumaa
convention	sopimus
shares	osakkeiden
principal	pääasiallinen
comfort	mukavuus
colors	värit
wars	sodat
ordering	tilaaminen
kept	säilytetään
alpha	alfa
appeal	valitus
cruise	risteily
bonus	bonus
hey	Hei
buildings	rakennukset
specials	tarjoukset
beat	lyödä
batteries	akut
becomes	tulee
drives	asemat
arms	aseet
tea	tee
improved	parantunut
achieve	saavuttaa
positions	kannat
dress	pukeutua
subscription	tilaus
dealer	jakaja
contemporary	nykyajan
sky	taivas
rom	rom
carried	kuljettaa
exposure	valotus
hide	piilottaa
signature	allekirjoitus
miller	mylläri
provision	säännös
clothes	vaatteet
frames	kehyksiä
certainly	varmasti
newspaper	sanomalehti
toy	lelu
layer	kerros
printed	painettu
slow	hidas
removal	poistaminen
liability	vastuu
printers	tulostimet
adding	lisäämällä
spot	täplä
spend	viettää
factory	tehdas
interior	sisusta
grow	kasvaa
optical	optinen
promotion	edistäminen
relative	suhteellinen
amazing	hämmästyttävä
dot	piste
identity	identiteetti
conversion	muuntaminen
feeling	tunne
hidden	kätketty
reasonable	kohtuullinen
revision	tarkistus
influence	vaikutus
ratio	suhde
importance	merkitys
rain	sade
planet	planeetta
copies	kappaletta
permit	lupa
seeing	koska
proof	todiste
bass	basso
prescription	resepti
empty	tyhjä
instance	ilmentymä
hole	reikä
ride	ratsastaa
bureau	toimisto
conservation	säilyttäminen
pair	pari
ideal	ihanteellinen
specs	silmälasit
recorded	tallennettu
don	Don
pieces	kappaletta
finished	päättynyt
parks	puistot
lawyers	lakimiehet
stress	stressi
cream	kerma
ss	ss
runs	ajot
discover	löytää
ap	ap
patterns	kuviot
hills	Hills
nm	nm
advisor	neuvonantaja
aware	tietoinen
shape	muoto
evolution	evoluutio
certificates	todistukset
objectives	tavoitteet
stations	asemat
suggested	ehdotti
op	op
remains	jäännökset
firms	yritykset
euro	euro
operator	operaattori
structures	rakenteet
generic	yleinen
encyclopedia	tietosanakirja
usage	käyttö
ink	muste
mixed	sekoitettu
census	väestönlaskenta
wheel	pyörä
suppliers	toimittajat
compact	kompakti
poetry	runous
lights	valot
tracking	seuranta
angel	enkeli
preparation	valmistautuminen
attempt	yrittää
receiving	vastaanotetaan
matches	Ottelut
accordance	mukaisesti
width	leveys
engines	moottorit
forget	unohtaa
array	ryhmä
discussed	keskusteltiin
accurate	tarkka
climate	ilmasto
greek	kreikkalainen
instruction	ohje
managing	hallinnassa
raw	raaka
differences	erot
explain	selittää
establish	perustaa
expressed	ilmaisi
extent	laajuus
sharp	terävä
ben	ben
paragraph	kohta
kill	tappaa
mathematics	matematiikka
compensation	korvaus
export	viedä
managers	johtajat
modules	moduulit
conducted	suoritettu
versions	versiot
knows	tietää
describe	kuvata
citizens	kansalaiset
heritage	perintö
trouble	vaivata
coach	valmentaja
agricultural	maatalous
expand	laajentaa
audience	yleisö
assigned	osoitettu
collections	kokoelmat
ages	iät
specialist	asiantuntija
cook	kokki
affect	vaikuttaa
virgin	Neitsyt
experienced	kokenut
investigation	tutkimus
raised	nosti
hat	hattu
institution	instituutio
directed	suunnattu
affected	vaikuttaa
bike	pyörä
totally	täysin
plate	levy
expenses	kulut
indicate	osoittaa
blonde	vaalea
proceedings	menettely
favourite	suosikki
characteristics	ominaisuudet
der	der
lose	menettää
organic	orgaaninen
seek	etsiä
experiences	kokemukset
albums	albumit
contracts	sopimuksia
guests	vieraita
hosted	isännöi
diseases	sairaudet
concerning	koskevat
equivalent	vastaava
chemistry	kemia
kits	sarjat
logic	logiikka
prince	prinssi
circle	ympyrä
soil	maaperä
psychology	psykologia
wet	märkä
circumstances	olosuhteet
investor	sijoittaja
elementary	perus
sponsors	sponsorit
fox	kettu
unlimited	rajoittamaton
respond	vastata
sizes	koot
plain	tavallinen
exit	poistuminen
arm	käsivarsi
keys	näppäimet
wave	Aalto
holy	pyhä
acts	säädökset
guidance	opastus
trail	polku
symbol	symboli
highway	valtatie
observed	havaitun
dean	dekaani
setup	perustaa
poll	äänestys
styles	tyylit
filled	täynnä
bond	side
channels	kanavat
appendix	liite
chocolate	suklaa
portion	osa
scope	laajuus
supplier	toimittaja
cables	kaapelit
cotton	puuvilla
requirement	vaatimus
killed	surmattu
border	reunus
ancient	muinainen
debate	keskustelu
representatives	edustajia
starts	alkaa
pregnancy	raskaus
attractions	nähtävyydet
learned	oppinut
transactions	liiketoimet
explorer	tutkimusmatkailija
historic	historiallinen
husband	aviomies
authorized	valtuutettu
crazy	hullu
upcoming	tuleva
concert	konsertti
scores	tulokset
efficiency	tehokkuus
comedy	komedia
adopted	hyväksyttiin
efficient	tehokas
linear	lineaarinen
commitment	sitoutuminen
specialty	erikoisuus
bears	karhut
hop	hypätä
carrier	kantaja
constant	jatkuva
visa	Visa
mouth	suu
meter	mittari
linked	sidoksissa
interviews	haastattelut
concepts	käsitteet
gun	ase
reflect	heijastaa
pure	puhdas
hell	helvetti
fruit	hedelmä
begins	alkaa
qualified	pätevä
reform	uudistaa
lens	linssi
treated	käsitelty
discovery	löytö
draw	piirtää
classified	luokiteltu
assume	olettaa
alliance	liitto
confirm	vahvistaa
engineer	insinööri
consistent	johdonmukainen
replace	korvata
clearance	raivaaminen
converter	muunnin
organisation	organisaatio
babe	tyttö
checks	tarkastuksia
reached	saavuttanut
becoming	tulossa
objective	tavoite
indicated	osoitettu
sugar	sokeri
crew	miehistö
legs	jalat
stick	tikku
relation	suhde
enabled	käytössä
genre	laji
volunteer	vapaaehtoinen
rear	takaosa
democratic	demokraattinen
enhance	parantaa
exact	tarkka
bound	sidottu
parameter	parametri
processor	suoritin
node	solmu
formal	muodollinen
storm	myrsky
micro	mikro
colleges	oppilaitokset
mile	maili
challenges	haasteet
editors	Editors
supreme	ylin
brothers	veljet
recognition	tunnustus
ref	viite
estimate	arvio
kid	lapsi
inspection	tarkastus
consumers	kuluttajien
limits	rajoja
territory	alue
weapons	aseet
delay	viive
pilot	lentäjä
contributions	maksut
continuous	jatkuva
initiative	aloite
novel	uusi
execution	suoritus
disability	vammaisuus
ultra	ultra
winner	voittaja
episode	episodi
potter	savenvalaja
dish	ruokalaji
plays	pelaa
bulletin	tiedotuslehti
ia	ia
modify	muuttaa
truly	todella
universe	maailmankaikkeus
candidate	ehdokas
slot	aukko
outstanding	maksamatta
ha	ha
planned	suunnitellut
lodge	jättää
mirror	peili
tournament	turnaus
consideration	harkinta
sessions	istuntoja
kernel	ydin
buyers	ostajien
journals	lehdet
gray	harmaa
catalogue	luettelo
charged	peritään
broad	laaja
und	und
chosen	valittu
demo	esittely
hate	vihata
terminal	pääte
publishers	julkaisijat
nights	öisin
liquid	neste
rice	riisi
reservation	varaus
foods	elintarvikkeet
guard	vartija
saving	tallentaa
empire	imperiumi
newly	hiljattain
raise	nostaa
illegal	laiton
expansion	laajeneminen
premier	johtava
tomorrow	huomenna
milk	maito
drama	draama
visiting	vierailevat
contest	kilpailu
collected	koottu
bands	bändejä
suitable	sopiva
absolutely	ehdottomasti
audit	tarkastaa
chamber	kammio
guinea	Guinea
findings	tulokset
iso	ISO
typical	tyypillinen
sum	summa
chicken	kana
temporary	tilapäinen
attend	käydä
shower	suihku
sending	lähettäminen
sufficient	riittävä
shell	kuori
province	maakunta
catholic	katolinen
governor	kuvernööri
beer	olut
contribution	panos
formula	kaava
constitution	perustuslaki
packaging	pakkaus
reliable	luotettava
doubt	epäillä
earn	ansaita
periods	aikoja
attacks	iskut
merchandise	kauppatavara
symptoms	oireet
memorial	muistomerkki
twin	twin
insert	lisätä
gateway	portti
drawing	piirustus
candidates	ehdokkaat
ordered	tilasi
biological	biologinen
fighting	taistelevat
transition	siirtyminen
preferences	mieltymykset
spy	vakooja
romance	romanssi
instrument	väline
split	jakaa
themes	teemat
powers	valtuudet
heaven	taivas
bits	bitit
pregnant	raskaana
classification	luokittelu
focused	keskittynyt
physician	lääkäri
asking	pyytäminen
blocks	lohkot
lo	katso
spiritual	hengellinen
diabetes	diabetes
ml	ml
shift	siirtää
sit	istua
bodies	elinten
photographs	valokuvat
cutting	leikkaus
writers	kirjailijat
flexible	joustava
loved	rakastettu
favourites	suosikit
mapping	kartoitus
numerous	useat
relatively	suhteellisesti
represents	edustaa
superior	esimies
preferred	edullinen
saved	tallennettu
intellectual	älyllinen
granted	myönnetty
carbon	hiili
comfortable	mukava
magnetic	magneettinen
interaction	vuorovaikutus
listening	kuuntelee
crisis	kriisi
outlook	näkymät
massive	massiivinen
bright	kirkas
formed	muodostettu
piano	piano
echo	kaiku
revolution	vallankumous
displays	näytöt
plasma	plasma
earnings	tulot
mystery	mysteeri
landscape	maisema
mechanical	mekaaninen
journey	matka
banner	lippu
fig	kuva
counties	maakunnat
acquisition	hankinta
recognized	tunnistettu
dreams	unelmat
notification	ilmoitus
kg	kg
teach	opettaa
rapid	nopea
pull	Vedä
ut	ut
seminar	seminaari
investments	investoinnit
wheels	pyörät
specify	eritellä
sensitive	herkkä
templates	malleja
formats	formaatit
holds	pitää
router	reititin
concrete	betoni
si	si
folder	kansio
completion	valmistuminen
pulse	pulssi
technique	tekniikka
voting	äänestys
courts	tuomioistuimet
converted	muunnettu
metro	metro
anniversary	vuosipäivä
improvements	parannuksia
strip	kaistale
specification	määrittely
accident	onnettomuus
nick	lovi
accessible	saatavilla
resident	asukas
plot	juoni
typically	tyypillisesti
representation	edustus
pump	pumppu
exists	olemassa
arrangements	järjestelyt
conferences	konferenssit
consumption	kulutus
narrow	kapea
threat	uhkaus
surveys	tutkimukset
sitting	istuva
consultant	konsultti
controller	ohjain
committees	valiokunnat
penis	penis
castle	linna
gardens	puutarhat
labels	tarrat
willing	halukas
bio	bio
acting	näytteleminen
heads	päät
exam	koe
residence	asuinpaikka
density	tiheys
hundred	sata
strange	outo
sustainable	kestävä
statistical	tilastollinen
mention	mainita
innovation	innovaatio
grey	harmaa
parallel	rinnakkainen
operate	toimia
bills	setelit
stable	vakaa
definitions	määritelmät
von	von
doctors	lääkärit
lesson	oppitunti
cinema	elokuva
elections	vaalit
reaction	reaktio
blank	tyhjä
enhanced	tehostettu
entitled	oikeutettu
severe	vaikea
generate	Tuottaa
newspapers	sanomalehdet
hospitals	sairaalat
vi	vi
humor	huumori
aged	ikäinen
monitors	näytöt
exception	poikkeus
duration	kesto
bulk	pääosa
visits	käyntiä
capabilities	kyvyt
recommendation	suositus
sin	synti
organized	järjestetty
ba	ba
para	kappale
adoption	hyväksyminen
improving	parantaminen
expensive	kallis
buffalo	puhveli
organisations	organisaatioiden
plane	kone
programmes	ohjelmat
mechanism	mekanismi
ee	ee
marked	merkitty
driven	ajettu
bottle	pullo
innovative	innovatiivinen
massage	hieronta
conclusion	johtopäätös
closing	sulkeminen
thousand	tuhat
legend	legenda
villa	huvila
bone	luu
columns	pylväät
disorders	häiriöt
collaboration	yhteistyö
detection	havaitseminen
inner	sisäinen
formation	muodostus
med	med
engineers	insinöörien
entity	kokonaisuus
cruises	risteilyt
gate	portti
roman	roomalainen
duties	tehtävät
erotic	eroottinen
tone	sävy
ethics	etiikka
dragon	lohikäärme
busy	kiireinen
captain	kapteeni
brings	tuo
heating	lämmitys
leg	jalka
neck	niska
wing	siipi
scripts	skriptejä
abc	ABC
appointed	nimitetty
dealing	tekemisissä
commit	sitoutumaan
rail	kisko
trips	matkat
gap	aukko
sides	sivut
tube	putki
corresponding	vastaava
descriptions	kuvaukset
belt	vyö
jacket	takki
animation	animaatio
oracle	oraakkeli
er	er
productions	tuotannot
aviation	ilmailu
proud	ylpeä
disaster	katastrofi
console	konsoli
commands	komennot
jr	jr
telecommunications	tietoliikenne
instructor	ohjaaja
giant	jättiläinen
achieved	saavutettu
injuries	vammat
approaches	lähestymistavat
usual	tavallinen
stamps	postimerkkejä
angle	kulma
rob	ryöstää
designers	suunnittelijat
liberty	vapaus
era	aikakausi
convert	muuntaa
possibility	mahdollisuus
analyst	analyytikko
dangerous	vaarallinen
reliability	luotettavuus
respectively	vastaavasti
volunteers	vapaaehtoiset
derived	johdettu
pleasure	ilo
honor	kunnia
oriented	suuntautunut
eagle	kotka
prayer	rukous
workshops	työpajat
hurricane	Hurrikaani
quiet	hiljainen
producer	tuottaja
represented	edustettuina
responsibilities	vastuut
cheese	juusto
carefully	huolellisesti
productivity	tuottavuus
crown	kruunu
par	par
diagnosis	diagnoosi
maker	valmistaja
crack	crack
principle	periaate
picks	poimii
gang	jengi
fetish	fetissi
appearance	ulkomuoto
smoke	savu
filters	suodattimet
incorporated	yhdistetty
craft	alus
fellow	kaveri
blind	sokea
lounge	aula
mad	hullu
algorithm	algoritmi
strongly	voimakkaasti
cafe	kahvila
ken	ken
proteins	proteiineja
su	su
familiar	tuttu
capable	kykenevä
admission	pääsy
shoe	kenkä
elected	valittiin
carrying	kuljettaa
terrorism	terrorismi
joy	ilo
editions	painokset
ethnic	etninen
parliament	eduskunta
actor	näyttelijä
finds	löydöt
seal	tiiviste
situations	tilanteita
fifth	viides
citizen	kansalainen
vertical	pystysuora
corrections	korjaukset
describes	kuvailee
disabilities	vammaiset
substance	aine
prohibited	kielletty
pipe	putki
soldiers	sotilaat
guardian	holhooja
lecture	luento
simulation	simulointi
layout	layout
initiatives	aloitteita
ill	sairas
concentration	keskittyminen
lay	asettaa
interpretation	tulkinta
dirty	likainen
taught	opettanut
worker	työntekijä
optimization	optimointi
temple	temppeli
substances	aineet
prove	todistaa
discovered	löydetty
wings	siivet
genetic	geneettinen
restrictions	rajoituksia
thin	ohut
exhibition	näyttely
ridge	harjanne
modem	modeemi
bringing	tuoden
sick	sairas
evaluate	arvioida
tropical	trooppinen
collect	kerätä
vector	vektori
definitely	ehdottomasti
turning	kääntyminen
existence	olemassaolo
commentary	selostus
developments	kehitys
immigration	maahanmuutto
destinations	kohteet
mutual	keskinäinen
syntax	syntaksi
li	li
attribute	ominaisuus
prison	vankila
skill	taito
chairs	tuolit
surrounding	ympäröivä
mountains	vuoret
popularity	suosio
inquiry	tiedustelu
checked	tarkistettu
exhibit	näyttely
throw	heittää
trend	trendi
cats	kissat
desert	aavikko
ya	ya
coordinator	koordinaattori
mercury	elohopea
burning	palaa
escape	paeta
receiver	vastaanotin
progressive	etenevä
boats	veneet
championship	mestaruus
arcade	arkadi
impossible	mahdoton
tells	kertoo
obvious	ilmeinen
depression	masennus
graph	kaavio
covering	päällyste
platinum	platina
judgment	tuomio
talks	neuvottelut
filing	arkistointi
foster	edistää
awarded	palkittiin
trials	tutkimuksissa
masters	Masters
cartridge	patruuna
explanation	selitys
org	Org
fraud	petos
electricity	sähkö
spectrum	spektri
arrival	saapuminen
pottery	keramiikka
emphasis	painotus
awesome	mahtava
confirmed	vahvistettu
counts	laskee
crash	romahdus
lift	hissi
inter	inter
heights	korkeudet
shadow	varjo
expense	kulu
venture	hanke
clinic	klinikka
healing	paranemista
princess	prinsessa
entering	kirjoittamalla
packet	paketti
studios	studiot
involvement	osallistuminen
dad	isä
buttons	painikkeet
placement	sijoitus
observations	havainnot
winners	voittajat
roads	tiet
subsequent	myöhempi
yard	piha
disclosure	julkistaminen
establishment	perustaminen
memories	muistoja
te	te
creates	luo
faces	kasvoja
tourist	turisti
murder	murhata
adequate	riittävä
senator	senaattori
presentations	esitykset
digest	sulattaa
dust	pöly
wiki	wiki
replaced	vaihdettu
radar	tutka
losses	tappiot
combat	taistelu
reducing	vähentäminen
stopped	pysäytetty
occupation	ammatti
closely	tarkasti
radiation	säteily
kings	kuninkaat
shooting	ammunta
ear	korva
flags	liput
baker	leipuri
conservative	konservatiivinen
shock	järkyttää
effectiveness	tehokkuuden
tie	solmio
roof	katto
demonstrate	osoittaa
atmosphere	ilmapiiri
kiss	suudella
beast	peto
ra	ra
operated	toimi
experiment	koe
targets	tavoitteet
purchases	ostot
federation	liittovaltio
pizza	pizza
invited	kutsuttu
assignment	toimeksianto
mod	mod
queries	kyselyt
absence	poissaolo
vendors	myyjät
yoga	jooga
serves	palvelee
surprise	yllätys
lamp	lamppu
jokes	vitsit
counseling	neuvonta
palace	palatsi
satisfied	vakuuttunut
wins	voittoa
warehouse	varasto
supposed	oletettu
ordinary	tavallinen
ghost	aave
violation	rikkominen
boss	pomo
pride	ylpeys
expectations	odotukset
independence	itsenäisyys
knowing	tietäen
reporter	reportteri
metabolism	aineenvaihdunta
champion	mestari
personally	henkilökohtaisesti
plenty	paljon
solo	soolo
throat	kurkku
wealth	rikkaus
vacuum	tyhjiö
dancing	tanssi
recognize	tunnistaa
writes	kirjoittaa
plaza	aukio
quest	etsintä
publish	julkaista
screening	seulonta
trans	trans
pioneer	pioneeri
forgotten	unohdettu
acrobat	akrobaatti
plates	levyt
essays	esseitä
behaviour	käytös
telling	kertominen
fairly	melko
intelligent	älykäs
modes	tilat
obligation	vaatimus
harbor	satama
traveler	matkustaja
segment	segmentti
enemy	vihollinen
puzzle	palapeli
wells	kaivot
restricted	rajoitettu
republican	tasavaltalainen
secrets	salaisuudet
syndrome	oireyhtymä
attendance	läsnäolo
penalty	rangaistus
drum	rumpu
enables	mahdollistaa
builder	rakentaja
vista	näköala
flood	tulva
ease	helppous
arguments	argumentit
arena	areena
adventures	seikkailuja
pupils	oppilaat
announcement	ilmoitus
outcome	tulokset
appreciate	arvostaa
expanded	laajennettu
grown	täysikasvuinen
lovely	ihana
centres	keskuksissa
clause	lauseke
smile	hymy
lands	maat
troops	joukot
armed	aseistettu
pine	mänty
cooling	jäähdytys
gulf	kuilu
trucks	autot
mechanisms	mekanismit
divorce	avioero
tradition	perinne
pills	pillereitä
tiger	tiikeri
folks	ihmiset
sensor	sensori
exposed	avoin
hunt	metsästää
angels	enkelit
deputy	sijainen
thai	thaimaalainen
emissions	päästöt
physicians	lääkärit
complaint	valitus
scenes	kohtaukset
experiments	kokeiluja
boost	edistää
governance	hallintotavan
mill	mylly
founded	perustettu
chronic	krooninen
den	den
finger	sormi
keeps	pitää
pound	punta
locate	paikantaa
pl	pl
trained	koulutettu
implementing	toteuttamisessa
bread	leipä
motors	moottorit
tough	kova
incident	tapaus
dynamics	dynamiikka
lie	valehdella
conversation	keskustelu
decrease	pienentää
worship	palvonta
capability	valmiudet
ak	ak
precision	tarkkuus
damages	vahingonkorvaus
reserves	varaukset
solve	ratkaista
minority	vähemmistö
diverse	monipuolinen
ingredients	ainekset
ah	Ah
tones	sävyt
rehabilitation	kuntoutus
sight	näky
clay	savi
weak	heikko
divided	jaettu
reception	vastaanotto
wise	viisas
odds	todennäköisyys
seminars	seminaarit
consequences	seuraukset
makers	päättäjille
geography	maantiede
integrity	eheys
legacy	perintö
pleased	tyytyväinen
danger	vaara
vitamin	vitamiini
processed	jalostettu
phrase	fraasi
raising	nostaminen
implications	vaikutukset
functionality	toiminnallisuus
paradise	paratiisi
hybrid	hybridi
reads	lukee
emotional	tunteellinen
glory	kunnia
ja	ja
geographic	maantieteellinen
exceed	ylittää
rod	sauva
silk	silkki
babies	vauvat
bi	bi
romantic	romanttinen
revealed	paljastui
specialists	asiantuntijat
generator	generaattori
suspension	jousitus
sad	surullinen
correction	korjaus
wolf	susi
slowly	hitaasti
supplement	täydentää
portions	osat
infant	pikkulasten
sectors	aloilla
fluid	neste
grounds	perusteet
meal	ateria
ta	ta
machinery	koneet
equation	yhtälö
baskets	korit
probability	todennäköisyys
dimension	ulottuvuus
studied	tutkittu
profits	voitot
devil	paholainen
grass	ruoho
illustrated	kuvitettu
cherry	kirsikka
continental	mannermainen
achievement	saavutus
limitations	rajoituksia
funeral	hautajaiset
chapters	luvuissa
passenger	matkustaja
convenient	mukava
mars	Mars
sized	kokoinen
egg	muna
signals	signaalit
orientation	suuntautuminen
theft	varkaus
childhood	lapsuus
symbols	symbolit
lat	lat
meta	meta
analog	analoginen
talent	lahjakkuus
dated	päivätty
wisdom	viisaus
boundary	raja
elite	eliitti
gi	gi
believes	uskoo
poems	runoja
jurisdiction	toimivalta
robot	robotti
displaying	näyttämällä
witness	todistaja
equipped	varustettu
stages	vaiheet
sur	sur
acquired	hankittu
assess	arvioida
wash	pestä
entrance	Sisäänkäynti
declaration	ilmoitus
losing	menettää
attempts	yrityksiä
noble	jalo
automation	automaatio
impacts	vaikutukset
rev	kierros
advantages	edut
knight	ritari
aims	tavoitteet
extensions	laajennukset
appeals	valitukset
illness	sairaus
ho	ho
alternatives	vaihtoehtoja
sh	sh
soap	saippua
jam	hillo
unusual	epätavallinen
answered	vastasi
destruction	tuho
migration	muutto
disorder	häiriö
conventional	tavanomainen
wearing	yllään
axis	akseli
sought	pyrittiin
genes	geenit
median	mediaani
scanner	skanneri
herein	tässä
animated	eloisa
adjustment	säätö
hero	sankari
treatments	hoidot
attitude	asenne
carpet	matto
lenses	linssit
attended	osallistui
difficulty	vaikeus
punk	punk
coalition	koalitio
enrollment	rekisteröinti
duke	herttua
pace	vauhti
producers	tuottajia
arc	kaari
interfaces	rajapinnat
atlas	kartasto
observation	havainto
torture	kiduttaa
deleted	Poistetaan
coat	takki
restoration	entisöinti
convenience	sopivuus
returning	palaavat
opposition	oppositio
container	kontti
defendant	vastaaja
supervisor	valvoja
corps	joukot
actors	toimijoiden
liver	maksa
liable	velvollinen
petition	adressi
antenna	antenni
picked	poimitaan
belief	uskomus
killing	tappaminen
shoulder	olkapää
decor	sisustus
ion	ioni
diameter	halkaisija
podcast	podcast
interactions	vuorovaikutukset
singer	laulaja
herald	airut
aging	vanheneminen
intervention	interventio
plugin	kytkeä
attraction	vetovoima
diving	sukellus
modification	muutos
suppose	olettaa
reed	ruoko
involve	sisältää
moderate	kohtalainen
mice	hiiret
understood	ymmärsi
rapidly	nopeasti
ban	kieltää
assurance	varmuus
happening	happening
vast	valtava
mills	myllyt
outline	ääriviivat
receives	vastaanottaa
jeans	farkut
compilation	kokoelma
odd	outo
sigma	sigma
gr	gr
attractive	viehättävä
occasion	tilaisuus
recordings	tallenteet
victim	uhri
demands	vaatii
careful	varovainen
beam	palkki
gardening	puutarhanhoito
obligations	velvoitteet
arrive	saapua
orchestra	orkesteri
licence	lisenssi
adjustable	säädettävä
allocation	jako
essay	essee
demonstrated	osoittivat
dialogue	vuoropuhelu
camps	leirit
declared	julistettu
trace	jäljittää
shut	sulkea
packs	pakkauksissa
