of	de
että	à
sisään	dans
varten	pour
on	est
päällä	sur
että	cette
mennessä	par
Tämä	ce
kanssa	avec
minä	je
sinä	toi
se	il
tai	ou
olla	être
olemme	sont
at	à
kaikki	tout
omistaa	avoir
Uusi	Nouveau
me	nous
tahtoa	volonté
Koti	maison
meille	nous
noin	sur
jos	si
sivu	page
minun	mon
on	a
Hae	chercher
vapaa	gratuit
mutta	mais
meidän	notre
yksi	un
muut	autre
tehdä	faire
tiedot	information
aika	temps
hän	il
joka	lequel
heidän	leur
uutiset	nouvelles
käyttää	utilisation
siellä	Là
nähdä	voir
niin	alors
Kuka	qui
verkko	toile
myös	aussi
saada	obtenir
pm	pm
näkymä	vue
C	c
e	e
ensimmäinen	premier
ollut	été
olisi	aurait
olivat	étaient
s	s
Kuten	comme
x	X
kuin	que
löytö	trouver
hinta	prix
takaisin	arrière
ylin	Haut
ihmiset	gens
oli	avait
lista	liste
nimi	prénom
vain	juste
vuosi	an
päivä	journée
osaksi	dans
kaksi	deux
terveys	santé
n	n
re	ré
käytetty	utilisé
mennä	aller
b	b
kestää	dernier
tehdä	faire
niitä	leur
pitäisi	devrait
tuote	produit
järjestelmä	système
lähettää	poster
hänen	sa
kaupunki	ville
T	t
politiikka	politique
määrä	nombre
tuki	soutien
viesti	message
jälkeen	après
sitten	puis
tammikuu	jan
hyvä	bien
d	ré
missä	où
tiedot	Info
oikeudet	droits
kirjat	livres
korkea	haute
koulu	école
m	m
kukin	chaque
linkit	liens
hän	elle
vuotta	années
tilata	commande
erittäin	très
kirja	livre
kohdetta	articles
yhtiö	compagnie
R	r
lukea	lis
ryhmä	groupe
sukupuoli	sexe
monet	beaucoup
käyttäjä	utilisateur
de	de
sarja	ensemble
yleinen	général
tutkimus	recherche
yliopisto	Université
tammikuu	janvier
posti	courrier
koko	plein
arvostelut	avis
ohjelmoida	programme
tietää	connaître
pelit	Jeux
tapa	façon
päivää	journées
p	p
osa	partie
voisi	pourrait
loistava	génial
yhdistynyt	uni
todellinen	réal
f	F
kansainvälinen	international
keskusta	centre
matkustaa	Voyage
kommentit	commentaires
tehty	fabriqué
kehitys	développement
raportti	rapport
jäsen	membre
yksityiskohdat	détails
linja	ligne
ehdot	termes
ennen	avant
hotellit	hôtels
teki	fait
lähettää	envoyer
oikea	droite
tyyppi	type
paikallinen	local
nuo	ceux
tulokset	résultats
toimisto	Bureau
kansallinen	nationale
auto	voiture
design	conception
ottaa	prendre
lähetetty	posté
osoite	adresse
Yhteisö	communauté
sisällä	dans
valtiot	États
haluta	vouloir
puhelin	téléphone
DVD	DVD
aihe	assujettir
välillä	entre
foorumi	forum
perhe	famille
l	l
pitkä	longue
w	w
show	montrer
O	o
jopa	même
musta	noir
erityinen	spécial
indeksi	indice
ollessa	étant
naiset	femmes
paljon	beaucoup
merkki	signe
tiedosto	fichier
linkki	lien
avata	ouvrir
etelä	Sud
tapaus	Cas
projekti	projet
sivut	pages
versio	version
jakso	section
oma	posséder
talo	maison
turvallisuus	Sécurité
g	g
lääni	comté
amerikkalainen	américain
kuva	photo
peli	Jeu
jäsenet	membres
teho	Puissance
verkko	réseau
tietokone	ordinateur
järjestelmät	systèmes
kolme	Trois
paikka	endroit
pää	fin
h	h
häntä	lui
kohti	par
pääsy	accès
ajatella	pense
pohjoinen	Nord
voimavarat	Ressources
nykyinen	actuel
iso	gros
tiedotusvälineet	médias
laki	loi
ohjaus	contrôle
vesi	eau
historia	histoire
koko	Taille
henkilökohtainen	personnel
opas	guider
myymälä	boutique
hakemisto	annuaire
muuttaa	changement
valkoinen	blanc
teksti	texte
pieni	petit
luokitus	évaluation
nopeus	taux
hallitus	gouvernement
lapset	enfants
palata	revenir
opiskelijoille	élèves
v	v
tili	Compte
ajat	fois
taso	niveau
digitaalinen	numérique
profiili	profil
Edellinen	précédent
muoto	forme
Tapahtumat	événements
rakkaus	amour
vanha	vieux
Johannes	John
tärkein	principale
puhelu	appel
kuva	image
osasto	département
otsikko	Titre
ei	non
K	k
y	y
vakuutus	Assurance
on	doit
omaisuus	propriété
luokka	classe
CD	CD
laatu	qualité
joka	chaque
listaus	inscription
pitoisuus	contenu
maa	pays
vähän	peu
Työkalut	outils
matala	faible
Vastaa	répondre
asiakas	client
joulukuu	décembre
vertailla	comparer
elokuvat	films
college	Université
arvo	valeur
artikla	article
mies	homme
työpaikkaa	emplois
j	j
ruoka	aliments
kirjailija	auteur
eri	différent
U	u
oppia	apprendre
myynti	vente
Tulosta	impression
kurssi	cours
Job	emploi
huone	chambre
kalusto	Stock
koulutus	entraînement
liian	aussi
luotto	crédit
kohta	point
tiede	science
miehet	Hommes
luokat	catégories
länsi	Ouest
Katso	Regardez
Englanti	Anglais
tiimi	équipe
omaisuus	biens
laatikko	boîte
olosuhteet	conditions
Valokuvat	Photos
homo	gai
lanka	fil
kategoria	Catégorie
Huomautus	Remarque
elää	vivre
suuri	grand
galleria	Galerie
pöytä	table
kuitenkin	toutefois
kesäkuu	juin
lokakuu	octobre
marraskuu	novembre
markkinoida	marché
kirjasto	bibliothèque
toiminta	action
alkaa	début
sarja	séries
ominaisuudet	fonctionnalités
ilma	air
ala	industrie
suunnitelma	plan
ihmisen	Humain
Joo	Oui
toinen	seconde
kuuma	chaud
kustannus	Coût
elokuva	film
foorumit	forums
maaliskuu	Mars
la	la
syyskuu	septembre
sanoa	dire
menossa	Aller
lääketieteellinen	médical
ystävä	ami
joulukuu	déc
palvelin	serveur
hakemus	application
henkilöstö	Personnel
pelata	jouer
kysymykset	problèmes
huhtikuu	avril
käyttäjät	utilisateurs
katu	rue
aihe	sujet
vastaan	contre
sai	eu
blogi	Blog
juhla	fête
maksu	Paiement
laitteet	équipement
antaa	laisser
ohjelmat	programmes
oikeudellinen	légal
viimeaikainen	récent
pysäköidä	parc
toimia	acte
ongelma	problème
punainen	rouge
antaa	donner
muisti	Mémoire
esitys	performance
sosiaalinen	social
q	q
tarina	récit
myydä	vendre
vaihtoehtoja	Options
kokea	expérience
avain	clé
ruumis	corps
nuori	Jeune
tärkeä	important
ala	champ
harvat	peu
itään	est
yksittäinen	unique
ii	ii
ikä	âge
klubi	club
esimerkki	Exemple
tytöt	filles
z	z
tie	route
lahja	cadeau
kysymys	question
ca	Californie
kova	difficile
maksaa	Payer
neljä	quatre
pokeri	poker
ongelma	problème
alue	gamme
rakennus	bâtiment
myyjä	vendeur
tuomioistuin	tribunal
helmikuu	février
tulos	résultat
valo	lumière
kirjoittaa	écrire
sota	guerre
tarjous	offre
sininen	bleu
ryhmät	groupes
ai	Al
helppo	facile
tietty	donné
pyyntö	demande
faksi	fax
Kiina	Chine
tehdä	fabrication
kuva	image
tarpeisiin	Besoins
mahdollinen	possible
kuukausi	mois
suuri	Majeur
tähti	étoile
tulevaisuus	avenir
tila	espace
komitea	Comité
käsi	main
aurinko	Soleil
kortit	cartes
Lontoo	Londres
tapaaminen	réunion
tulla	devenir
lapsi	enfant
pitää	garder
porno	porno
Jaa	partager
samankaltainen	similaire
puutarha	jardin
koulut	écoles
miljoona	million
lisättyä	ajoutée
viite	référence
yritykset	entreprises
vauva	bébé
oppiminen	apprentissage
energia	énergie
juosta	courir
toimitus	livraison
suosittu	populaire
termi	terme
elokuva	film
tarinoita	histoires
laittaa	mettre
päiväkirja	journal
raporttien	rapports
co	co
yrittää	essayer
kuvien	images
ilmoitus	remarquer
Jumala	Dieu
alkuperäinen	original
pää	tête
radio	radio
solu	cellule
neuvosto	conseil
sisältää	comprend
seurata	Piste
keskustelu	discussion
arkisto	archiver
toiset	autres
sopimus	accord
muoto	format
yhteiskunta	société
kuukaudet	mois
turvallisuus	sécurité
ystävät	copains
varma	sûr
painos	édition
viestien	messages
markkinointi	commercialisation
kertoa	dire
yhdistys	association
tarjoaa	fournit
hauska	amusement
jo	déjà
vihreä	vert
opinnot	études
kiinni	Fermer
yhteinen	commun
erityinen	spécifique
useat	nombreuses
elävä	vivant
kokoelma	collection
nimeltään	appelé
lyhyt	court
arts	lettres
erä	lot
kysyä	demander
rajallinen	limité
ratkaisut	solutions
johtaja	réalisateur
ranta	plage
menneisyys	passé
luonnollinen	Naturel
elektroniikka	électronique
päälle	sur
aika	période
suunnittelu	Planification
sanoo	dit
virallinen	officiel
maaliskuu	mar
tehty	terminé
tekninen	technique
ikkuna	fenêtre
ammattilainen	pro
alue	Région
saari	île
ennätys	record
suoraan	direct
konferenssi	conférence
asiakirjat	archives
st	st
piiri	district
kalenteri	calendrier
kustannukset	frais
tyyli	style
selvitys	déclaration
mailia	miles
resurssi	Ressource
sovellukset	applications
asiakirja	document
sana	mot
teokset	travaux
materiaali	Matériel
laskuttaa	facture
kirjallinen	écrit
säännöt	règles
lopullinen	final
asia	chose
keskusta	centre
vaatimuksista	exigences
TOTTA	VRAI
minuutit	minutes
muu	autre
merkki	marque
rock	Roche
huono	mal
yksilö	individuel
plus	plus
auto	auto
peite	couverture
muokata	modifier
yhdessä	ensemble
Videot	vidéos
nopeasti	vite
toiminto	fonction
tosiasia	fait
saada	obtention
maailmanlaajuinen	global
teknologia	technologie
tavata	rencontrer
pitkälle	loin
taloudellinen	économique
fi	en
pelaaja	joueur
hankkeet	projets
määrä	montant
katsella	regarder
Sisältää	inclus
tuntea	ressentir
pankki	banque
riski	risque
tarjoukset	offres
eri	divers
sanat	mots
tuotanto	production
kaupallinen	commercial
paino	poids
sydän	cœur
hoito	traitement
pistettä	points
tuntemus	connaissance
aikakauslehti	magazine
virhe	Erreur
kamera	caméra
tyttö	fille
rakentaminen	construction
lelut	jouets
kirjattu	inscrit
verkkotunnuksen	domaine
menetelmät	méthodes
luku	chapitre
suojaus	protection
politiikkaa	politiques
leveä	large
kauneus	beauté
johtaja	directeur
Intia	Inde
asento	position
otettu	pris
järjestellä	Trier
listat	annonces
tunnettu	connu
puoli	moitié
tapauksissa	cas
vaihe	étape
tekniikka	ingénierie
yksinkertainen	simple
nopea	rapide
lisenssi	Licence
järvi	Lac
koko	entier
vuotuinen	annuel
julkaistu	publié
kirkko	église
menetelmä	méthode
aktiivinen	actif
vastaus	réponse
kuva	figure
tarvikkeet	matériaux
tarpeeksi	assez
suunnitellut	conçu
keskuudessa	parmi
kuolema	décès
menetys	perte
kasvot	visage
brändi	marque
alennus	remise
tehosteet	effets
luotu	créé
standardit	normes
bitti	bit
poliittinen	politique
kuningaskunta	Royaume
pohja	base
tekemässä	Faire
lainat	prêts
kengät	chaussures
merkintä	entrée
pysyä	rester
tilaukset	ordres
saatavuus	disponibilité
yhteenveto	résumé
vuoro	tour
kasvu	croissance
toimisto	agence
kuningas	Roi
eurooppalainen	européen
aktiviteetti	activité
kopio	copie
Läntinen	occidental
pakottaa	Obliger
työllisyys	emploi
lahti	baie
joki	rivière
komissio	commission
paketti	paquet
nähdään	vu
pelaajat	joueurs
moottori	moteur
portti	Port
albumi	album
alueellinen	régional
Stop	Arrêtez
aloitti	commencé
antaminen	administration
baari	bar
instituutti	institut
näkymät	vues
kaksinkertainen	double
koira	chien
pian	bientôt
linjat	lignes
elektroninen	électronique
hyötyjä	avantages
tarvittu	nécessaire
kirjoitin	imprimante
kunto	condition
tehokas	efficace
uskoa	croyez
organisaatio	organisation
vaikutus	effet
mieli	esprit
valinta	sélection
kasino	casino
PDF	pdf
kiertue	tour
ylittää	traverser
toivoa	espérer
yhtiö	société
toive	souhait
ratkaisu	Solution
kypsä	mature
rooli	rôle
viikkoa	semaines
tietty	certain
alempi	inférieur
välttämätön	nécessaire
liitto	syndicat
mon	lun
com	com
tietty	particulier
hieno	bien
tunnin	heure
kaasu	gaz
taidot	compétences
kuusi	six
Puska	buisson
saaret	îles
neuvot	Conseil
ura	carrière
päätös	décision
jättää	laisser
pre	pré
valtava	énorme
nainen	femme
laitteisto	installations
tarjous	offre
keskimmäinen	milieu
kaapeli	câble
mahdollisuudet	Opportunités
ottaen	prise
arvot	valeurs
jako	division
tuleva	arrivant
esine	objet
lesbo	lesbienne
sopiva	approprié
kone	machine
logo	logo
pituus	longueur
kiva	agréable
pisteet	But
tilasto	statistiques
asiakas	client
näyte	échantillon
investointi	investissement
lähetetty	envoyé
esitetty	montré
joulu	Noël
kulttuuri	Culture
salama	flash
neiti	Mme
valinta	choix
kurssit	cours
kuluttaja	consommateur
Moi	salut
ulkomainen	étranger
taiteilija	artiste
huonekalut	meubles
kanava	canal
kirje	lettre
tila	mode
puhelimet	Téléphones
ideoita	idées
rakenne	structure
aste	degré
sopimus	Contrat
Super	super
Uros	mâle
asia	matière
melkein	presque
sijaitsevat	situé
moninkertainen	plusieurs
jakelu	Distribution
toimittaja	éditeur
majatalo	auberge
teollinen	industriel
mahdollinen	potentiel
laulu	chanson
los	los
pudota	tomber
ajatus	idée
Huoneet	pièces
viestintä	communications
voittaa	gagner
ensisijainen	primaire
syöpä	cancer
numerot	Nombres
syy	raison
työkalu	outil
kevät	printemps
perusta	fondation
vastaus	répondre
ääni	voix
ajoittaa	programme
asiakirjat	documents
tarkoitus	objectif
ominaisuus	fonctionnalité
sänky	lit
tulee	vient
Poliisi	police
itsenäinen	indépendant
lähestyä	approche
ruskea	marron
fyysinen	physique
mäki	colline
kartat	Plans
pitää	tenir
luokitukset	évaluations
onnellinen	content
seppä	forgeron
kehittyneillä	développé
kiittää	remercier
turvallinen	sûr
ainutlaatuinen	unique
tutkimus	enquête
ennen	avant
puhelin	Téléphone
Urheilu	sport
valmis	prêt
eläin	animal
lähteet	sources
väestö	population
pa	Pennsylvanie
säännöllinen	ordinaire
turvallinen	garantir
toiminnot	opérations
yksinkertaisesti	simplement
näyttö	preuve
asema	gare
ymmärtää	comprendre
vaihtoehto	option
laakso	vallée
todennäköisesti	Probablement
meri	mer
Julkaisut	publications
parantaa	améliorer
yhteys	connexion
kustantaja	éditeur
sali	salle
anti	anti
verkot	réseaux
maa	Terre
vanhemmat	Parents
vaikutus	impact
siirtää	transfert
esittely	introduction
keittiö	cuisine
vahva	fort
häät	mariage
ominaisuudet	Propriétés
sairaala	hôpital
maa	sol
alus	navire
majoitus	hébergement
tauti	maladie
erinomainen	excellent
täydellinen	parfait
hiukset	cheveux
tilaisuus	opportunité
pakki	trousse
klassikko	classique
perusta	base
komento	commander
kaupungit	villes
ilmaista	Express
myöntää	prix
etäisyys	distance
puu	arbre
arviointi	évaluation
seinä	mur
osallistuva	impliqué
el	el
ylimääräinen	supplémentaire
erityisesti	notamment
talousarvio	budget
oppaita	guides
menestys	Succès
enimmäismäärä	maximum
äiti	mère
operaatio	opération
nykyinen	existant
melko	assez
valittu	choisi
poika	garçon
ravintolat	Restaurants
kaunis	beau
Varoitus	Attention
sijainnit	Emplacements
hevonen	cheval
äänestys	vote
kukat	fleurs
tähdet	étoiles
luettelot	listes
omistaja	propriétaire
eläimet	animaux
tapoja	façons
poika	fils
tarjoaminen	fournir
sääntö	règle
kotelo	logement
kestää	prend
tuoda	apporter
luettelo	catalogue
max	max
äiti	mère
auktoriteetti	autorité
kertoi	Raconté
ohjelmoida	programme
liittyi	relié
panos	contribution
strategia	stratégie
jalkaa	pieds
agentti	agent
pätevä	valide
moderni	moderne
vanhempi	Sénior
seksikäs	sexy
opetus	enseignement
ovi	porte
suuri	grandiose
oikeudenkäynti	procès
yksiköt	unités
viileä	cool
normaali	Ordinaire
yritys	entreprise
laivat	navires
koko	tout
positiivinen	positif
kunto	aptitude
Kiinalainen	chinois
lausunto	opinion
jalkapallo	Football
abstrakti	abstrait
ulostulo	sortie
varat	fonds
Herra	M
todennäköisesti	probable
kehittää	développer
Taiteilijat	artistes
vaihtoehto	alternative
vastuu	responsabilité
Jaava	Java
vieras	client
julkaisu	publication
kulkea	passer
suhteet	rapports
luottamus	confiance
pakettiauto	van
sisältää	contient
multi	multi
tasavalta	république
palkkiot	honoraires
komponentit	Composants
loma	vacances
vuosisata	siècle
akateeminen	académique
apu	assistance
valmistunut	terminé
iho	peau
grafiikka	graphique
intialainen	Indien
rengas	bague
arvosana	qualité
vuori	Montagne
organisaatioiden	organisations
suodattaa	filtre
paneeli	panneau
lattia	sol
ostaminen	achat
ottelu	rencontre
ehdotettu	proposé
vaatia	exiger
pojat	garçons
aamu	Matin
sallii	permet
proteiini	protéine
kasvi	plante
raportoitu	signalé
osuma	frappé
mm	mm
pool	bassin
mini	mini
politiikka	politique
kumppani	partenaire
kirjoittajat	auteurs
levyt	planches
kalastaa	poisson
jäsenyys	adhésion
tehtävä	mission
silmä	œil
jono	chaîne
tunne	sens
muokattu	modifié
julkaisi	libéré
vaihe	étape
sisäinen	interne
syntynyt	née
yksityiskohtainen	détaillé
japanilainen	Japonais
rotu	course
hyväksytty	approuvé
kohde	cible
paitsi	sauf
merkki	personnage
ylläpito	entretien
kyky	aptitude
toim	ed
raiskata	râpé
akku	batterie
nuoret	jeunesse
paine	pression
toimitettu	soumis
velka	dette
keskikokoinen	moyen
televisio	télévision
kiinnostunut	intéressé
ydin	coeur
tauko	Pause
tarkoituksiin	fins
setit	ensembles
tanssi	Danse
puu	bois
määritellyt	défini
paperit	papiers
palkinnot	prix
maksu	frais
studio	studio
lukija	lecteur
laite	dispositif
perusti	établi
vastauksia	réponses
vuokrata	location
las	Las
tumma	foncé
ulkoinen	externe
omena	Pomme
le	le
ohjeet	instructions
min	min
tarjotaan	offert
teoria	théorie
poistaa	retirer
apu	aide
visuaalinen	visuel
isäntä	hôte
lajike	variété
opettajat	enseignants
manuaalinen	Manuel
lohko	bloc
aiheita	sujets
aineet	agents
korjaus	réparation
oikeudenmukainen	juste
teräs	acier
ymmärtäminen	compréhension
lauluja	Chansons
kiinteä	fixé
väärä	faux
alku	début
käsissä	mains
az	az
Pariisi	Paris
saa	obtient
sektori	secteur
kapasiteetti	capacité
un	ONU
rasva	graisse
isä	père
sähköinen	électrique
näin	vu
välineet	instruments
upseeri	officier
kuljettaja	chauffeur
yritykset	entreprises
kuollut	mort
tuntematon	inconnu
ravintola	restaurant
mikrofoni	Mike
matka	voyage
mi	mi
huono	pauvre
yhteys	relation
työntekijöiden	ouvriers
rauha	paix
perinteinen	traditionnel
osoittavat	projection
luova	Créatif
rannikko	côte
hyöty	avantage
rahoitus	financement
laitteet	dispositifs
herra	Seigneur
myöntää	subvention
sub	sous
kaunokirjallisuus	fiction
kellot	montres
uraa	carrières
menee	va
led	LED
museo	musée
tuuletin	ventilateur
kuljetus	transport
mielenkiintoista	intéressant
blogit	blogs
arviointi	évaluation
entinen	ancien
vyöhyke	zone
monimutkainen	complexe
th	e
kissa	chat
kuolla	mourir
esittelyyn	présenté
tasainen	appartement
virtaus	couler
virastojen	agences
kirjallisuus	Littérature
vanhempi	parent
asetus	réglage
DR	dr
asteikko	échelle
talous	économie
hyödyllinen	utile
kuukausittain	mensuel
kriittinen	critique
kehys	Cadre
musikaali	musical
määritelmä	définition
sihteeri	secrétaire
polku	chemin
päällikkö	chef
antaa	donne
paketit	paquets
yksityiskohta	détail
lait	lois
muutettu	modifié
alkaa	commencer
kuninkaallinen	Royal
puhdas	nettoyer
kaveri	gars
otsikot	titres
merkityksellinen	pertinent
oikeudenmukaisuus	Justice
kytkeä	relier
kuppi	Coupe
kori	panier
soveltava	appliqué
viikoittain	hebdomadaire
vol	vol
asennus	installation
pp	pp
huomio	attention
edetä	avance
hyppiä	sauter
ruokavalio	régime
armeija	armée
vaihde	équipement
ero	différence
sallittu	permis
oikea	correct
kansakunta	nation
myynti	vente
paljon	beaucoup
pala	pièce
arkki	drap
yritys	raffermir
seitsemän	Sept
elementtejä	éléments
laji	espèce
hypätä	saut
solut	cellules
moduuli	module
lomakeskus	recours
todistus	certificat
ministeri	ministre
liike	mouvement
muoti	mode
ohjeet	directions
vierailijat	visiteurs
dokumentointi	Documentation
kaupankäynti	commerce
metsä	forêt
puhelut	appels
kattavuus	couverture
pari	couple
antaminen	donnant
mahdollisuus	chance
näkemys	vision
pallo	ballon
pääte	fin
asiakkaat	clients
toimet	actes
keskustella	discuter
tavoite	objectif
onnistunut	réussi
myyty	vendu
tuuli	vent
yhteisöt	communautés
kliininen	clinique
tilanne	situation
markkinat	marchés
kustannustoiminta	édition
ilmestyä	apparaître
kehittämällä	développement
elämää	vies
määrittää	déterminer
lämpötila	Température
ilmoitukset	annonces
potilas	patient
todellinen	réel
historiallinen	historique
kivi	pierre
Bob	bob
kaupankäynti	Commerce
henkilöt	personnes
vaikea	difficile
tieteellinen	scientifique
satelliitti	Satellite
testit	essais
kylä	village
tilit	comptes
amatööri	amateur
entinen	ex
tavannut	rencontré
kipu	douleur
tekijät	facteurs
kahvi	café
ostaja	acheteur
juliste	affiche
reuna	bord
toiminnallinen	fonctionnel
juuri	racine
fi	Fi
suljettu	fermé
juhlapäivät	vacances
vaaleanpunainen	rose
saldo	équilibre
seuranta	surveillance
vastaukset	réponses
laukaus	coup
alkukirjain	initiale
etiketti	étiquette
sec	seconde
kaanon	canon
liiga	ligue
jätteet	déchets
minuutti	minute
bussi	autobus
toimittaja	fournisseur
sanakirja	dictionnaire
kirjanpito	comptabilité
valmistus	fabrication
osiot	sections
tuoli	chaise
ponnistus	effort
vaihe	phase
fantasia	fantaisie
po	po
va	Virginie
professori	professeur
Asentaa	installer
paita	chemise
vaatteet	vêtements
jalka	pied
rinta	Sein
tekniikat	techniques
dollaria	dollars
uskonto	religion
lupa	autorisation
villi	sauvage
sukupolvi	génération
neiti	manquer
kemiallinen	chimique
lääkäri	docteur
tehtävä	tâche
vähentää	réduire
toi	apporté
liikunta	exercice
vika	punaise
takuu	garantie
johtaja	chef
SE	se
prosessit	processus
pehmeä	doux
kokoukset	réunions
sekuntia	secondes
lento	vol
kongressi	congrès
polttoaine	carburant
kävellä	marche
valmistettu	produit
pyhimys	Saint
Perustelu	argument
kilpailu	compétition
huumeita	drogues
yhteinen	mixte
palkkio	prime
tuore	Frais
merkkiä	personnages
asianajaja	avocat
di	di
tekijä	facteur
tuhansia	milliers
km	km
virta	courant
huoneisto	appartements
valita	choisir
kuulo	audition
itäinen	est
terapia	thérapie
merkinnät	entrées
allekirjoitettu	signé
hallinnollinen	administratif
vakava	sérieux
raja	limite
askeleet	pas
kaupat	magasins
orjuus	esclavage
del	del
pyrkimyksiä	efforts
ilmoitti	informé
ga	Géorgie
ajatuksia	pensées
puro	ruisseau
ft	ft
määrä	quantité
olennainen	essentiel
matkat	Tours
ladata	charge
heti	immédiatement
koneet	Machines
nimetty	désigné
raskas	lourd
katettu	couvert
elpyminen	récupération
integroitu	intégré
kokoonpano	configuration
kukko	coq
kauppias	marchande
kattava	complet
asiantuntija	expert
suojella	protéger
vankka	solide
esittely	présentation
tuli	devenu
oranssi	Orange
noudattaminen	conformité
teema	thème
rikas	riches
kampanja	campagne
vs	contre
kitara	guitare
havainto	découverte
esimerkkejä	exemples
henki	esprit
ar	ar
vaatimukset	réclamations
hyväksyminen	acceptation
strategiat	stratégies
mo	mo
asioihin	affaires
tarkoitettu	prévu
sa	sa
tavoitteet	buts
vuokraus	louer
vaalit	élection
ehdottaa	suggérer
haara	branche
palvella	servir
Kumppanit	affiliés
asentaa	monter
Latina	Latin
multimedia	multimédia
hoitaa	gérer
kulma	coin
arvo	rang
elementti	élément
syntymä	naissance
virus	virus
interaktiivinen	interactif
pyynnöt	demandes
erillinen	séparé
neljännes	trimestre
menettely	procédure
johto	direction
määritellä	définir
uskonnollinen	religieux
tosiasiat	faits
aamiainen	déjeuner
sarake	colonne
usko	Foi
ketju	chaîne
tunnistaa	identifier
katu	rue
puuttuva	disparu
suosituksia	recommandations
siirretty	déplacé
saavuttaa	atteindre
vertailu	Comparaison
hetki	moment
laajennettu	élargi
jakso	séquence
tuuma	pouce
hyökkäys	attaque
keskuksissa	centres
aukko	ouverture
laboratorio	laboratoire
varata	réserve
gamma	gamma
tuottaa	produire
totuus	vérité
laskuri	compteur
vika	échec
seuraa	suit
dollari	dollar
leiri	camp
des	des
elokuvat	films
silta	pont
täyttää	remplir
liike	mouvement
painaminen	impression
luonnos	Brouillon
kartoittaa	graphique
pelataan	joué
yhteystiedot	Contacts
lukijoita	lecteurs
risti	clubs
wa	Washington
seikkailu	aventure
uhri	offre
voitto	profit
johtajat	dirigeants
Julisteet	affiches
laitokset	institutions
avustaja	assistant
muuttuja	variable
dj	dj
pysäköinti	parking
eilen	hier
määritetty	déterminé
työpaja	atelier
mennyt	disparu
koodit	codes
Erilaisia	types
laajentaminen	extension
lausuntoja	déclarations
täysin	complètement
joukkueet	équipes
linnake	fort
cm	cm
senaatti	sénat
hauska	drôle
geeni	gène
kääntyi	tourné
levy	disque
kuvio	modèle
vene	bateau
teatteri	théâtre
valmistajat	fabricants
sponsori	parrainer
klassinen	classique
ikoni	icône
takuu	garantie
omistautunut	dévoué
suunta	direction
koripallo	basketball
esineet	objets
poistaa	effacer
ilta	soir
kokoonpano	Assemblée
ydinaseiden	nucléaire
hiiri	Souris
signaali	signal
rikollinen	criminel
annettu	Publié
voimakas	puissant
unelma	rêver
VÄÄRÄ	FAUX
da	da
heittää	jeter
kukka	fleur
henkilöstö	personnel
läpäissyt	passé
toimitetaan	fourni
Falls	chutes
sielu	âme
edistää	promouvoir
totesi	déclaré
tilastot	Statistiques
ammattilaisten	professionnels
näyttää	apparaît
kuljettaa	porter
lippu	drapeau
kannet	couvertures
em	em
etu	avantage
Hei	Bonjour
malleja	dessins
ylläpitää	maintenir
matkailu	tourisme
prioriteetti	priorité
aikuiset	adultes
graafinen	graphique
atomi	atome
maksut	Paiements
sitova	contraignant
lyhyt	bref
päättyi	terminé
voittoisa	gagnant
anonyymi	anonyme
käsikirjoitus	scénario
palveli	servi
haluaa	veut
valmis	préparé
mitätön	vide
tag	marque
haastatella	entretien
sekoittaa	mélanger
puitteet	cadre
levy	disque
asennetut	installée
kuningatar	reine
ov	crédits
selvästi	clairement
korjata	réparer
kahva	manipuler
makea	doux
kriteeri	Critères
kumppani	associer
NE	ne
käytös	comportement
suurentaa	agrandir
säde	rayon
tulot	revenu
mitata	mesure
ääntä	votes
du	du
velvollisuus	devoir
keskustelut	discussions
karhu	ours
saada	Gain
festivaali	Festival
laboratorio	laboratoire
valtameri	océan
lennot	vols
asiantuntijat	experts
merkkejä	signes
syvyys	profondeur
kouluttaa	train
kuiva	sec
tutkia	explorer
kylpylä	spa
konsepti	concept
lähes	presque
käsittely	manipulation
alkuperä	origine
miljardi	milliard
älykkyys	intelligence
ostettu	acheté
huijaus	escroquerie
kansakunnat	nations
reitti	route
rikki	cassé
taistelu	bataille
puhua	parler
protokolla	protocole
tiedustelu	question
kumppanuus	Partenariat
ilmaisu	expression
es	es
puhe	discours
johdin	câble
ehdotukset	suggestions
korvaus	remplacement
nauha	ruban
strateginen	stratégique
tuomari	juge
happo	acide
tavua	octets
sentti	cent
pakko	forcé
yhteensopiva	compatible
huoneisto	appartement
tyhjä	nul
nolla	zéro
kaiutin	orateur
konsultointi	consultant
suunnittelija	designer
PR	pr
avioliitto	mariage
rulla	rouleau
pankit	banques
FR	fr
osallistujaa	participants
salaisuus	secret
negatiivinen	négatif
suosikit	favoris
teatteri	théâtre
jouset	ressorts
var	var
suorittaa	effectuer
käännös	Traduction
arvioiden	estimations
vahinko	blessure
ministeriö	ministère
kuljettajat	conducteurs
lakimies	avocat
luvut	chiffres
suojattu	protégé
ehdotus	proposition
jakaminen	partage
portaali	portail
beeta	bêta
ilmaiseksi	gratuitement
kohti	vers
hieman	légèrement
avustaa	aider
käytös	conduite
sisälsi	contenu
lainsäädäntö	législation
kutsumus	appel
parametrit	paramètres
profiilit	profils
asioissa	questions
talot	Maisons
ohjaimet	contrôles
Yhdistetty	combiné
perimmäinen	ultime
edustaja	représentant
vähäinen	mineur
osastot	départements
asukkaat	résidents
näyttöön	affiché
äiti	maman
pelkistetty	réduit
harvinainen	rare
suoritettu	réalisée
äärimmäinen	extrême
näytteet	échantillons
baarit	barres
ennuste	prévoir
poistettu	supprimé
sykli	cycle
sisältää	contenir
tarkkuus	précision
nukkua	dormir
mg	mg
lintu	oiseau
apteekki	pharmacie
luominen	création
staattinen	statique
metsästäjä	chasseur
osoitteet	adresses
nainen	Dame
kristalli	cristal
kuuluisa	célèbre
kirjailija	écrivain
puheenjohtaja	président
juoda	boisson
akatemia	académie
dynaaminen	dynamique
syödä	manger
pysyvä	permanent
puhdistus	nettoyage
muodostaa	constitue
salkku	portefeuille
käytännöllinen	pratique
toimitetaan	livré
infrastruktuuri	Infrastructure
väri	Couleur
myyjä	vendeur
filosofia	philosophie
säätö	règlement
upseerit	officiers
tavoite	objectif
tarjouksia	offres
ravitsemus	nutrition
äänite	enregistrement
nuorempi	junior
les	les
viitta	cap
renkaat	anneaux
kärki	pointe
ihana	formidable
lippu	billet
ilmoitti	annoncé
arvaus	deviner
ketä	qui
jalkapallo	football
matematiikka	math
tuonti	importer
komennus	affectation
läsnäolo	présence
Automaattinen	automatique
katselu	visualisation
säilyy	entretenu
ch	ch
dan	dan
koirat	chiens
johtajat	directeurs
näkökohdat	aspects
eteenpäin	devant
kuu	lune
osallistumista	participation
ohjelma	schème
lentää	mouche
tapa	manière
matriisi	matrice
yhdistelmä	combinaison
muutos	amendement
vahvuus	force
Turkki	dinde
kirjastot	bibliothèques
asianmukainen	correct
astetta	degrés
yrityksille	entreprises
delta	delta
pelko	peur
etsiä	recherche
tuumaa	pouces
sopimus	convention
osakkeiden	actions
pääasiallinen	principal
mukavuus	confort
värit	couleurs
sodat	guerres
tilaaminen	commande
säilytetään	conservé
alfa	alpha
valitus	charme
risteily	croisière
bonus	prime
Hei	Hey
rakennukset	bâtiments
tarjoukset	promos
lyödä	battre
akut	batteries
tulee	devient
asemat	disques
aseet	bras
tee	thé
parantunut	amélioré
saavuttaa	atteindre
kannat	positions
pukeutua	robe
tilaus	abonnement
jakaja	Marchand
nykyajan	contemporain
taivas	ciel
rom	ROM
kuljettaa	porté
valotus	exposition
piilottaa	cacher
allekirjoitus	Signature
mylläri	meunier
säännös	disposition
vaatteet	vêtements
kehyksiä	cadres
varmasti	certainement
sanomalehti	journal
lelu	jouet
kerros	couche
painettu	imprimé
hidas	lent
poistaminen	suppression
vastuu	responsabilité
tulostimet	imprimantes
lisäämällä	ajouter
täplä	place
viettää	dépenser
tehdas	usine
sisusta	intérieur
kasvaa	croître
optinen	optique
edistäminen	promotion
suhteellinen	relatif
hämmästyttävä	incroyable
piste	point
identiteetti	identité
muuntaminen	conversion
tunne	sentiment
kätketty	caché
kohtuullinen	raisonnable
tarkistus	révision
vaikutus	influence
suhde	rapport
merkitys	importance
sade	pluie
planeetta	planète
kappaletta	copies
lupa	permis
koska	voyant
todiste	preuve
basso	basse
resepti	ordonnance
tyhjä	vide
ilmentymä	exemple
reikä	trou
ratsastaa	balade
toimisto	bureau
säilyttäminen	préservation
pari	paire
ihanteellinen	idéal
silmälasit	spécification
tallennettu	enregistré
Don	Don
kappaletta	pièces
päättynyt	fini
puistot	parcs
lakimiehet	avocats
stressi	stress
kerma	crème
ss	ss
ajot	fonctionne
löytää	découvrir
ap	ap
kuviot	modèles
Hills	collines
nm	nm
neuvonantaja	conseiller
tietoinen	conscient
muoto	forme
evoluutio	évolution
todistukset	certificats
tavoitteet	objectifs
asemat	stations
ehdotti	suggéré
op	op
jäännökset	restes
yritykset	entreprises
euro	euro
operaattori	opérateur
rakenteet	structures
yleinen	générique
tietosanakirja	encyclopédie
käyttö	usage
muste	encre
sekoitettu	mixte
väestönlaskenta	recensement
pyörä	roue
toimittajat	Fournisseurs
kompakti	compact
runous	poésie
valot	lumières
seuranta	suivi
enkeli	ange
valmistautuminen	préparation
yrittää	tentative
vastaanotetaan	recevoir
Ottelut	allumettes
mukaisesti	conformité
leveys	largeur
moottorit	moteurs
unohtaa	oublier
ryhmä	tableau
keskusteltiin	discuté
tarkka	précis
ilmasto	climat
kreikkalainen	grec
ohje	instruction
hallinnassa	gérant
raaka	brut
erot	différences
selittää	Explique
perustaa	établir
ilmaisi	exprimé
laajuus	ampleur
terävä	tranchant
ben	ben
kohta	paragraphe
tappaa	tuer
matematiikka	mathématiques
korvaus	compensation
viedä	exportation
johtajat	gestionnaires
moduulit	modules
suoritettu	menée
versiot	versions
tietää	sait
kuvata	décrire
kansalaiset	citoyens
perintö	patrimoine
vaivata	difficulté
valmentaja	entraîneur
maatalous	agricole
laajentaa	développer
yleisö	public
osoitettu	attribué
kokoelmat	collections
iät	âge
asiantuntija	spécialiste
kokki	cuisinier
vaikuttaa	affecter
Neitsyt	vierge
kokenut	expérimenté
tutkimus	enquête
nosti	relevé
hattu	chapeau
instituutio	institution
suunnattu	dirigée
vaikuttaa	affecté
pyörä	bicyclette
täysin	totalement
levy	assiette
kulut	frais
osoittaa	indiquer
vaalea	blond
menettely	procédure
suosikki	préféré
ominaisuudet	caractéristiques
der	der
menettää	perdre
orgaaninen	biologique
etsiä	chercher
kokemukset	expériences
albumit	albums
sopimuksia	contrats
vieraita	invités
isännöi	hébergé
sairaudet	maladies
koskevat	concernant
vastaava	équivalent
kemia	chimie
sarjat	kits
logiikka	logique
prinssi	prince
ympyrä	cercle
maaperä	sol
psykologia	psychologie
märkä	humide
olosuhteet	conditions
sijoittaja	investisseur
perus	élémentaire
sponsorit	sponsors
kettu	Renard
rajoittamaton	illimité
vastata	répondre
koot	tailles
tavallinen	plaine
poistuminen	Sortie
käsivarsi	bras
näppäimet	clés
Aalto	vague
pyhä	saint
säädökset	actes
opastus	orientation
polku	Piste
symboli	symbole
valtatie	Autoroute
havaitun	observé
dekaani	doyen
perustaa	installer
äänestys	sondage
tyylit	modes
täynnä	rempli
side	liaison
kanavat	filières
liite	annexe
suklaa	Chocolat
osa	portion
laajuus	portée
toimittaja	fournisseur
kaapelit	câbles
puuvilla	coton
vaatimus	exigence
surmattu	tué
reunus	frontière
muinainen	ancien
keskustelu	débat
edustajia	représentants
alkaa	départs
raskaus	grossesse
nähtävyydet	attractions
oppinut	appris
liiketoimet	transactions
tutkimusmatkailija	explorateur
historiallinen	historique
aviomies	mari
valtuutettu	autorisé
hullu	fou
tuleva	prochain
konsertti	concert
tulokset	scores
tehokkuus	Efficacité
komedia	comédie
hyväksyttiin	adopté
tehokas	efficace
lineaarinen	linéaire
sitoutuminen	engagement
erikoisuus	spécialité
karhut	ours
hypätä	saut
kantaja	transporteur
jatkuva	constant
Visa	visa
suu	bouche
mittari	mètre
sidoksissa	lié
haastattelut	interviews
käsitteet	concepts
ase	pistolet
heijastaa	réfléchir
puhdas	pur
helvetti	enfer
hedelmä	fruit
alkaa	commence
pätevä	qualifié
uudistaa	réforme
linssi	lentille
käsitelty	traités
löytö	Découverte
piirtää	dessiner
luokiteltu	classifié
olettaa	assumer
liitto	Alliance
vahvistaa	confirmer
insinööri	ingénieur
johdonmukainen	cohérent
korvata	remplacer
raivaaminen	dégagement
muunnin	convertisseur
organisaatio	organisation
tyttö	bébé
tarkastuksia	chèques
saavuttanut	atteint
tulossa	devenir
tavoite	objectif
osoitettu	indiqué
sokeri	sucre
miehistö	équipage
jalat	jambes
tikku	bâton
suhde	relation
käytössä	activée
laji	genre
vapaaehtoinen	bénévole
takaosa	arrière
demokraattinen	démocratique
parantaa	améliorer
tarkka	exact
sidottu	lié
parametri	paramètre
suoritin	processeur
solmu	nœud
muodollinen	formel
myrsky	orage
mikro	micro
oppilaitokset	collèges
maili	mile
haasteet	défis
Editors	éditeurs
ylin	suprême
veljet	frères
tunnustus	reconnaissance
viite	ref
arvio	estimation
lapsi	enfant
tarkastus	inspection
kuluttajien	consommateurs
rajoja	limites
alue	territoire
aseet	armes
viive	retard
lentäjä	pilote
maksut	contributions
jatkuva	continu
aloite	initiative
uusi	roman
suoritus	exécution
vammaisuus	invalidité
ultra	ultra
voittaja	gagnant
episodi	épisode
savenvalaja	potier
ruokalaji	plat
pelaa	pièces
tiedotuslehti	bulletin
ia	ia
muuttaa	modifier
todella	vraiment
maailmankaikkeus	univers
ehdokas	candidat
aukko	fente
maksamatta	exceptionnel
ha	Ha
suunnitellut	prévu
jättää	loge
peili	miroir
turnaus	tournoi
harkinta	considération
istuntoja	sessions
ydin	noyau
ostajien	acheteurs
lehdet	revues
harmaa	gris
luettelo	catalogue
peritään	accusé
laaja	vaste
und	und
valittu	choisi
esittely	demo
vihata	haine
pääte	Terminal
julkaisijat	éditeurs
öisin	nuits
neste	liquide
riisi	riz
varaus	réservation
elintarvikkeet	nourriture
vartija	garde
tallentaa	économie
imperiumi	Empire
hiljattain	nouvellement
nostaa	élever
laiton	illégal
laajeneminen	expansion
johtava	premier
huomenna	demain
maito	Lait
draama	drame
vierailevat	visite
kilpailu	concours
koottu	collectées
bändejä	bandes
sopiva	adapté
ehdottomasti	absolument
tarkastaa	vérification
kammio	chambre
Guinea	Guinée
tulokset	résultats
ISO	iso
tyypillinen	typique
summa	somme
kana	poulet
tilapäinen	temporaire
käydä	assister
suihku	douche
lähettäminen	envoi
riittävä	suffisant
kuori	coquille
maakunta	Province
katolinen	catholique
kuvernööri	gouverneur
olut	Bière
panos	contribution
kaava	formule
perustuslaki	Constitution
pakkaus	emballage
luotettava	fiable
epäillä	doute
ansaita	gagner
aikoja	périodes
iskut	attaques
kauppatavara	marchandise
oireet	symptômes
muistomerkki	Mémorial
twin	double
lisätä	insérer
portti	passerelle
piirustus	dessin
ehdokkaat	candidats
tilasi	commandé
biologinen	biologique
taistelevat	combat
siirtyminen	transition
mieltymykset	préférences
vakooja	espion
romanssi	romance
väline	instrument
jakaa	Divisé
teemat	thèmes
valtuudet	pouvoirs
taivas	paradis
bitit	morceaux
raskaana	Enceinte
luokittelu	classification
keskittynyt	concentré
lääkäri	médecin
pyytäminen	demander
lohkot	blocs
katso	lo
hengellinen	spirituel
diabetes	Diabète
ml	ml
siirtää	décalage
istua	asseoir
elinten	corps
valokuvat	photographies
leikkaus	Coupe
kirjailijat	écrivains
joustava	flexible
rakastettu	aimé
suosikit	favoris
kartoitus	cartographie
useat	nombreux
suhteellisesti	relativement
edustaa	représente
esimies	supérieur
edullinen	préféré
tallennettu	enregistré
älyllinen	intellectuel
myönnetty	accordé
hiili	carbone
mukava	confortable
magneettinen	magnétique
vuorovaikutus	interaction
kuuntelee	écoute
kriisi	crise
näkymät	perspective
massiivinen	massif
kirkas	brillant
muodostettu	formé
piano	piano
kaiku	écho
vallankumous	révolution
näytöt	affiche
plasma	plasma
tulot	gains
mysteeri	mystère
maisema	paysage
mekaaninen	mécanique
matka	périple
lippu	bannière
kuva	figue
maakunnat	comtés
hankinta	acquisition
tunnistettu	reconnu
unelmat	rêves
ilmoitus	notification
kg	kg
opettaa	apprendre
nopea	rapide
Vedä	tirer
ut	Utah
seminaari	séminaire
investoinnit	investissements
pyörät	roues
eritellä	spécifier
herkkä	sensible
malleja	modèles
formaatit	formats
pitää	détient
reititin	routeur
betoni	béton
si	si
kansio	dossier
valmistuminen	achèvement
pulssi	impulsion
tekniikka	technique
äänestys	vote
tuomioistuimet	tribunaux
muunnettu	converti
metro	métro
vuosipäivä	anniversaire
parannuksia	améliorations
kaistale	bande
määrittely	spécification
onnettomuus	accident
lovi	entaille
saatavilla	accessible
asukas	résident
juoni	terrain
tyypillisesti	typiquement
edustus	représentation
pumppu	pompe
olemassa	existe
järjestelyt	arrangements
konferenssit	conférences
kulutus	consommation
kapea	étroit
uhkaus	menace
tutkimukset	enquêtes
istuva	séance
konsultti	consultant
ohjain	manette
valiokunnat	comités
penis	pénis
linna	Château
puutarhat	jardins
tarrat	Étiquettes
halukas	prêt
bio	bio
näytteleminen	agissant
päät	têtes
koe	examen
asuinpaikka	résidence
tiheys	densité
sata	cent
outo	étrange
kestävä	durable
tilastollinen	statistique
mainita	mention
innovaatio	innovation
harmaa	gris
rinnakkainen	parallèle
toimia	fonctionner
setelit	factures
vakaa	stable
määritelmät	définitions
von	von
lääkärit	médecins
oppitunti	leçon
elokuva	cinéma
vaalit	élections
reaktio	réaction
tyhjä	blanc
tehostettu	renforcée
oikeutettu	intitulé
vaikea	sévère
Tuottaa	produire
sanomalehdet	journaux
sairaalat	hôpitaux
vi	vi
huumori	humour
ikäinen	vieilli
näytöt	moniteurs
poikkeus	exception
kesto	durée
pääosa	masse
käyntiä	visites
kyvyt	capacités
suositus	recommandation
synti	péché
järjestetty	organisé
ba	ba
kappale	para
hyväksyminen	adoption
parantaminen	améliorer
kallis	coûteux
puhveli	buffle
organisaatioiden	organisations
kone	avion
ohjelmat	programmes
mekanismi	mécanisme
ee	ee
merkitty	marqué
ajettu	poussé
pullo	bouteille
innovatiivinen	innovant
hieronta	massage
johtopäätös	conclusion
sulkeminen	fermeture
tuhat	mille
legenda	Légende
huvila	villa
luu	OS
pylväät	colonnes
häiriöt	troubles
yhteistyö	collaboration
havaitseminen	détection
sisäinen	interne
muodostus	formation
med	med
insinöörien	ingénieurs
kokonaisuus	entité
risteilyt	Croisières
portti	porte
roomalainen	romain
tehtävät	fonctions
eroottinen	érotique
sävy	Ton
etiikka	éthique
lohikäärme	dragon
kiireinen	occupé
kapteeni	capitaine
tuo	apporte
lämmitys	chauffage
jalka	jambe
niska	cou
siipi	aile
skriptejä	scripts
ABC	abc
nimitetty	nommé
tekemisissä	transaction
sitoutumaan	commettre
kisko	rail
matkat	voyages
aukko	écart
sivut	côtés
putki	tube
vastaava	correspondant
kuvaukset	descriptions
vyö	ceinture
takki	veste
animaatio	animation
oraakkeli	oracle
er	er
tuotannot	productions
ilmailu	aviation
ylpeä	fier
katastrofi	catastrophe
konsoli	console
komennot	commandes
jr	jr
tietoliikenne	télécommunications
ohjaaja	instructeur
jättiläinen	géant
saavutettu	réalisé
vammat	blessures
lähestymistavat	approches
tavallinen	habituel
postimerkkejä	timbres
kulma	angle
ryöstää	Rob
suunnittelijat	concepteurs
vapaus	liberté
aikakausi	ère
muuntaa	convertir
mahdollisuus	possibilité
analyytikko	analyste
vaarallinen	dangereux
luotettavuus	fiabilité
vastaavasti	respectivement
vapaaehtoiset	bénévoles
johdettu	dérivé
ilo	plaisir
kunnia	honneur
suuntautunut	orienté
kotka	Aigle
rukous	prière
työpajat	ateliers
Hurrikaani	ouragan
hiljainen	silencieux
tuottaja	producteur
edustettuina	représentée
vastuut	responsabilités
juusto	fromage
huolellisesti	soigneusement
tuottavuus	productivité
kruunu	couronne
par	par
diagnoosi	diagnostic
valmistaja	fabricant
crack	fissure
periaate	principe
poimii	choix
jengi	gang
fetissi	fétiche
ulkomuoto	apparence
savu	fumée
suodattimet	filtres
yhdistetty	incorporé
alus	artisanat
kaveri	compagnon
sokea	aveugle
aula	salon
hullu	furieux
algoritmi	algorithme
voimakkaasti	fortement
kahvila	café
ken	ken
proteiineja	protéines
su	su
tuttu	familier
kykenevä	capable
pääsy	admission
kenkä	chaussure
valittiin	élu
kuljettaa	portant
terrorismi	terrorisme
ilo	joie
painokset	éditions
etninen	ethnique
eduskunta	parlement
näyttelijä	acteur
löydöt	découvertes
tiiviste	joint
tilanteita	situations
viides	cinquième
kansalainen	citoyen
pystysuora	verticale
korjaukset	corrections
kuvailee	décrit
vammaiset	handicapées
aine	substance
kielletty	interdit
putki	tuyau
sotilaat	soldats
holhooja	Gardien
luento	conférence
simulointi	simulation
layout	disposition
aloitteita	initiatives
sairas	mauvais
keskittyminen	concentration
asettaa	allonger
tulkinta	interprétation
likainen	sale
opettanut	enseigné
työntekijä	ouvrier
optimointi	optimisation
temppeli	temple
aineet	substances
todistaa	prouver
löydetty	découvert
siivet	ailes
geneettinen	génétique
rajoituksia	restrictions
ohut	mince
näyttely	exposition
harjanne	crête
modeemi	modem
tuoden	apportant
sairas	malade
arvioida	évaluer
trooppinen	tropical
kerätä	collecte
vektori	vecteur
ehdottomasti	absolument
kääntyminen	tournant
olemassaolo	existence
selostus	commentaire
kehitys	développements
maahanmuutto	immigration
kohteet	destinations
keskinäinen	mutuel
syntaksi	syntaxe
li	li
ominaisuus	attribut
vankila	prison
taito	compétence
tuolit	chaises
ympäröivä	alentours
vuoret	montagnes
suosio	popularité
tiedustelu	enquête
tarkistettu	vérifié
näyttely	exposition
heittää	jeter
trendi	tendance
kissat	chats
aavikko	désert
ya	ya
koordinaattori	coordinateur
elohopea	Mercure
palaa	brûlant
paeta	échapper
vastaanotin	destinataire
etenevä	progressive
veneet	bateaux
mestaruus	championnat
arkadi	arcade
mahdoton	impossible
kertoo	dit
ilmeinen	évident
masennus	dépression
kaavio	graphique
päällyste	couvrant
platina	platine
tuomio	jugement
neuvottelut	pourparlers
arkistointi	dépôt
edistää	favoriser
palkittiin	décerné
tutkimuksissa	essais
Masters	maîtrise
patruuna	cartouche
selitys	explication
Org	org
petos	fraude
sähkö	électricité
spektri	spectre
saapuminen	arrivée
keramiikka	poterie
painotus	accentuation
mahtava	impressionnant
vahvistettu	confirmé
laskee	compte
romahdus	crash
hissi	ascenseur
inter	entre
korkeudet	hauteurs
varjo	ombre
kulu	frais
hanke	entreprise
klinikka	clinique
paranemista	guérison
prinsessa	Princesse
kirjoittamalla	entrer
paketti	paquet
studiot	studios
osallistuminen	participation
isä	papa
painikkeet	boutons
sijoitus	placement
havainnot	observations
voittajat	gagnants
tiet	routes
myöhempi	subséquent
piha	Cour
julkistaminen	divulgation
perustaminen	établissement
muistoja	souvenirs
te	te
luo	crée
kasvoja	visages
turisti	touristique
murhata	meurtre
riittävä	adéquat
senaattori	sénateur
esitykset	présentations
sulattaa	digérer
pöly	poussière
wiki	wiki
vaihdettu	remplacé
tutka	radar
tappiot	pertes
taistelu	combat
vähentäminen	réduire
pysäytetty	arrêté
ammatti	Occupation
tarkasti	étroitement
säteily	radiation
kuninkaat	rois
ammunta	tournage
korva	oreille
liput	drapeaux
leipuri	boulanger
konservatiivinen	conservateur
järkyttää	choc
tehokkuuden	efficacité
solmio	attacher
katto	toit
osoittaa	démontrer
ilmapiiri	atmosphère
suudella	baiser
peto	bête
ra	ra
toimi	exploité
koe	expérience
tavoitteet	cibles
ostot	achats
liittovaltio	fédération
pizza	Pizza
kutsuttu	invité
toimeksianto	affectation
mod	mod
kyselyt	requêtes
poissaolo	absence
myyjät	vendeurs
jooga	yoga
palvelee	sert
yllätys	surprise
lamppu	lampe
vitsit	blagues
neuvonta	conseils
palatsi	palais
vakuuttunut	satisfait
voittoa	victoires
varasto	entrepôt
oletettu	supposé
tavallinen	ordinaire
aave	fantôme
rikkominen	violation
pomo	patron
ylpeys	fierté
odotukset	attentes
itsenäisyys	indépendance
tietäen	connaissance
reportteri	journaliste
aineenvaihdunta	métabolisme
mestari	champion
henkilökohtaisesti	personnellement
paljon	beaucoup
soolo	solo
kurkku	gorge
rikkaus	richesse
tyhjiö	vide
tanssi	dansant
tunnistaa	reconnaître
kirjoittaa	écrit
aukio	place
etsintä	quête
julkaista	publier
seulonta	dépistage
trans	trans
pioneeri	pionnier
unohdettu	oublié
akrobaatti	acrobate
levyt	plaques
esseitä	essais
käytös	comportement
kertominen	récit
melko	équitablement
älykäs	intelligent
tilat	modes
vaatimus	obligation
satama	port
matkustaja	voyageur
segmentti	segment
vihollinen	ennemi
palapeli	puzzle
kaivot	puits
rajoitettu	limité
tasavaltalainen	républicain
salaisuudet	secrets
oireyhtymä	syndrome
läsnäolo	présence
rangaistus	peine
rumpu	tambour
mahdollistaa	permet
rakentaja	constructeur
näköala	vue
tulva	inonder
helppous	facilité
argumentit	arguments
areena	arène
seikkailuja	aventures
oppilaat	élèves
ilmoitus	annonce
tulokset	résultat
arvostaa	apprécier
laajennettu	étendu
täysikasvuinen	mûr
ihana	charmant
keskuksissa	centres
lauseke	clause
hymy	sourire
maat	terres
joukot	troupes
aseistettu	armé
mänty	pin
jäähdytys	refroidissement
kuilu	golfe
autot	camions
mekanismit	mécanismes
avioero	divorce
perinne	tradition
pillereitä	pilules
tiikeri	tigre
ihmiset	gens
sensori	capteur
avoin	exposé
metsästää	chasse
enkelit	anges
sijainen	adjoint
thaimaalainen	thaïlandais
päästöt	émissions
lääkärit	médecins
valitus	plainte
kohtaukset	scènes
kokeiluja	expériences
edistää	renforcer
hallintotavan	gouvernance
mylly	moulin
perustettu	fondé
krooninen	chronique
den	tanière
sormi	doigt
pitää	garde
punta	livre
paikantaa	Localiser
pl	PL
koulutettu	qualifié
toteuttamisessa	exécution
leipä	pain
moottorit	moteurs
kova	dure
tapaus	incident
dynamiikka	dynamique
valehdella	mensonge
keskustelu	conversation
pienentää	diminution
palvonta	culte
valmiudet	aptitude
ak	Alaska
tarkkuus	précision
vahingonkorvaus	dégâts
varaukset	réserves
ratkaista	résoudre
vähemmistö	minorité
monipuolinen	diverse
ainekset	Ingrédients
Ah	ah
sävyt	tons
kuntoutus	réhabilitation
näky	vue
savi	argile
heikko	faible
jaettu	divisé
vastaanotto	accueil
viisas	sage
todennäköisyys	chances
seminaarit	séminaires
seuraukset	conséquences
päättäjille	décideurs
maantiede	géographie
eheys	intégrité
perintö	héritage
tyytyväinen	heureux
vaara	danger
vitamiini	vitamine
jalostettu	traité
fraasi	phrase
nostaminen	élevage
vaikutukset	implications
toiminnallisuus	fonctionnalité
paratiisi	paradis
hybridi	hybride
lukee	lit
tunteellinen	émotif
kunnia	gloire
ja	ja
maantieteellinen	géographique
ylittää	dépasser
sauva	barre
silkki	soie
vauvat	bébés
bi	bi
romanttinen	romantique
paljastui	révélé
asiantuntijat	spécialistes
generaattori	Générateur
jousitus	suspension
surullinen	triste
korjaus	correction
susi	Loup
hitaasti	lentement
täydentää	supplément
osat	portions
pikkulasten	bébé
aloilla	secteurs
neste	fluide
perusteet	terrains
ateria	repas
ta	ta
koneet	machinerie
yhtälö	équation
korit	paniers
todennäköisyys	probabilité
ulottuvuus	dimension
tutkittu	étudié
voitot	bénéfices
paholainen	diable
ruoho	herbe
kuvitettu	illustré
kirsikka	Cerise
mannermainen	continental
saavutus	réussite
rajoituksia	limites
hautajaiset	funérailles
luvuissa	chapitres
matkustaja	passager
mukava	pratique
Mars	Mars
kokoinen	taille
muna	Oeuf
signaalit	signaux
suuntautuminen	orientation
varkaus	vol
lapsuus	enfance
symbolit	symboles
lat	lat
meta	méta
analoginen	analogique
lahjakkuus	Talent
päivätty	daté
viisaus	sagesse
raja	frontière
eliitti	élite
gi	gi
uskoo	croit
runoja	poèmes
toimivalta	juridiction
robotti	robot
näyttämällä	visualisation
todistaja	témoin
varustettu	équipé
vaiheet	étapes
sur	sur
hankittu	acquis
arvioida	évaluer
pestä	lavage
Sisäänkäynti	entrée
ilmoitus	déclaration
menettää	perdant
yrityksiä	tentatives
jalo	noble
automaatio	automatisation
vaikutukset	impacts
kierros	tour
edut	avantages
ritari	Chevalier
tavoitteet	objectifs
laajennukset	extensions
valitukset	appels
sairaus	maladie
ho	ho
vaihtoehtoja	alternatives
sh	sh
saippua	savon
hillo	confiture
epätavallinen	inhabituel
vastasi	répondu
tuho	destruction
muutto	migration
häiriö	désordre
tavanomainen	conventionnel
yllään	portant
akseli	axe
pyrittiin	recherché
geenit	gènes
mediaani	médian
skanneri	scanner
tässä	ici
eloisa	Animé
säätö	ajustement
sankari	héros
hoidot	traitements
asenne	attitude
matto	tapis
linssit	lentilles
osallistui	assisté
vaikeus	difficulté
punk	punk
koalitio	coalition
rekisteröinti	inscription
herttua	Duc
vauhti	rythme
tuottajia	producteurs
kaari	arc
rajapinnat	interfaces
kartasto	atlas
havainto	observation
kiduttaa	torture
Poistetaan	supprimé
takki	manteau
entisöinti	restauration
sopivuus	commodité
palaavat	retour
oppositio	opposition
kontti	récipient
vastaaja	défendeur
valvoja	superviseur
joukot	corps
toimijoiden	acteurs
maksa	foie
velvollinen	assujetti
adressi	pétition
antenni	antenne
poimitaan	choisi
uskomus	croyance
tappaminen	meurtre
olkapää	épaule
sisustus	décor
ioni	ion
halkaisija	diamètre
podcast	Podcast
vuorovaikutukset	interactions
laulaja	chanteur
airut	héraut
vanheneminen	vieillissement
interventio	intervention
kytkeä	brancher
vetovoima	attraction
sukellus	plongée
muutos	modification
olettaa	supposer
ruoko	roseau
sisältää	impliquer
kohtalainen	modérer
hiiret	souris
ymmärsi	compris
nopeasti	rapidement
kieltää	interdire
varmuus	assurance
happening	événement
valtava	vaste
myllyt	moulins
ääriviivat	contour
vastaanottaa	reçoit
farkut	jeans
kokoelma	compilation
outo	impair
sigma	Sigma
gr	gr
viehättävä	attrayant
tilaisuus	occasion
tallenteet	enregistrements
uhri	victime
vaatii	demandes
varovainen	prudent
palkki	faisceau
puutarhanhoito	jardinage
velvoitteet	obligations
saapua	arrivée
orkesteri	orchestre
lisenssi	Licence
säädettävä	Ajustable
jako	allocation
essee	essai
osoittivat	démontré
vuoropuhelu	dialogue
leirit	camps
julistettu	déclaré
jäljittää	trace
sulkea	fermer
pakkauksissa	paquets
ge	ge
asennus	pose
kytkimet	interrupteurs
vapaaehtoinen	volontaire
sinä	tu
suuresti	très
ng	ng
yleisesti	communément
pe	pe
valokuvaaja	photographe
itkeä	cri
kvantti	quantum
rakennettava	construit
lisäykset	additions
edellyttävät	exigeant
nuoli	flèche
sitoumus	engagement
karkea	rugueux
outo	bizarre
leijona	Lion
häät	mariages
happi	oxygène
kanjoni	canyon
metriä	mètres
vain	seulement
kalenterit	calendriers
järjestely	arrangement
päätelmät	conclusions
bibliografia	bibliographie
osoitin	aiguille
yhteensopivuus	compatibilité
venyttää	étendue
luvat	permis
osuuskunta	coopérative
ruokinta	alimentation
kauppala	canton
rankingissa	classements
mittaus	mesure
hihna	sangle
väkijoukko	foule
siirrot	transferts
olympia	olympique
muutos	transformation
dir	dir
tulli	douane
ylläpitäjät	administrateurs
persoonallisuus	personnalité
koukku	crochet
ruletti	roulette
aleneminen	déclin
johto	corde
pilvi	nuage
helpottaa	faciliter
Val	val
selittää	explique
edetä	procéder
tunteet	sentiments
veitsi	couteau
hyväksyä	adopter
evätty	dénié
lahjoitus	don
ulompi	extérieur
sato	surgir
joet	rivières
solmut	nœuds
mainittu	cité
napa	centre
kohdennettu	ciblée
tajusi	réalisé
perustaja	fondateur
vuosikymmen	décennie
riita	contestation
väsynyt	fatigué
haitallinen	négatif
ote	extrait
purkaa	décharge
juomat	boissons
ässä	as
äänet	voix
kiipeily	escalade
tonnia	tonnes
hajuvesi	parfum
vaarallinen	dangereux
palauttaa	restaurer
pino	empiler
metodologia	méthodologie
maine	réputation
demokraatteja	démocrates
ripustaa	pendre
käyrä	courbe
luoja	créateur
keltainen	ambre
museot	musées
koodaus	codage
seuraaja	traqueur
vaihtelu	variation
kulku	passage
siirretty	transféré
runko	tronc
valokuva	photographier
aallot	vagues
kameli	chameau
jakelija	distributeur
chi	chi
keräys	rassemblement
projektio	projection
matemaattinen	mathématique
looginen	logique
kastike	sauce
kuuluisuus	célébrité
erikoistunut	spécialisé
yritykset	sociétés
kritiikki	critique
auto	voiture
tuomarit	juges
huomautukset	remarques
havaittu	détecté
maalaukset	peintures
käveli	marché
aiheutuvat	découlant
populaatiot	populations
peloissaan	peur
akustinen	acoustique
kasetti	cassette
indikaattori	indicateur
jpg	jpg
virhe	erreur
poistaa	éliminer
mineraali	minéral
rubiini	rubis
helmet	perles
onni	fortune
kangas	Toile
kynnys	seuil
seurakunta	paroisse
näytöt	écrans
hautausmaa	cimetière
stadion	stade
tutkiminen	exploration
min	minutes
varsi	tige
tähtitiede	astronomie
kilpailut	concours
flunssa	grippe
puku	costume
polkupyörää	vélos
piispa	évêque
veti	tiré
maissi	blé
puristus	compression
perustamisesta	établissement
viljelijä	agriculteur
tina	étain
orja	esclave
heti	immédiatement
valmennus	encadrement
tutkitaan	examiné
koodaus	codage
huomautukset	soumissions
sankareita	héros
maalannut	peint
muotokuva	portrait
terroristi	terroriste
eettinen	éthique
harjoittajat	transporteurs
liikkuvuus	mobilité
taistelu	lutte
järjestelmiä	régimes
kärsimys	Souffrance
neutraali	neutre
kalastaja	pêcheur
rotta	rat
keihäitä	lances
tuloaan	joindre
otsikko	titre
keinotekoinen	artificiel
laakeri	palier
mahtava	spectaculaire
maailmoja	mondes
syyllinen	coupable
aktivointi	Activation
satama	havre
tabletti	tablette
tuomaristo	jury
dos	dos
pyrstö	queue
viehätys	charme
väkivaltainen	violent
mahdollisesti	potentiellement
karjatila	ranch
rajoitteet	contraintes
ylitys	traversée
täydellinen	compris
mökki	chalet
humalassa	ivre
huomattava	considérable
rikokset	crimes
ratkaistu	résolu
tavu	octet
nenä	nez
oksat	branches
ulkomaalainen	extraterrestre
prosessorit	processeurs
mursi	cassé
monimutkaisuus	complexité
alituisesti	constamment
ratkaista	résoudre
alueiden	territoires
tutkielma	thèse
levyt	disques
tiheä	fréquent
katto	plafond
pikseliä	pixels
gen	gen
ruutu	diamants
laivasto	flotte
kimppu	bouquet
teoreettinen	théorique
lähete	référence
lopettaa	quitter
protokollat	protocoles
keuhko	poumon
korvike	remplacer
loistava	brillant
ti	ti
geeli	gel
puhuttu	parlé
omega	oméga
arvioitu	évalué
jäi	séjourné
näkee	voit
päättyminen	Résiliation
katsoi	regardé
kotitalouksien	ménages
lunastaa	racheter
jyvä	grain
järjestelmä	régime
sonni	taureau
arkkitehtoninen	architectural
erota	différer
liikkeet	mouvements
korjaus	réparations
hengitys	souffle
palveluihin	équipements
käytännössä	virtuellement
kauppapaikka	marché
kynttilä	bougie
riippuva	pendaison
värillinen	coloré
tarina	conte
ennen	anciennement
projektori	projecteur
sijaitseva	situé
etsii	cherche
tiukasti	strictement
psykologinen	psychologique
vitamiinit	vitamines
tyylikäs	élégant
voitto	gains
uusiminen	renouvellement
sukututkimus	généalogie
katsotaan	réputée
pisteytys	points
menot	dépense
kriitikot	critiques
algoritmit	algorithmes
hakkeri	pirate
salonki	salon
turbo	turbo
parantaa	guérir
ni	ni
ajattelee	pense
ehdotus	suggestion
sotilas	soldat
pommi	bombe
vahingoittaa	nuire
aikaväli	intervalle
peilit	miroirs
tutkia	enquêter
sinun	tes
paneelit	panneaux
toistettu	répété
hyökkäys	agression
Peura	cerf
kieli	langue
keilailu	bowling
tri	tri
apina	singe
osa	proportion
hame	jupe
analyysit	analyses
piirustukset	dessins
merkitys	importance
skenaario	scénario
te	vous
arabialainen	arabe
arvioida	jauge
suojaava	protéger
kohtasi	face
ratkaiseminen	résolution
tuottaa	produit
intensiivinen	intensif
kahleet	Chaînes
kuudes	sixième
sitoutua	engager
kytkentä	commutation
kirjeenvaihto	correspondance
tuonti	importations
valvonta	surveillance
menot	dépenses
erottaminen	séparation
todistus	témoignage
epäilty	suspect
pakollinen	obligatoire
rajoja	limites
juhla	fête
suodatus	filtration
puoliso	époux
eksoottinen	exotique
katsoja	téléspectateur
päästäisiin	atteindre
nauraa	rire
kirurginen	chirurgical
tuhota	détruire
lainaus	citation
yo	yo
tilat	locaux
osoittautui	prouvé
hyökkäys	offensive
keisarillinen	impérial
tusina	douzaine
käyttöönotto	déploiement
kangas	tissu
lootus	lotus
lohi	Saumon
lasti	cargaison
direktiivi	directif
perämies	camarade
voi	beurre
pippuri	poivre
ase	arme
taakka	charge
nauhat	bandes
vyöhykkeet	zones
saari	île
hoikka	svelte
vaahtera	érable
ruokakauppa	épicerie
hallitseva	gouvernant
varikko	dépôt
alt	alt
piirakka	tarte
sekoitus	mélange
päästö	émission
näennäinen	apparent
neuvonta	éducatif
käyttöoikeudet	autorisations
WC	toilette
sijoittui	classé
reitit	routes
asennus	montage
sidottu	lié
tasapainoinen	équilibré
myöhässä	différé
laakso	vallée
laskeminen	calcul
huvilat	villas
Tilaisuudet	occasions
yhtälöt	équations
öljyt	huiles
syyskuu	septembre
poikkeuksellinen	exceptionnel
levottomuus	anxiété
tila	spatial
vastaajat	répondants
näkökohdat	considérations
maksaa	paie
aurinkoinen	ensoleillé
toimittaa	livre
je	je
kaulakoru	Collier
yhdistelmä	composite
lang	lang
teatterit	théâtres
suunnittelu	conception
toivoo	espoirs
arvioinnit	évaluations
kaavio	diagramme
jalkineet	chaussure
SG	sg
kansojen	peuples
voittaja	Victor
lisenssejä	licences
vaihtelee	gammes
paria	paires
herkkyys	sensibilité
säilytys	préservation
yksittäinen	isolé
väliaikainen	intérimaire
avustaa	assisté
jumalallinen	Divin
hyväksyä	approuver
yhdiste	composé
intensiteetti	intensité
teknologinen	technologique
abortti	Avortement
dialogi	dialogue
tapahtumapaikat	lieux
räjähdys	explosion
käsitellään	adressage
napa	pôle
kilpi	bouclier
kalvo	membrane
epätoivoinen	désespéré
äidit	mères
esittely	manifestation
valtiosta	gouvernemental
valmistettu	fabriqué
kynttilät	bougies
muunnelmat	variations
äidit	mamans
pyhä	sacré
riippuvuus	dépendance
kromi	chrome
kieltäytyi	refusé
jarru	frein
ulkopuoli	extérieur
tervehdys	salutation
ekologia	écologie
laakso	glen
työttömyys	chômage
sijoitettiin	marqué
lisälaite	renforcement
klooni	cloner
nopeus	rapidité
lambda	lambda
kokoonpanossa	composé
kyyneleet	larmes
keidas	oasis
ohjaamo	taxi
fa	FA
yhteiskunnissa	sociétés
pii	silicium
identtinen	identique
maaöljy	pétrole
kilpailla	rivaliser
ist	ist
rakastaja	amoureux
kuulua	appartenir
huulet	lèvres
saattaja	escorte
lampi	étang
lautta	traversier
kani	lapin
ammatti	métier
pato	barrage
fysiologia	physiologie
vientiä	exportations
Rengas	pneu
osallistuja	participant
elektroni	électron
kuormat	charges
kanerva	bruyère
motelli	motel
ammattiliitot	syndicats
valtiovarainministeriö	Trésorerie
miehitetty	occupé
asteikot	Balance
rasitus	souche
pidätetty	arrêté
tutkimuksia	enquêtes
sai	gagné
pesula	blanchisserie
saattamisesta	placement
säätää	régler
arvioitu	évalués
salaus	chiffrement
täyte	remplissage
määrätty	imposé
hiljaisuus	silence
Neuvostoliiton	soviétique
hallinta	possession
sopimus	traité
kouluttaja	entraîneur
urut	organe
sitruuna	citron
pimeys	obscurité
jänneväli	envergure
vitsi	blague
pakkaus	emballage
säädös	loi
hylätty	rejeté
suoja	abri
kappeli	chapelle
valmistus	fabrication
kerroksia	couches
juhlia	célébrer
laite	appareil
seos	mélange
ratsastaja	cavalier
säde	rayon
vaikuttava	impressionnant
lammas	mouton
arkkitehti	architecte
luennot	conférences
viinit	vins
kupit	tasses
tuhka	cendre
avustajat	contributeurs
salaatti	salade
rikkomuksia	violations
lämpötilat	températures
kilpailut	compétitions
säilyttää	préserver
runo	poème
pysyminen	rester
pääsiäinen	Pâques
teoriat	théories
säilytyspaikka	dépôt
virtoja	ruisseaux
lasku	atterrissage
teloitettiin	réalisé
neuvottelut	négociations
realistinen	réaliste
kysyy	demande
tiivistelmä	synopsis
säveltäjä	compositeur
papu	haricot
miekka	épée
muutoksia	modifications
koralli	corail
pikselin	pixel
polut	chemins
kupla	bulle
por	por
hankkia	acquérir
päinvastainen	contraire
Tribune	tribune
alus	navire
hapot	acides
virukset	virus
tarroja	autocollants
reaktiot	réactions
uskomukset	croyances
ryhmä	équipe
analysoida	analyser
alueet	divisions
uida	nager
nano	nano
konsertit	concerts
urokset	mâles
säilyttää	conserver
värit	couleurs
suorittaa	exécuter
tunneli	tunnel
tyylilajit	genres
patentit	brevets
vehnä	blé
aikakirjat	chroniques
saada	obtention
majava	castor
lukemat	lectures
laajennus	élargissement
Eagles	aigles
emäkset	bases
syytetty	accusé
kampanjat	campagnes
yhtenäisyys	unité
määritellään	définit
tapauksissa	instances
kotoperäinen	indigène
alkaneet	commencé
paketit	paquets
ankkuri	ancre
sukat	chaussettes
laukaista	déclencheur
kolesteroli	cholestérol
ero	différentiel
pinnat	surfaces
kauhea	terrible
reitittimet	routeurs
kellot	horloges
niveltulehdus	arthrite
BIOS	bios
naaraat	femelles
heijastaa	reflète
verotus	Imposition
kuume	fièvre
keittiö	cuisine
varmasti	sûrement
harjoittajat	praticiens
lause	théorème
inflaatio	inflation
sinua	te
yhdisteet	composés
rummut	tambours
kohtuullisen	raisonnablement
paljas	nu
radikaali	radical
suosittelee	recommande
valvontaan	commander
aarre	Trésor
liekki	flamme
kuoppa	fosse
mono	mono
hiukkasia	particules
kelluva	flottant
koordinoida	coordonner
yksinomaan	exclusivement
rajoitus	limitation
iski	frappé
kuva	illustration
varoitukset	avertissements
rakentaa	construction
sovellukset	applications
kyselyt	enquêtes
liite	annexe
inspiraatio	inspiration
rahti	fret
pimennys	éclipse
vaikuttaa	affecte
ennusteet	prévisions
havaita	détecter
aktiivisesti	activement
monimutkainen	compliqué
loukkaantunut	blessé
ilmauksia	expressions
tonni	tonne
kuriiri	courrier
vihjeitä	astuces
gif	gif
konfliktit	conflits
juoma	boisson
kunnianosoitus	hommage
immuuni	immunitaire
metsänhoito	sylviculture
rajat	barrières
kallistus	pente
harvoin	rarement
tarjoukset	offres
este	barrière
polkupyörä	vélo
kalusteet	mobilier
nousta	survenir
kelttiläinen	celtique
hiukkanen	particule
kosteus	humidité
pullot	bouteilles
dm	dm
renessanssi	Renaissance
määräys	ordonnance
valokuvaajat	photographes
infektiot	infections
shakki	échecs
toimii	fonctionne
festivaalit	festivals
mahdollisuuksia	possibilités
Ankka	canard
kanava	canal
myötävaikuttaa	contribuant
lehmä	vache
analyyttinen	analytique
puvut	costumes
tiukka	strict
verenkierto	circulation
rikkomus	infraction
olettamus	supposition
harraste	loisir
yrittää	essais
keksintö	invention
teknikko	technicien
johtajat	cadres
kyselyt	enquêtes
kognitiivinen	cognitif
tutkia	explorant
temppu	tour
tiedustelu	enquête
päättäminen	fermeture
puutavara	bois
voltti	volt
voimakas	intense
kannattajat	partisans
säädökset	statuts
kirjoilla	inscrits
anturit	capteurs
ruuvi	vis
ministerit	ministres
julkisesti	publiquement
kärsi	souffert
otto	admission
perhonen	papillon
mekaniikka	mécanique
otsikot	têtes
virheitä	erreurs
numeerinen	numérique
määrittelemällä	définissant
laskenta	compte
heijastus	réflexion
kutsu	invitation
natrium	sodium
hormoni	hormone
lasten	enfants
tiili	brique
pito	poignée
keskiaikainen	médiéval
posliini	porcelaine
kaapattu	capturé
kunnollinen	décent
valu	fonderie
käännetty	traduit
donna	dona
soturi	guerrier
hytti	cabine
skannaus	balayage
poolo	polo
kopiointi	copier
sarvi	klaxon
journalismi	journalisme
sammakko	grenouille
kielioppi	grammaire
tarkoitus	intention
renkaat	pneus
toteutetut	entreprise
vaara	danger
jaksot	épisodes
pyöreä	circulaire
suututtaa	colère
kuvitukset	illustrations
mahdollisuudet	chances
onnellisuus	bonheur
outo	bizarre
Ur	ur
hedelmät	fruits
tunnisteen	identificateur
nauha	ruban
laskelmat	calculs
jpeg	jpeg
aloittaa	Commencez
kätevä	pratique
vaihtaa	échanger
vapauttaa	exempter
viljelykasvien	cultures
vähentää	réduit
aikaan	accompli
geometria	géométrie
vaikutus	impression
kilta	guilde
korrelaatio	corrélation
sim	sim
hermostunut	nerveux
tuoksu	fragrance
kopio	réplique
heimo	tribu
kaupat	métiers
loistava	superbe
eroon	débarrasser
kolminaisuus	trinité
käsiteltävä	manipulés
legendoja	légendes
puomi	boom
rauhoittaa	calme
Mestarien	champions
lattiat	étages
valinnat	sélections
verrataan	comparant
puhuu	parle
ammatillinen	professionnel
apteekit	pharmacies
ln	Dans
rulla	rouleau
erä	lot
järjestää	organiser
Ymmärretään	apprécié
muuttaa	modifier
reunat	bords
sekoittaminen	mélange
kahvat	poignées
harmonia	harmonie
hienostunut	distingué
astma	asthme
oletukset	hypothèses
säännelty	réglementé
kolmio	Triangle
muuttaa	modifier
ennakoitua	anticipé
itämainen	Oriental
palkinto	récompense
vety	hydrogène
vertailukelpoinen	comparable
puolestapuhuja	avocat
sekaannus	confusion
tulot	contributions
takuut	garanties
perimä	génome
mitali	médaille
valmentajat	entraîneurs
alukset	navires
satama	port
Eco	eco
haavoittuva	vulnérable
järjestää	organiser
taiteellinen	artistique
kunnianosoitukset	honneurs
heijastunut	reflété
yhdistynyt	unifié
rotu	race
ilmaisin	détecteur
huomiotta	ignoré
täsmällinen	précis
arviointiin	évaluer
huuli	lèvre
kerätä	recueillir
muodostaen	formant
toimittajat	journalistes
hienoinen	mince
epäsuora	indirect
keskuudessa	parmi
perustukset	fondations
horisontti	horizon
nu	nu
syvään	profondément
velat	passif
palkinnot	prix
vähentynyt	diminué
kuvaava	décrivant
optiikka	optique
jatkaa	poursuivre
salama	foudre
ou	OU
lainaukset	citations
tarkastaja	inspecteur
käärme	serpent
muistutus	rappel
etsinyt	cherché
Plains	plaines
oivalluksia	idées
kyvyt	capacités
aloitettu	initié
karaoke	karaoké
ansa	piège
yksinäinen	solitaire
ve	ve
tarkkailla	observer
kontit	conteneurs
asenteet	attitudes
marja	baie
kaulus	collier
yhdistää	intégrer
sosiologia	sociologie
näytteille	expositions
kuolee	meurt
terassi	terrasse
bakteerit	bactéries
pitäisi	devrait
herkullinen	délicieux
perinteet	traditions
rajallinen	fini
lähettää	envoie
kestävä	durable
liittoutunut	allié
kosteus	humidité
muuttaa	transformer
ajastin	minuteur
tabletit	comprimés
saatu	obtenu
kasvattajat	éducateurs
vihannes	légume
jae	verset
itsenäisesti	indépendamment
kilpailijat	concurrents
raketti	fusée
kyllä	toujours
luoti	balle
tornit	tours
näkyvyys	visibilité
leveysaste	latitude
tajunta	conscience
kasvain	tumeur
ruma	laid
talletukset	dépôts
emäntä	maîtresse
kohdata	rencontre
wattia	watts
neljäkymmentä	quarante
putket	tubes
yritettiin	tentative
pappi	prêtre
analyytikot	analystes
vasara	marteau
invaasio	invasion
juoksija	coureur
riviä	lignes
annettuna	administré
käsite	notion
oikeinkirjoitus	orthographe
arktinen	Arctique
palkintoja	récompenses
alla	sous
vahvistaa	renforcer
puolustaa	défendre
infrapuna	infrarouge
seitsemäs	septième
vatsa	ventre
aggressiivinen	agressif
mainoksia	annonces
neljäsosaa	quarts
varastettu	volé
määrittää	détermine
veistos	sculpture
poly	poly
korvat	oreilles
nyrkki	poing
neo	néo
motivaatio	motivation
matkustajien	passagers
johdonmukaisesti	régulièrement
ylijäämä	surplus
kaivaa	creuser
Taksi	Taxi
arvostus	appréciation
om	om
rajoitus	restriction
kitarat	guitares
olemus	essence
mahtava	puissant
ihmiskunta	humanité
transkriptio	transcription
komplikaatioita	complications
tutkijat	savants
galaksi	galaxie
huolehtiva	soins
testamentti	testament
hallitseva	dominant
vatsa	estomac
osittain	partiellement
minimoida	minimiser
rivit	rangs
debyytti	début
sukupolvet	générations
turnaukset	tournois
kieltää	Nier
anatomia	anatomie
kuulokkeet	écouteurs
jae	fraction
trio	trio
menettely	instance
kuutio	cube
vikoja	défauts
epävarmuus	incertitude
hajota	panne
ratkaistu	colonisé
rokote	vaccin
kohtalo	sort
varaukset	réservations
republikaanit	républicains
viidakko	jungle
zen	Zen
dIS	dis
ennustus	prédiction
ekologinen	écologique
soikea	ovale
viittaa	implique
ser	ser
arviointi	évaluation
näkymä	perspective
maantieteellinen	géographique
luovuttaja	donneur
jännitys	tension
roska	poubelle
muodot	formes
porras	étage
jaarli	comte
kotimaa	patrie
mestaruutta	championnats
rodut	races
disko	disco
aus	aus
viimeistely	finition
tunteet	émotions
ikuinen	éternel
kierto	rotation
nam	nam
tuottava	productif
bulevardi	boulevard
sika	porc
metrinen	métrique
seuraamukset	pénalités
monipuolinen	varié
grande	grande
näyttelijä	actrice
luovuttaa	attribuer
majoittaa	accommoder
Tiikerit	tigres
kyliä	villages
sävy	ombre
kertosäe	Refrain
rytmi	rythme
numero	chiffre
sinfonia	symphonie
äkillinen	soudain
hyväksymisestä	acceptant
altaat	piscines
lyyrinen	lyrique
eristäminen	isolement
nopeudet	vitesses
jatkuva	soutenu
Hyväksytty	appariés
lähentää	approximatif
köysi	corde
järkevä	rationnel
ohjelmoija	programmeur
taistelijat	combattants
peritty	hérité
epätäydellinen	incomplet
laulu	voix
suihkulähde	Fontaine
laillinen	légitime
elämäkerrat	Biographies
tutkija	enquêteur
kantaja	demandeur
lempeä	doux
arvokas	digne
arkkitehdit	architectes
pyhimykset	saints
yrittäjä	entrepreneur
kuljettaa	porte
duo	duo
liiallinen	excessif
säästää	sauve
pitää	considéré
arvostus	évaluation
odottamaton	inattendu
sumu	brouillard
luonteenomainen	caractéristiques
aula	hall
hahmoteltu	décrit
valtava	énorme
karma	karma
muodostuvat	consister
kuningattaret	reines
tutkijoita	universitaires
heimot	tribus
ero	distinction
vaarat	dangers
vapautus	exemption
vuokralainen	locataire
kestävyys	durabilité
tatuointi	tatouage
algebra	algèbre
varjot	ombres
typerä	idiot
vapaasti	librement
lievä	doux
turkis	fourrure
helposti	facilement
kuuluminen	affiliation
aita	clôture
ääretön	infini
klaani	clan
vallankumouksellinen	révolutionnaire
ranneketta	bracelets
parannuskeino	remède
hengittäminen	respiration
lyhyesti	brièvement
paksuus	épaisseur
graafinen	graphique
nero	génie
keskustella	discuter
taistelija	combattant
mielekäs	significatif
muokattu	adapté
säädyt	domaines
matto	couverture
demokraatti	démocrate
kauppala	arrondissement
ylläpitää	maintient
ka	ka
säilytetään	retenu
marmori	marbre
dem	dem
meditaatio	méditation
mikrofoni	microphone
Yhdistämällä	combinant
jättiläiset	géants
organisointi	organisation
muistio	note
kinkku	jambon
ratkaistu	résolu
vuorovesi	marée
väliseinä	cloison
näkymätön	invisible
konsolit	consoles
magneetti	aimant
käännökset	traductions
jaguaari	jaguar
hyödyke	marchandise
kilometriä	kilomètres
takeita	garanties
gotiikka	gothique
sylinteri	cylindre
noita	sorcière
pukki	mâle
viholliset	ennemis
konsultointi	Conseil
nauttii	profiter
partio	patrouille
haju	odeur
karnevaali	carnaval
karkeasti	grossièrement
tarra	autocollant
lupauksia	promesses
riutta	récif
jakaa	diviser
peräkkäinen	consécutif
Bon	bon
esitykset	représentations
chan	chan
sävelet	airs
mas	mas
lausekkeet	phrases
kai	kai
niemimaa	péninsule
tylsää	ennuyeuse
dom	dom
puheet	discours
saavuttaa	atteint
kaavio	schéma
luettelot	catalogues
ministeriöiden	ministères
parlamentin	parlementaire
etuliite	préfixe
savanni	savane
tynnyri	baril
hermo	nerf
dans	Dans
planeetat	planètes
alijäämä	déficit
uudistaa	renouveler
kytketty	accouplé
piirit	circuits
rakenne	texture
tunnustaa	reconnaître
teltta	tente
tunnistaa	identifie
pätevyys	qualification
lukot	serrures
miniatyyri	miniature
euroa	euros
merirosvot	pirates
antenni	aérien
haukka	faucon
seuraus	conséquence
systemaattinen	systématique
koettu	perçue
alkuperä	origines
palkattu	embauché
meikki	maquillage
ui	ui
painot	poids
geologinen	géologique
kestävä	durable
paha	méchant
esittelee	introduit
työntää	pressé
ro	ro
rinne	pente
runoilija	poète
salaliitto	conspiration
teologia	théologie
kynnet	ongles
ilmeinen	évident
ratsastaa	manèges
eeppinen	épique
järjestäjä	organisateur
allergia	allergie
vuoksi	Saké
yhdistelmät	combinaisons
edeltävä	précédent
ansio	mérite
entsyymi	enzyme
lentokoneita	Avions
levyt	disques
vahvistin	amplificateur
mielivaltainen	arbitraire
näkyvä	important
sans	sans
rakentaa	construit
yhteyttä	contacté
akseli	arbre
nojata	maigre
satunnainen	occasionnel
innovaatiot	innovations
tarkistetaan	révision
paniikki	panique
kansalaisuus	citoyenneté
tekosyy	excuse
uudistuksia	réformes
sipuli	oignon
voileipä	sandwich
altto	alto
hierarkia	hiérarchie
hylätty	abandonné
piireissä	cercles
lyöntiä	Beats
iloinen	joyeux
kultti	culte
kojelauta	tiret
passiivinen	passif
arvostettu	estimé
häkki	cage
rohkeus	courage
korkeus	élévation
kierros	tour
käyttö	utilisation
juomat	boissons
ping	ping
viihteellinen	divertissant
edellytys	prérequis
raja	frontière
pakolaisten	réfugiés
ritarit	chevaliers
hypoteesi	hypothèse
lääkkeet	médicaments
muuttunut	modifié
oppi	doctrine
luonnonkaunis	scénique
parannuksia	améliorations
leikkauspiste	intersection
ompelu	couture
keräilijät	collectionneurs
tunnistettu	reconnu
raivo	rage
prix	prix
astrologia	astrologie
neuvonantajat	conseillers
paviljonki	pavillon
taktiikka	tactique
täydentäviä	additionnel
lahjakas	talentueux
tyyny	oreiller
leviäminen	diffusion
maakunnat	provinces
varastaa	voler
paketti	parcelle
esiintyvyys	incidence
pelot	craintes
ennustaa	prédire
maku	saveur
nälkäinen	affamé
metallinen	métallique
häiriö	ingérence
soturit	guerriers
ilmakehän	atmosphérique
sädekehä	Halo
vanhempien	parental
viitattu	référencé
lakkoja	grèves
muurahainen	fourmi
ehdotus	proposition
osuva	apte
käsitelty	traité
kauppias	Commerçant
heitetään	jeté
kriteeri	critère
kunniamerkki	badge
sivistys	civilisation
nummi	bruyère
valtava	énorme
suorittaa	exécute
valtakunta	domaine
korjattu	corrigée
kypärä	casque
kohdanneet	rencontré
tsunami	tsunami
tutkija	savant
ympäröimä	entouré
geologia	géologie
oliot	créatures
selvitetty	dégagé
suorittaa	accomplir
kulmat	coins
kasvissyöjä	végétarien
hiiva	Levure
pas	pas
tutkitaan	enquête
suurlähettiläs	ambassadeur
päällystetty	recouvert
tuho	condamner
rutiinit	routines
olentoja	êtres
riippuvuus	dépendance
myytti	mythe
puro	ruisseau
fu	fu
ilmiö	phénomène
kokonaisuus	ensemble
varma	assuré
tajuissaan	conscient
aksentti	accent
vaimot	épouses
käyttää	utiliser
pantti	gage
vampyyri	vampire
telakka	Dock
järjestetty	organisé
muusikko	musicien
rajoittamalla	limitant
palautettu	restauré
vihje	allusion
panssari	armure
huomautus	remarque
kymmeniä	douzaines
vaihtelee	varie
perustelut	raisonnement
vartijat	gardes
aukot	ouvertures
korvaa	remplaçant
tutkija	chercheur
valtuustot	conseils
Ammatit	professions
tunnustettu	reconnu
sianliha	porc
zu	zu
tasapaino	équilibre
putket	pipes
mökit	chalets
yhdistää	fusionner
etuoikeus	privilège
kehittyy	développe
alusta	châssis
arvio	estimation
lato	Grange
halla	gel
laitokset	instituts
muotti	moule
rouva	dame
jahti	yacht
mieluummin	préfère
poraus	forage
yrtti	herbe
rikkominen	violation
valas	baleine
matkustaja	voyageur
määrärahat	crédits
epäillään	soupçonné
tomaatit	tomates
ohjaajien	instructeurs
vauhti	élan
evä	ailette
pastori	pasteur
muta	boue
smaragdi	émeraude
kasvaa	pousse
alue	tract
ul	ul
baletti	ballet
toimittaja	journaliste
uskonnot	religions
valkosipuli	Ail
paistaa	éclat
räjähdys	explosion
alushousut	slips
allekirjoituksia	signatures
otsoni	ozone
tieteenalojen	disciplines
Casa	casa
keskustelut	conversations
radiot	radios
tulli	tarif
yksinkertaistettu	simplifié
lihakset	muscles
nopea	rapide
emätin	vagin
samppanja	Champagne
poikkeama	déviation
samba	samba
käyttää	employer
pingviini	manchot
maaginen	magique
vaikutteita	influences
tarkastukset	inspections
kastelu	irrigation
ihme	miracle
hydraulinen	hydraulique
tunkeutuminen	pénétration
haava	blessure
kaunotar	belle
rosa	rosa
vakaumus	conviction
laiska	paresseux
ominaisuudet	qualités
isät	ancêtres
latauksen	charge
merkittävästi	important
siro	menue
laitteet	appareil
maasto	terrain
selitetään	expliquant
nauhat	bandes
nimitys	nomination
empiirinen	empirique
mato	ver
riippuvuus	dépendance
erillinen	discret
aloittelija	débutant
kansi	couvercle
seksuaalisuus	sexualité
safiiri	saphir
etuoikeudet	privilèges
erikoistunut	spécialisation
merkki	marquage
seriffi	shérif
vähentynyt	diminué
vakoojia	espions
moottoripyörät	motocyclettes
valita	élire
valtatiet	autoroutes
keskittää	concentrer
intiimi	intime
molekyylit	molécules
kierrosta	tours
jääkaappi	réfrigérateur
väliajoin	intervalles
lauseet	Phrases
holokausti	holocauste
lentäjä	prospectus
herneet	pois
annostus	dosage
vaihtelu	variance
Navigator	navigateur
neula	aiguille
kylpylä	thermes
jarrut	freins
og	og
tyrmäys	ko
omistaa	propriétaire
kohtalo	destin
Maisemat	paysages
laskeminen	calcul
heinä	foins
pelastus	salut
ennustukset	prévisions
oppijat	apprenants
symbolinen	jeton
sinkki	zinc
uhrata	sacrifice
etsijät	demandeurs
guru	gourou
sopiva	adapté
numeerinen	numérique
antropologia	anthropologie
keisari	empereur
Grad	grad
vyöt	ceintures
mustat	noirs
sivistynyt	cultivé
ylpeänä	fièrement
välttämättömyys	nécessité
käyrät	courbes
farmari	tournée
kärki	sommet
tomaatti	tomate
matkustaa	voyages
kalpea	pâle
toiminta	fonctionnement
talouksien	économies
sitoutuvat	entreprendre
julistaa	déclarer
venttiilit	vannes
aukkoja	lacunes
saavutukset	réalisations
repiä	larme
opettaa	enseigne
nolla	néant
muukalainen	étranger
pesä	nid
tuomioistuin	tribunal
sulkea	gouverné
eläkkeet	pensions
rukoukset	prières
poliisi	flic
nuori	adolescent
ehdokkaat	nominations
banaani	banane
alustava	préliminaire
varasto	réservoir
esiintyminen	occurrence
idoli	idole
verinen	sanglant
muistuttaa	rappeler
viehättävä	charmant
hammas	dent
arvostettu	respecté
pysyy	séjours
asia	affaire
rajoittaa	restreindre
kaivokset	mines
muotokuvia	portraits
tulkita	interprété
arvioinnit	évaluations
eliminointi	élimination
metriä	mètres
hypoteettinen	hypothétique
helikopteri	hélicoptère
lyijykynä	crayon
esiintyjä	interprète
palkkiot	commissions
pallo	sphère
sammal	mousse
suhteet	rapports
sopu	concorde
porrastettu	graduée
hyväksyttiin	approuvé
yllättävä	surprenant
peitsi	lance
tikapuut	échelle
korkki	Liège
senaattorit	sénateurs
verenvuoto	saignement
luonnehdinta	caractérisation
todennäköisyys	probabilité
kaistat	voies
perusteet	fondamentaux
saastuminen	contamination
kupoli	dôme
siunata	bénir
neuvottelu	négociation
harja	crête
vastustajat	adversaires
riemuvoitto	triomphe
nimitetty	nommé
hitsaus	soudage
orgasmi	orgasme
metalliseos	alliage
tontteja	parcelles
kevyesti	doucement
lukitus	verrouillage
kiistanalainen	controversé
kiinnittää	dessine
jääkaappi	frigo
terät	lames
silmukoita	boucles
aalto	poussée
trauma	traumatisme
ilmoitus	publicité
puolustava	défensive
kielletty	interdit
vanilja	vanille
ohjelmoijat	programmeurs
seurataan	suivi
laitteistot	installations
sielut	âmes
motivoitunut	motivé
tyhmä	stupide
ontto	creux
holvi	voûte
ura	rainure
paljastus	révélation
pyrkimys	poursuite
valtuuskunta	délégation
johdot	fils
sanakirjoja	dictionnaires
läpinäkyvyys	transparence
kiertorata	orbite
valuutat	devises
Niger	Niger
paikannus	placement
siirtomaa	colonie
tykki	canon
sirkus	cirque
ylennetty	promu
taimen	truite
saavutus	exploit
väliaikaisesti	temporairement
valmistettu	cuit
lähettää	transmettre
taajuudet	fréquences
ajatukset	réflexions
nälkä	faim
kunta	municipalité
etsivä	détective
sementti	ciment
kokee	expérience
takka	cheminée
merkintä	approbation
tekstiilit	textiles
ohjus	missile
psykiatria	psychiatrie
avustaa	aide
tilintarkastaja	Auditeur
viulu	violon
profeetta	prophète
oksidi	oxyde
upea	magnifique
viipymättä	rapidement
sovittaminen	adaptation
haitallinen	nocif
seksuaalisesti	sexuellement
liite	enceinte
glukoosi	glucose
normi	norme
toisto	lecture
kilpikonna	tortue
etäisyydet	distances
imeytyminen	absorption
aarteita	trésors
fossiili	fossile
huonosti	mal
kommunistinen	communiste
yrittäjät	entrepreneurs
robotit	robots
virhe	faute
biodiversiteetti	biodiversité
jännitys	excitation
sanallinen	verbal
meret	mers
salaperäinen	mystérieux
uutuus	nouveauté
laatat	carrelage
kirjastonhoitaja	bibliothécaire
kytketty	commuté
ru	ru
aiheuttaa	pose
grammaa	grammes
terapeutti	thérapeute
budjetit	budgets
vuohi	chèvre
tehdä	rendre
purjehtia	voile
komissaarit	commissaires
tiheä	dense
urhea	courageux
huolinta	expéditeur
hirveä	terrible
lentokone	avion
organismit	organismes
teleskooppi	télescope
asbesti	amiante
edistäminen	avancement
paju	saule
jatkuu	CV
olemassa	existait
generaattorit	générateurs
synnyttää	génère
perunat	patates
perusteellinen	approfondi
reseptorit	récepteurs
optimaalinen	optimum
olento	créature
yksinäinen	seul
hienovarainen	subtil
raidat	rayures
firmware	firmware
paimen	berger
kehto	berceau
liittokansleri	chancelier
jauhot	farine
kiista	controverse
legendaarinen	légendaire
kuoro	chorale
välttää	évitant
kauniisti	magnifiquement
odottaa	attend
hyppy	sauteur
kankaat	textile
polymeeri	polymère
hygienia	hygiène
hyve	vertu
kirurgit	chirurgiens
mandaatti	mandat
corpus	corpus
terminologia	terminologie
herrasmies	gentilhomme
tuomittu	condamné
suihkukoneet	jets
indeksit	indices
qui	Qui
uhkaava	menaçant
aktivistit	militants
vanki	prisonnier
kannustaa	encourage
koolla	assemblé
terminaalit	terminaux
raaka	brut
tutkii	examine
viikinki	viking
siivota	nettoyer
ehdollinen	conditionnel
hyökkäsi	attaqué
saapuu	arrive
kääntäjä	traducteur
autojen	automobiles
traktori	tracteur
maanosa	continent
hintoja	tarifs
pituusaste	longitude
toivoneet	espéré
lisäys	insertion
rajoite	contrainte
vahvistaminen	renforcement
haluaa	souhaitant
eristys	isolation
rikkominen	infraction
taipunut	courbé
subjektiivinen	subjectif
hirviöt	monstres
turvapaikka	asile
panos	pieu
cocktail	cocktail
lajikkeet	variétés
myrkyttää	poison
hallitsi	dominé
kallis	cher
johdannaiset	dérivés
estää	prévient
kivääri	fusil
rasismi	racisme
tulkita	interpréter
sopimus	accord
vaatimaton	modeste
pelaajat	joueurs
lajittelu	tri
yhteys	liaison
sipulit	bulbes
turistit	touristes
käyttäytymistä	comportements
selventää	clarifier
vyötärö	taille
johtuvan	attribué
pöllö	hibou
kiteet	cristaux
ylittää	dépasse
täydentävä	complémentaire
taistelut	batailles
katkera	amer
muistio	mémorandum
lohikäärmeitä	dragons
melu	vacarme
uskomattoman	incroyablement
osanottajaa	délégués
psykiatrinen	psychiatrique
nuoret	adolescents
piha	Cour
presidentit	présidents
lähteä	partir
nimenomaan	expressément
lilja	lis
erehdys	surveillance
hartsi	résine
liittoutuneet	alliés
säilytetty	conservé
ristissä	franchi
nouseva	Ascendant
nimellinen	nominal
rappeutuminen	pourriture
kvartsi	quartz
rekisterit	registres
kahdeksas	huitième
valtuutettu	autorisé
parantaa	améliore
kannattaa	défenseurs
ilmiöitä	phénomènes
kallistaa	inclinaison
graniitti	granit
massat	masses
urheilija	athlète
frangi	franc
samankaltaisuus	similarité
vuotaa	fuite
neuvonantaja	conseiller
kirjanen	brochure
odottaa	attendant
liikevaihto	rotation
virtsa	urine
pyyhe	serviette
inkivääri	gingembre
kromosomi	chromosome
als	als
kärpäset	mouches
pätevyys	compétence
huutava	pleurs
amatöörit	amateurs
nosturi	grue
tutkii	enquête
mätä	pourri
tapa	habitude
kunnia	honneur
suojaa	protège
iiris	iris
hallinnoi	gère
eroosio	érosion
puuseppä	Charpentier
kaani	khan
riittämätön	insuffisant
muotoilu	formulation
taitava	intelligent
ylähuone	seigneurs
nautittava	agréable
puolikuu	croissant
kuusikymmentä	soixante
keskitetty	concentré
erottaa	distinguer
EI	ei
ennusteet	projections
kipinä	étincelle
turvaaminen	fixation
polku	sentier
ilmaisimet	détecteurs
piikki	pointe
ainesosa	ingrédient
verho	rideau
julkaisussa	divulgués
taktinen	tactique
lentäjät	pilotes
retkikunta	expédition
operatiivinen	opératoire
huumori	humour
mol	mol
jälki	imprimer
avustaminen	assistant
vika	défaut
huonosti	pauvrement
jumalatar	déesse
tarkkailijat	observateurs
magneetit	aimants
kaavat	formules
tilava	spacieux
väittää	soutient
maaperä	sols
elimet	organes
det	det
uskollisuus	fidélité
luotettava	fidèle
rikkomus	infraction
litium	lithium
harppaus	saut
perustamisen	fondation
joutsen	cygne
istutus	plantation
liitto	engagement
arkeologia	archéologie
merimies	marin
huolet	soins
pyhäkkö	sanctuaire
patsas	statue
lainaus	citation
suurten	majors
manipulointi	manipulation
kelloja	cloches
myrkyllisyys	toxicité
lähetin	émetteur
lähiöissä	quartiers
palkinto	trophée
tunne	émotion
nähtävyydet	spectacles
univormut	uniformes
haavoittunut	blessés
johdannainen	dérivé
käyttöaste	occupation
annokset	doses
kouluttaa	éduquer
ennakkoluulo	préjudice
teknikot	techniciens
todennäköinen	probable
liikkeeseen	émission
koriste	décoration
kansalaisten	ressortissants
troijalainen	troyen
avustajat	assistants
neuvonantaja	conseiller
sääti	adopté
epävakaa	instable
kehotti	pressé
heijastava	reflétant
saamassa	gagnant
lopullinen	définitive
matkusti	voyagé
sopeuttaa	adapter
liittymistä	accession
säädin	régulateur
polttoaineet	carburants
soija	soja
siisti	soigné
nimeäminen	appellation
perä	arrière
muotoillun	conçu
idiootti	idiot
käsitti	composé
ulkomaalaisten	extraterrestres
muokkaukset	modifications
korppi	corbeau
asunto	habitation
symbolinen	symbolique
kulmat	angles
paineet	pressions
Venus	Vénus
liekit	flammes
primitiivinen	primitif
sukka	stockage
ekosysteemi	écosystème
hallit	salles
yksinkertaisuus	simplicité
demoni	démon
tyytyväinen	accueilli
merkintätapa	notation
täti	tante
varis	corbeau
semanttinen	sémantique
lopetettu	abandonnées
päättää	décide
globalisaatio	mondialisation
aasit	ânes
kompassi	boussole
kehittynyt	évolué
jalkaväki	infanterie
kuuluisa	renommé
käytävä	couloir
filosofinen	philosophique
oikeutus	justification
vapaa	vacant
vahvistamisesta	fixation
gramma	gramme
piilossa	cache
väriaine	colorant
aakkoset	alphabet
puhdistettu	nettoyé
kunnioitettava	honoré
optinen	optique
puhelimet	téléphones
päiväkirjat	agendas
suru	douleur
hiki	transpiration
delfiini	dauphin
ihmeitä	merveilles
ilmanvaihto	ventilation
maskit	masques
rintakuva	buste
kuja	ruelle
reittejä	voies
lennätin	télégraphe
monumentti	monument
muodollisesti	officiellement
kaste	rosée
peruutettu	retiré
keskustelut	débats
identiteetit	identités
puute	carence
satula	selle
malaria	paludisme
uskollinen	fidèle
suuntaus	tendance
hyödynnetty	utilisé
ein	ein
kiikari	jumelles
aloittaa	lancer
puhtaasti	purement
eloisa	vif
väitteitä	allégations
vastaa	correspond
demoni	démon
juhlittu	célèbre
metsästäjät	chasseurs
toimi	agi
kerroin	coefficient
kallo	crâne
jatkaminen	continuation
palvelija	serviteur
haukka	faucon
yhdessä	conjointement
välttää	éviter
selitykset	explications
uudistunut	renouvelé
kriitikko	critique
sedimentti	sédiment
neliöt	carrés
pakettiautot	fourgonnettes
kartio	cône
selviytyi	survécu
yleisyys	prévalence
kappale	fragment
sitoutuu	engage
kobra	cobra
heitti	jeta
hoc	hoc
esiintyjät	interprètes
jälkiruoka	dessert
väitöskirja	thèse
yhdeksäs	neuvième
innostusta	enthousiasme
juhlia	célébrations
kuvernöörit	gouverneurs
atomia	atomes
kudokset	tissus
ramppi	rampe
kauniisti	bien
della	della
ylivalta	domination
sointuja	accords
vajaatoiminta	détérioration
molekyyli	molécule
