of	von
to	zu
in	im
for	zum
is	ist
on	auf
that	Das
by	durch
this	Dies
with	mit
i	ich
you	Sie
it	es
or	oder
be	Sein
are	sind
at	beim
all	alle
have	haben
new	Neu
we	wir
will	werden
home	Zuhause
us	uns
about	Über
if	ob
page	Seite
my	meine
has	hat
search	Suche
free	frei
but	aber
our	unser
one	ein
other	andere
do	machen
information	Information
time	Zeit
he	er
which	welche
their	ihr
news	Nachrichten
use	benutzen
there	Dort
see	sehen
so	damit
who	Wer
web	Netz
also	ebenfalls
get	bekommen
pm	pm
view	Aussicht
c	c
e	e
first	zuerst
been	gewesen
would	würde
were	wurden
s	s
like	mögen
x	x
than	als
find	finden
price	Preis
back	zurück
top	oben
people	Menschen
had	hätten
list	Liste
name	Name
just	gerade
year	Jahr
day	Tag
into	in
two	zwei
health	Gesundheit
n	n
re	Re
used	benutzt
go	gehen
b	b
last	letzte
make	machen
them	Sie
should	sollte
product	Produkt
system	System
post	Post
her	ihr
city	Stadt
t	t
policy	Politik
number	Nummer
support	Unterstützung
message	Botschaft
after	nach
then	dann
jan	Januar
good	gut
d	d
where	woher
info	Info
rights	Rechte
books	Bücher
high	hoch
school	Schule
m	m
each	jeder
links	Links
she	sie
years	Jahre
order	Auftrag
very	sehr
book	Buch
items	Artikel
company	Unternehmen
r	r
read	lesen
group	Gruppe
sex	Sex
many	viele
user	Benutzer
de	de
set	einstellen
general	Allgemeines
research	Forschung
university	Universität
january	Januar
mail	Post
full	voll
reviews	Bewertungen
program	Programm
know	kennt
games	Spiele
way	Weg
days	Tage
p	p
part	Teil
could	könnte
great	groß
united	vereinigt
real	echt
f	f
international	International
center	Center
travel	Reise
comments	Bemerkungen
made	gemacht
development	Entwicklung
report	Bericht
member	Mitglied
details	Einzelheiten
line	Linie
terms	Bedingungen
before	Vor
hotels	Hotels
did	tat
send	senden
right	Recht
type	Art
local	lokal
those	jene
results	Ergebnisse
office	Büro
national	National
car	Auto
design	Design
take	nehmen
posted	Gesendet
address	Adresse
community	Gemeinschaft
within	innerhalb
states	Zustände
want	wollen
phone	Telefon
dvd	DVD
subject	Gegenstand
between	zwischen
forum	Forum
family	Familie
l	l
long	lange
w	w
show	Show
o	O
even	sogar
black	schwarz
special	Besondere
index	Index
being	Sein
women	Frau
much	viel
sign	Schild
file	Datei
link	Verknüpfung
open	öffnen
south	Süd
case	Fall
project	Projekt
pages	Seiten
version	Ausführung
section	Sektion
own	besitzen
house	Haus
security	Sicherheit
g	G
county	Bezirk
american	amerikanisch
photo	Foto
game	Spiel
members	Mitglieder
power	Leistung
network	Netzwerk
computer	Computer
systems	Systeme
three	drei
place	Ort
end	Ende
h	h
him	ihm
per	pro
access	Zugriff
think	denken
north	Norden
resources	Ressourcen
current	Strom
big	groß
media	Medien
law	Recht
control	Steuerung
water	Wasser
history	Geschichte
size	Größe
personal	persönlich
guide	führen
shop	Geschäft
directory	Verzeichnis
change	Veränderung
white	Weiß
text	Text
small	klein
rating	Wertung
rate	Bewertung
government	Regierung
children	Kinder
return	Rückkehr
students	Studenten
v	v
account	Konto
times	mal
level	Niveau
digital	Digital
profile	Profil
previous	Bisherige
form	bilden
events	Veranstaltungen
love	Liebe
old	alt
john	John
main	Main
call	Anruf
image	Bild
department	Abteilung
title	Titel
non	nicht
k	k
y	y
insurance	Versicherung
shall	soll
property	Eigentum
class	Klasse
cd	CD
quality	Qualität
every	jeden
listing	Auflistung
content	Inhalt
country	Land
little	wenig
tools	Werkzeuge
low	niedrig
reply	Antworten
customer	Kunde
december	Dezember
compare	vergleichen
movies	Filme
college	Hochschule
value	Wert
article	Artikel
man	Mann
jobs	Arbeitsplätze
j	j
food	Lebensmittel
author	Autor
different	anders
u	u
learn	lernen
sale	Verkauf
print	drucken
course	Kurs
job	Job
room	Zimmer
stock	Stock
training	Ausbildung
too	auch
credit	Kredit
point	Punkt
science	Wissenschaft
men	Männer
categories	Kategorien
west	Westen
look	aussehen
english	Englisch
team	Mannschaft
estate	Gut
box	Box
conditions	Bedingungen
photos	Fotos
gay	Fröhlich
thread	Faden
category	Kategorie
note	Hinweis
live	Leben
large	groß
gallery	Galerie
table	Tabelle
however	jedoch
june	Juni
october	Oktober
november	November
market	Markt
library	Bibliothek
action	Aktion
start	Anfang
series	Serie
features	Eigenschaften
air	Luft
industry	Industrie
plan	planen
human	Mensch
yes	Ja
second	zweite
hot	heiß
cost	Kosten
movie	Film
forums	Foren
march	März
la	la
september	September
say	sagen
going	gehen
medical	medizinisch
friend	Freund
dec	Dezember
server	Server
application	Anwendung
staff	Mitarbeiter
play	abspielen
issues	Probleme
april	April
users	Benutzer
street	Straße
topic	Thema
against	gegen
got	bekam
blog	Blog
party	Party
payment	Zahlung
equipment	Ausrüstung
let	Lassen
programs	Programme
legal	legal
recent	kürzlich
park	Park
act	Handlung
problem	Problem
red	rot
give	geben
memory	Erinnerung
performance	Performance
social	Sozial
q	q
story	Geschichte
sell	verkaufen
options	Optionen
experience	Erfahrung
key	Schlüssel
body	Karosserie
young	jung
important	wichtig
field	Feld
few	wenige
east	Osten
single	Single
ii	ii
age	Alter
club	Verein
example	Beispiel
girls	Mädchen
z	z
road	Straße
gift	Geschenk
question	Frage
ca	ca
hard	hart
pay	Zahlen
four	vier
poker	Poker
issue	Problem
range	Angebot
building	Gebäude
seller	Verkäufer
court	Gericht
february	Februar
result	Ergebnis
light	Licht
write	schreiben
war	Krieg
offer	Angebot
blue	Blau
groups	Gruppen
al	al
easy	einfach
given	gegeben
request	anfordern
fax	Fax
china	China
making	Herstellung
picture	Bild
needs	Bedürfnisse
possible	möglich
month	Monat
major	Haupt
star	Star
future	Zukunft
space	Raum
committee	Ausschuss
hand	Hand
sun	Sonne
cards	Karten
london	London
meeting	Treffen
become	werden
child	Kind
keep	behalten
porn	Porno
share	Aktie
similar	ähnlich
garden	Garten
schools	Schulen
million	Million
added	hinzugefügt
reference	Referenz
companies	Firmen
baby	Baby
learning	Lernen
energy	Energie
run	Lauf
delivery	Lieferung
popular	Beliebt
term	Begriff
film	Film
stories	Geschichten
put	stellen
journal	Tagebuch
reports	Berichte
co	co
try	Versuchen
images	Bilder
notice	beachten
god	Gott
original	Original
head	Kopf
radio	Radio
cell	Zelle
council	Rat
includes	enthält
track	Spur
discussion	Diskussion
archive	Archiv
others	Andere
agreement	Zustimmung
format	Format
society	Gesellschaft
months	Monate
safety	Sicherheit
friends	Freunde
sure	sicher
edition	Auflage
messages	Mitteilungen
marketing	Marketing
tell	sagen
association	Verband
provides	bietet
fun	Spaß
already	bereits
green	Grün
studies	Studien
close	schließen
common	verbreitet
specific	Spezifisch
several	mehrere
living	Leben
collection	Sammlung
called	namens
short	kurz
arts	Kunst
lot	Menge
ask	Fragen
limited	begrenzt
solutions	Lösungen
director	Direktor
beach	Strand
past	Vergangenheit
natural	natürlich
electronics	Elektronik
upon	auf
period	Zeitraum
planning	Planung
says	sagt
official	offiziell
mar	beschädigen
done	erledigt
technical	technisch
window	Fenster
pro	Profi
region	Region
island	Insel
record	Aufzeichnung
direct	Direkte
conference	Konferenz
records	Aufzeichnungen
st	st
district	Kreis
calendar	Kalender
costs	Kosten
style	Stil
statement	Erklärung
miles	Meilen
resource	Ressource
applications	Anwendungen
document	Dokument
word	Wort
works	Werk
material	Material
bill	Rechnung
written	geschrieben
rules	Regeln
final	Finale
thing	Ding
centre	Center
requirements	Anforderungen
TRUE	WAHR
minutes	Protokoll
else	sonst
mark	Kennzeichen
rock	Rock
bad	Schlecht
individual	Individuell
plus	Plus
auto	Auto
cover	Abdeckung
edit	bearbeiten
together	zusammen
videos	Videos
fast	schnell
function	Funktion
fact	Tatsache
getting	bekommen
global	global
tech	Technik
meet	Treffen
far	weit
economic	wirtschaftlich
en	en
player	Spieler
projects	Projekte
amount	Menge
watch	Uhr
included	inbegriffen
feel	Gefühl
bank	Bank
risk	Risiko
deals	Angebote
various	verschiedene
words	Wörter
production	Produktion
commercial	kommerziell
weight	Gewicht
heart	Herz
treatment	Behandlung
points	Punkte
knowledge	Wissen
magazine	Zeitschrift
error	Error
camera	Kamera
girl	Mädchen
construction	Konstruktion
toys	Spielzeuge
registered	Eingetragen
domain	Domain
methods	Methoden
chapter	Kapitel
protection	Schutz
policies	Politik
wide	breit
beauty	Schönheit
manager	Manager
india	Indien
position	Position
taken	genommen
sort	Sortieren
listings	Inserate
known	bekannt
half	Hälfte
cases	Fälle
step	Schritt
engineering	Ingenieurwesen
simple	einfach
quick	schnell
license	Lizenz
lake	See
whole	ganze
annual	jährlich
published	veröffentlicht
church	Kirche
method	Methode
active	aktiv
response	Antwort
figure	Zahl
materials	Materialien
enough	genug
designed	entworfen
among	unter
death	Tod
loss	Verlust
face	Gesicht
brand	Marke
discount	Rabatt
effects	Auswirkungen
created	erstellt
standards	Normen
bit	Bit
political	politisch
kingdom	Königreich
base	Base
doing	tun
loans	Darlehen
shoes	Schuhe
entry	Eintrag
stay	bleibe
orders	Aufträge
availability	Verfügbarkeit
summary	Zusammenfassung
turn	Wende
growth	Wachstum
agency	Agentur
king	König
european	europäisch
activity	Aktivität
copy	Kopieren
western	Western
force	Macht
employment	Beschäftigung
bay	Bucht
river	Fluss
commission	Kommission
package	Paket
seen	gesehen
players	Spieler
engine	Motor
port	Hafen
album	Album
regional	regional
stop	halt
started	gestartet
administration	Verwaltung
bar	Bar
institute	Institut
views	Ansichten
double	doppelt
dog	Hund
soon	bald
lines	Linien
electronic	elektronisch
benefits	Leistungen
needed	erforderlich
printer	Drucker
condition	Bedingung
effective	Wirksam
believe	glauben
organization	Organisation
effect	bewirken
mind	Verstand
selection	Auswahl
casino	Kasino
pdf	pdf
tour	Tour
cross	Kreuz
hope	Hoffnung
corporation	Konzern
wish	Wunsch
solution	Lösung
mature	reifen
role	Rolle
weeks	Wochen
certain	sicher
lower	niedriger
necessary	notwendig
union	Union
mon	mon
com	com
particular	besonders
fine	fein
hour	Stunde
gas	Gas
skills	Kompetenzen
six	sechs
bush	Buchse
islands	Inseln
advice	Rat
career	Werdegang
decision	Entscheidung
leave	verlassen
pre	Vor
huge	enorm
woman	Frau
facilities	Anlagen
bid	bieten
middle	Mitte
cable	Kabel
opportunities	Chancen
taking	Einnahme
values	Werte
division	Aufteilung
coming	Kommen
object	Objekt
lesbian	lesbisch
appropriate	angemessen
machine	Maschine
logo	Logo
length	Länge
nice	nett
score	Ergebnis
statistics	Statistiken
client	Klient
sample	Probe
investment	Investition
sent	geschickt
shown	gezeigt
christmas	Weihnachten
culture	Kultur
flash	Blitz
ms	Frau
choice	Wahl
courses	Kurse
consumer	Verbraucher
hi	Hallo
foreign	fremd
artist	Künstler
furniture	Möbel
channel	Kanal
letter	Brief
mode	Modus
phones	Telefone
ideas	Ideen
structure	Struktur
degree	Grad
contract	Vertrag
super	Super
male	männlich
matter	Angelegenheit
almost	fast
located	gelegen
multiple	mehrere
distribution	Verteilung
editor	Editor
inn	Gasthaus
industrial	industriell
potential	Potenzial
song	Lied
los	los
fall	fallen
idea	Idee
rooms	Räume
communications	Kommunikations
win	Sieg
primary	primär
cancer	Krebs
numbers	Zahlen
reason	Grund
tool	Werkzeug
spring	Frühling
foundation	Stiftung
answer	Antworten
voice	Stimme
schedule	Zeitplan
documents	Unterlagen
purpose	Zweck
feature	Feature
bed	Bett
comes	kommt
police	Polizei
independent	unabhängig
approach	Ansatz
brown	braun
physical	physikalisch
hill	Hügel
maps	Karten
hold	halt
ratings	Bewertungen
happy	glücklich
smith	Schmied
developed	entwickelt
thank	danken
safe	sicher
unique	einzigartig
survey	Umfrage
prior	vor
telephone	Telefon
sport	Sport
ready	bereit
animal	Tier
sources	Quellen
population	Population
pa	pa
regular	regulär
secure	sichern
operations	Geschäftstätigkeit
simply	einfach
evidence	Beweis
station	Bahnhof
understand	verstehen
option	Möglichkeit
valley	Tal
probably	wahrscheinlich
sea	Meer
publications	Publikationen
improve	verbessern
connection	Verbindung
publisher	Herausgeber
hall	Halle
anti	Anti
networks	Netzwerke
earth	Erde
parents	Eltern
impact	Auswirkung
transfer	Transfer
introduction	Einführung
kitchen	Küche
strong	stark
wedding	Hochzeit
properties	Eigenschaften
hospital	Krankenhaus
ground	Boden
ship	Schiff
accommodation	Unterkunft
disease	Krankheit
excellent	Ausgezeichnet
perfect	perfekt
hair	Haar
opportunity	Gelegenheit
kit	Ausrüstung
classic	klassisch
basis	Basis
command	Befehl
cities	Städte
express	ausdrücken
award	vergeben
distance	Entfernung
tree	Baum
assessment	Bewertung
wall	Mauer
involved	beteiligt
el	el
extra	extra
especially	insbesondere
budget	Budget
guides	Führungen
success	Erfolg
maximum	maximal
ma	ma
operation	Betrieb
existing	bestehende
quite	ganz
selected	ausgewählt
boy	Junge
restaurants	Restaurants
beautiful	schön
warning	Warnung
locations	Standorte
horse	Pferd
vote	Abstimmung
flowers	Blumen
stars	Sterne
lists	Listen
owner	Inhaber
animals	Tiere
ways	Wege
son	Sohn
providing	Bereitstellen
rule	Regel
housing	Gehäuse
takes	nimmt
bring	bringen
catalog	Katalog
max	max
mother	Mutter
authority	Behörde
told	erzählte
programme	Programm
joined	beigetreten
input	Eingang
strategy	Strategie
feet	Füße
agent	Agent
valid	gültig
modern	modern
senior	Senior
sexy	sexy
teaching	Lehren
door	Tür
grand	großartig
trial	Versuch
units	Einheiten
cool	cool
normal	normal
enterprise	Unternehmen
ships	Schiffe
entire	ganz
positive	positiv
fitness	Fitness
chinese	Chinesisch
opinion	Meinung
football	Fußball
abstract	abstrakt
output	Ausgabe
funds	Mittel
mr	Herr
likely	wahrscheinlich
develop	entwickeln
artists	Künstler
alternative	Alternative
responsibility	Verantwortung
java	Java
guest	Gast
publication	Veröffentlichung
pass	bestehen
relations	Verhältnis
trust	Vertrauen
van	Transporter
contains	enthält
multi	Mehr
republic	Republik
fees	Gebühren
components	Komponenten
vacation	Ferien
century	Jahrhundert
academic	akademisch
assistance	Hilfe
completed	abgeschlossen
skin	Haut
graphics	Grafik
indian	indisch
ring	Ring
grade	Klasse
mountain	Berg
organizations	Organisationen
filter	Filter
panel	Platte
floor	Fußboden
buying	Kauf
match	Spiel
proposed	vorgeschlagen
require	benötigen
boys	Jungen
morning	Morgen
allows	erlaubt
protein	Eiweiß
plant	Pflanze
reported	berichtet
hit	schlagen
mm	Millimeter
pool	Schwimmbad
mini	Mini
politics	Politik
partner	Partner
authors	Autoren
boards	Bretter
fish	Fisch
membership	Mitgliedschaft
mission	Mission
eye	Auge
string	Schnur
sense	Sinn
modified	geändert
released	freigegeben
stage	Bühne
internal	intern
born	geboren
detailed	ausführlich
japanese	japanisch
race	Rennen
approved	genehmigt
target	Ziel
except	außer
character	Charakter
maintenance	Instandhaltung
ability	Fähigkeit
ed	ed
rape	vergewaltigen
battery	Batterie
youth	Jugend
pressure	Druck
submitted	eingereicht
debt	Schuld
medium	Mittel
television	Fernsehen
interested	interessiert
core	Ader
break	Unterbrechung
purposes	Zwecke
sets	Sets
dance	tanzen
wood	Holz
defined	definiert
papers	Papiere
awards	Auszeichnungen
fee	Gebühr
studio	Studio
reader	Leser
device	Gerät
established	etabliert
answers	Antworten
rent	Miete
las	las
dark	dunkel
external	extern
apple	Apfel
le	le
instructions	Anleitung
min	Mindest
offered	angeboten
theory	Theorie
remove	Löschen
aid	Hilfe
visual	visuell
host	Gastgeber
variety	Vielfalt
teachers	Lehrer
manual	Handbuch
block	Block
subjects	Fächer
agents	Mittel
repair	Reparatur
fair	Messe
steel	stehlen
understanding	Verstehen
songs	Lieder
fixed	Fest
wrong	falsch
beginning	Anfang
hands	Hände
az	az
paris	Paris
gets	wird
sector	Sektor
capacity	Kapazität
un	un
fat	Fett
father	Vater
electric	elektrisch
saw	sah
instruments	Instrumente
officer	Offizier
driver	Treiber
businesses	Unternehmen
dead	tot
unknown	unbekannte
restaurant	Restaurant
mike	Mike
trip	Ausflug
mi	mi
poor	Arm
relationship	Beziehung
workers	Arbeitskräfte
peace	Frieden
traditional	traditionell
showing	zeigt
creative	kreativ
coast	Küste
benefit	Vorteil
funding	Finanzierung
devices	Geräte
lord	Herr
grant	gewähren
sub	Unter
fiction	Fiktion
watches	Uhren
careers	Karriere
goes	geht
led	LED
museum	Museum
fan	Ventilator
transport	Transport
interesting	interessant
blogs	Blogs
evaluation	Auswertung
former	ehemalige
zone	Zone
complex	Komplex
th	th
cat	Katze
die	sterben
presented	vorgeführt
flat	eben
flow	fließen
agencies	Agenturen
literature	Literatur
parent	Elternteil
setting	Rahmen
dr	DR
scale	Rahmen
economy	Wirtschaft
helpful	hilfreich
monthly	monatlich
critical	kritisch
frame	Rahmen
musical	Musical
definition	Definition
secretary	Sekretär
path	Pfad
chief	Chef
gives	gibt
packages	Pakete
detail	Detail
laws	Gesetze
changed	geändert
begin	Start
royal	königlich
clean	reinigen
guy	Kerl
titles	Titel
relevant	relevant
justice	Gerechtigkeit
connect	verbinden
cup	Tasse
basket	Korb
applied	angewandt
weekly	wöchentlich
vol	vol
installation	Installation
pp	pp
attention	Beachtung
advance	vorrücken
skip	überspringen
diet	Diät
army	Armee
gear	Ausrüstung
difference	Unterschied
allowed	dürfen
correct	richtig
nation	Nation
selling	Verkauf
lots	viele
piece	Stück
sheet	Blatt
firm	Feste
seven	Sieben
elements	Elemente
species	Spezies
jump	springen
cells	Zellen
module	Modul
resort	Urlaubsort
certificate	Zertifikat
minister	Minister
motion	Bewegung
fashion	Mode
directions	Richtungen
visitors	Besucher
documentation	Dokumentation
trading	Handel
forest	Wald
calls	Anrufe
coverage	Berichterstattung
couple	Paar
giving	Angabe
chance	Chance
vision	Vision
ball	Ball
ending	Ende
clients	Kunden
actions	Aktionen
discuss	diskutieren
goal	Tor
successful	erfolgreich
sold	verkauft
wind	Wind
communities	Gemeinden
clinical	klinisch
situation	Lage
markets	Märkte
publishing	Verlagswesen
appear	erscheinen
developing	Entwicklung
lives	Leben
determine	bestimmen
temperature	Temperatur
announcements	Ankündigungen
patient	geduldig
actual	tatsächlich
historical	historisch
stone	Stein
bob	Bob
commerce	Handel
persons	Personen
difficult	schwer
scientific	wissenschaftlich
satellite	Satellit
tests	Tests
village	Dorf
accounts	Konten
amateur	Amateur
ex	Ex
met	getroffen
pain	Schmerzen
factors	Faktoren
coffee	Kaffee
buyer	Käufer
poster	Poster
edge	Kante
functional	funktional
root	Wurzel
fi	fi
closed	geschlossen
holidays	Ferien
pink	Rosa
balance	Balance
monitoring	Überwachung
replies	Antworten
shot	Schuss
initial	Initiale
label	Etikette
sec	Sekunde
canon	Kanon
league	Liga
waste	Abfall
minute	Minute
bus	Bus
provider	Anbieter
dictionary	Wörterbuch
accounting	Buchhaltung
manufacturing	Herstellung
sections	Abschnitte
chair	Stuhl
effort	Anstrengung
phase	Phase
fantasy	Fantasie
po	po
va	va
professor	Professor
install	Installieren
shirt	Hemd
apparel	Kleider
foot	Fuß
breast	Brust
techniques	Techniken
dollars	Dollar
religion	Religion
permission	Genehmigung
wild	wild
generation	Generation
miss	Fräulein
chemical	chemisch
doctor	Arzt
task	Aufgabe
reduce	reduzieren
brought	gebracht
exercise	Übung
bug	Fehler
guarantee	Garantie
leader	Führer
se	se
processes	Prozesse
soft	weich
meetings	Treffen
seconds	Sekunden
flight	Flug
congress	Kongress
fuel	Treibstoff
walk	gehen
produced	hergestellt
saint	Heilige
argument	Streit
competition	Wettbewerb
drugs	Drogen
joint	Joint
premium	Prämie
fresh	frisch
characters	Figuren
attorney	Rechtsanwalt
di	di
factor	Faktor
thousands	tausende
km	km
stream	Strom
apartments	Wohnungen
pick	pflücken
hearing	Hören
eastern	östlich
therapy	Therapie
entries	Einträge
signed	unterzeichnet
administrative	administrativ
serious	ernst
limit	Grenze
steps	Schritte
shops	Geschäfte
bondage	Knechtschaft
del	del
efforts	Anstrengungen
informed	informiert
ga	ga
thoughts	Gedanken
creek	Bach
ft	ft
quantity	Menge
essential	wesentlich
tours	Touren
load	Belastung
immediately	sofort
machines	Maschinen
designated	vorgesehen
heavy	schwer
covered	bedeckt
recovery	Wiederherstellung
integrated	integriert
configuration	Aufbau
cock	Schwanz
merchant	Händler
comprehensive	umfassend
expert	Experte
protect	schützen
solid	solide
presentation	Präsentation
became	wurde
orange	Orange
compliance	Beachtung
theme	Thema
rich	Reich
campaign	Kampagne
vs	vs
guitar	Gitarre
finding	finden
examples	Beispiele
spirit	Geist
ar	ar
claims	Ansprüche
acceptance	Annahme
strategies	Strategien
mo	mo
affairs	Angelegenheiten
intended	beabsichtigt
sa	sa
goals	Tore
hire	mieten
election	Wahl
suggest	vorschlagen
branch	Ast
serve	Dienen
affiliates	Mitgliedsorganisationen
mount	montieren
latin	Latein
multimedia	Multimedia
manage	verwalten
corner	Ecke
rank	Rang
element	Element
birth	Geburt
virus	Virus
interactive	interaktiv
requests	Anfragen
separate	trennen
quarter	Quartal
procedure	Verfahren
leadership	Führung
define	definieren
religious	religiös
facts	Fakten
breakfast	Frühstück
column	Säule
faith	Glauben
chain	Kette
identify	identifizieren
avenue	Avenue
missing	fehlt
recommendations	Empfehlungen
moved	gerührt
reach	erreichen
comparison	Vergleich
moment	Moment
extended	verlängert
sequence	Sequenz
inch	Zoll
attack	Attacke
centers	Zentren
opening	Öffnung
lab	Labor
reserve	Reservieren
gamma	Gamma
produce	produzieren
truth	Wahrheit
counter	Zähler
failure	Fehler
follows	folgt
dollar	Dollar
camp	Lager
des	die
films	Filme
bridge	Brücke
fill	füllen
movement	Bewegung
printing	Drucken
draft	Entwurf
chart	Diagramm
played	gespielt
contacts	Kontakte
readers	Leser
clubs	Clubs
wa	wa
adventure	Abenteuer
offering	Opfer
profit	profitieren
leaders	Führung
posters	Poster
institutions	Institutionen
assistant	Assistent
variable	Variable
dj	dj
parking	Parken
yesterday	gestern
determined	entschlossen
workshop	Werkstatt
gone	Weg
codes	Codes
kinds	Arten
extension	Erweiterung
statements	Aussagen
completely	vollständig
teams	Mannschaften
fort	Fort
cm	cm
senate	Senat
funny	komisch
gene	Gen
turned	gedreht
disc	Scheibe
pattern	Muster
boat	Boot
theatre	Theater
manufacturers	Hersteller
sponsor	Sponsor
classical	klassisch
icon	Symbol
warranty	Garantie
dedicated	gewidmet
direction	Richtung
basketball	Basketball
objects	Objekte
delete	löschen
evening	Abend
assembly	Versammlung
nuclear	nuklear
mouse	Maus
signal	Signal
criminal	Verbrecher
issued	ausgegeben
powerful	mächtig
dream	Traum
FALSE	FALSCH
da	da
cast	Besetzung
flower	Blume
personnel	Personal
passed	bestanden
supplied	geliefert
falls	Stürze
soul	Seele
promote	fördern
stated	angegeben
stats	Statistiken
professionals	Profis
appears	erscheint
carry	tragen
flag	Flagge
covers	Abdeckungen
em	em
advantage	Vorteil
hello	Hallo
designs	Design
maintain	pflegen
tourism	Tourismus
priority	Priorität
adults	Erwachsene
graphic	Grafik
atom	Atom
payments	Zahlungen
binding	Bindung
brief	kurz
ended	beendet
winning	gewinnt
anonymous	anonym
script	Skript
served	serviert
wants	will
prepared	bereit
void	Leere
tag	Etikett
interview	Interview
mix	mischen
framework	Rahmen
disk	Scheibe
installed	Eingerichtet
queen	Königin
credits	Kredite
clearly	deutlich
fix	Fix
handle	Griff
sweet	Süss
criteria	Kriterien
associate	assoziieren
ne	ne
behavior	Verhalten
enlarge	vergrößern
ray	Strahl
revenue	Einnahmen
measure	messen
votes	Stimmen
du	du
duty	Pflicht
discussions	Diskussionen
bear	Bär
gain	gewinnen
festival	Festival
laboratory	Labor
ocean	Ozean
flights	Flüge
experts	Fachwelt
signs	Zeichen
depth	Tiefe
train	Zug
dry	trocken
explore	erkunden
spa	Spa
concept	Konzept
nearly	fast
handling	Handhabung
origin	Ursprung
billion	Milliarde
intelligence	Intelligenz
bought	gekauft
con	con
nations	Nationen
route	Route
broken	gebrochen
battle	Schlacht
speak	sprechen
protocol	Protokoll
query	Abfrage
partnership	Partnerschaft
expression	Ausdruck
es	es
speech	Rede
wire	Draht
suggestions	Vorschläge
replacement	Ersatz
tape	Band
strategic	strategisch
judge	Richter
acid	Acid
bytes	Bytes
cent	Cent
forced	gezwungen
compatible	kompatibel
apartment	Wohnung
null	Null
zero	Null
speaker	Redner
consulting	Beratung
designer	Konstrukteur
pr	pr
marriage	Ehe
roll	rollen
banks	Banken
fr	fr
participants	Teilnehmer
secret	Geheimnis
negative	Negativ
favorites	Favoriten
theater	Theater
springs	Federung
var	var
perform	ausführen
translation	Übersetzung
estimates	Schätzungen
injury	Verletzung
ministry	Ministerium
drivers	Treiber
lawyer	Anwalt
figures	Figuren
protected	geschützt
proposal	Vorschlag
sharing	teilen
portal	Portal
beta	Beta
gratis	gratis
toward	zu
slightly	leicht
assist	helfen
conduct	Verhalten
contained	enthalten
legislation	Gesetzgebung
calling	Berufung
parameters	Parameter
profiles	Profile
matters	Angelegenheiten
houses	Häuser
controls	Steuerung
combined	kombiniert
ultimate	letzte
representative	Vertreter
minor	geringer
departments	Abteilungen
residents	Bewohner
displayed	angezeigt
mom	Mama
reduced	reduziert
rare	Selten
performed	durchgeführt
extreme	extrem
samples	Proben
bars	Riegel
forecast	Prognose
removed	entfernt
cycle	Zyklus
contain	enthalten
accuracy	Richtigkeit
sleep	Schlaf
mg	mg
bird	Vogel
pharmacy	Apotheke
creation	Schaffung
static	statisch
hunter	Jäger
addresses	Adressen
lady	Dame
crystal	Kristall
famous	berühmt
writer	Schriftsteller
chairman	Vorsitzende
drink	Getränk
academy	Akademie
dynamic	dynamisch
eat	Essen
permanent	permanent
cleaning	Reinigung
constitutes	bildet
portfolio	Mappe
practical	praktisch
delivered	geliefert
infrastructure	Infrastruktur
colour	Farbe
vendor	Verkäufer
philosophy	Philosophie
regulation	Verordnung
officers	Offiziere
aim	Ziel
bids	Gebote
nutrition	Ernährung
recording	Aufzeichnung
junior	Junior
les	les
cape	Kap
rings	Ringe
tip	Spitze
wonderful	wunderbar
ticket	Fahrkarte
announced	angekündigt
guess	vermuten
whom	wem
soccer	Fußball
math	Mathematik
import	einführen
posting	Entsendung
presence	Gegenwart
automatic	automatisch
viewing	Besichtigung
maintained	gepflegt
ch	CH
dan	Dan
dogs	Hunde
directors	Direktoren
aspects	Aspekte
ahead	voraus
moon	Mond
participation	Beteiligung
scheme	planen
fly	Fliege
manner	Weise
matrix	Matrix
combination	Kombination
amendment	Änderung
strength	Stärke
turkey	Truthahn
libraries	Bibliotheken
proper	richtig
degrees	Grad
enterprises	Unternehmen
delta	Delta
fear	Angst
seeking	suche
inches	Zoll
convention	Konvention
shares	Anteile
principal	Schulleiter
comfort	Komfort
colors	Farben
wars	Kriege
ordering	Bestellung
kept	gehalten
alpha	Alpha
appeal	Beschwerde
cruise	Kreuzfahrt
bonus	Bonus
hey	Hallo
buildings	Gebäude
specials	Angebote
beat	schlagen
batteries	Batterien
becomes	wird
drives	fährt
arms	Waffen
tea	Tee
improved	verbessert
achieve	leisten
positions	Positionen
dress	Kleid
subscription	Abonnement
dealer	Händler
contemporary	zeitgenössisch
sky	Himmel
rom	Rom
carried	getragen
exposure	Exposition
hide	verbergen
signature	Unterschrift
miller	Müller
provision	Bereitstellung
clothes	Kleider
frames	Rahmen
certainly	bestimmt
newspaper	Zeitung
toy	Spielzeug
layer	Schicht
printed	gedruckt
slow	langsam
removal	Entfernung
liability	Haftung
printers	Drucker
adding	Hinzufügen
spot	Stelle
spend	verbringen
factory	Fabrik
interior	Innere
grow	wachsen
optical	optisch
promotion	Beförderung
relative	relativ
amazing	tolle
dot	Punkt
identity	Identität
conversion	Umwandlung
feeling	Gefühl
hidden	versteckt
reasonable	angemessen
revision	Revision
influence	beeinflussen
ratio	Verhältnis
importance	Bedeutung
rain	Regen
planet	Planet
copies	Kopien
permit	erlauben
seeing	Sehen
proof	Beweis
bass	Bass
prescription	Rezept
empty	leer
instance	Beispiel
hole	Loch
ride	Reiten
bureau	Büro
conservation	Erhaltung
pair	Paar
ideal	Ideal
specs	Brille
recorded	verzeichnet
don	Don
pieces	Stücke
finished	fertig
parks	Parks
lawyers	Rechtsanwälte
stress	Stress
cream	Sahne
ss	ss
runs	läuft
discover	entdecken
ap	ap
patterns	Muster
hills	Hügel
nm	nm
advisor	Berater
aware	bewusst
shape	gestalten
evolution	Evolution
certificates	Zertifikate
objectives	Ziele
stations	Stationen
suggested	empfohlen
op	op
remains	Überreste
firms	Firmen
euro	Euro
operator	Operator
structures	Strukturen
generic	generisch
encyclopedia	Enzyklopädie
usage	Verwendung
ink	Tinte
mixed	gemischt
census	Volkszählung
wheel	Rad
suppliers	Lieferanten
compact	kompakt
poetry	Poesie
lights	Beleuchtung
tracking	Verfolgung
angel	Engel
preparation	Vorbereitung
attempt	Versuch
receiving	Empfang
matches	Streichhölzer
accordance	Übereinstimmung
width	Breite
engines	Motoren
forget	vergessen
array	Feld
discussed	diskutiert
accurate	genau
climate	Klima
greek	griechisch
instruction	Anweisung
managing	Verwaltung
raw	roh
differences	Unterschiede
explain	erklären
establish	Gründen
expressed	ausgedrückt
extent	Umfang
sharp	Scharf
ben	ben
paragraph	Absatz
kill	töten
mathematics	Mathematik
compensation	Vergütung
export	Export
managers	Manager
modules	Module
conducted	geführt
versions	Versionen
knows	weiß
describe	beschreiben
citizens	Bürger
heritage	Erbe
trouble	Ärger
coach	Trainer
agricultural	landwirtschaftlich
expand	erweitern
audience	Publikum
assigned	zugewiesen
collections	Sammlungen
ages	Ewigkeit
specialist	Spezialist
cook	Koch
affect	beeinflussen
virgin	Jungfrau
experienced	erfahren
investigation	Ermittlung
raised	angehoben
hat	Hut
institution	Institution
directed	gerichtet
affected	betroffen
bike	Fahrrad
totally	total
plate	Teller
expenses	Kosten
indicate	zeigen
blonde	blond
proceedings	Verfahren
favourite	Favorit
characteristics	Eigenschaften
der	der
lose	verlieren
organic	organisch
seek	suchen
experiences	Erfahrungen
albums	Alben
contracts	Verträge
guests	Gäste
hosted	Gastgeber
diseases	Krankheiten
concerning	über
equivalent	äquivalent
chemistry	Chemie
kits	Kits
logic	Logik
prince	Prinz
circle	Kreis
soil	Boden
psychology	Psychologie
wet	nass
circumstances	Umstände
investor	Investor
elementary	elementar
sponsors	Sponsoren
fox	Fuchs
unlimited	unbegrenzt
respond	reagieren
sizes	Größen
plain	einfach
exit	Ausfahrt
arm	Arm
keys	Schlüssel
wave	Welle
holy	heilig
acts	Handlungen
guidance	Beratung
trail	Weg
symbol	Symbol
highway	Autobahn
observed	beobachtete
dean	Dean
setup	Konfiguration
poll	Umfrage
styles	Arten
filled	gefüllt
bond	Bindung
channels	Kanäle
appendix	Blinddarm
chocolate	Schokolade
portion	Portion
scope	Umfang
supplier	Lieferant
cables	Kabel
cotton	Baumwolle
requirement	Anforderung
killed	getötet
border	Rand
ancient	alt
debate	Debatte
representatives	Vertreter
starts	beginnt
pregnancy	Schwangerschaft
attractions	Sehenswürdigkeiten
learned	gelernt
transactions	Transaktionen
explorer	Forscher
historic	historisch
husband	Mann
authorized	autorisiert
crazy	verrückt
upcoming	bevorstehende
concert	Konzert
scores	Partituren
efficiency	Wirksamkeit
comedy	Komödie
adopted	angenommen
efficient	effizient
linear	linear
commitment	Engagement
specialty	Spezialität
bears	Bären
hop	hüpfen
carrier	Träger
constant	Konstante
visa	Visa
mouth	Mund
meter	Meter
linked	verbunden
interviews	Interviews
concepts	Konzepte
gun	Gewehr
reflect	reflektieren
pure	rein
hell	Hölle
fruit	Obst
begins	beginnt
qualified	qualifiziert
reform	Reform
lens	Linse
treated	behandelt
discovery	Entdeckung
draw	zeichnen
classified	klassifiziert
assume	annehmen
alliance	Allianz
confirm	bestätigen
engineer	Ingenieur
consistent	konsistent
replace	ersetzen
clearance	Spielraum
converter	Konverter
organisation	Organisation
babe	Baby
checks	Schecks
reached	erreicht
becoming	Werden
objective	Zielsetzung
indicated	angezeigt
sugar	Zucker
crew	Crew
legs	Beine
stick	Stock
relation	Beziehung
enabled	aktiviert
genre	Genre
volunteer	Freiwillige
rear	Rückseite
democratic	demokratisch
enhance	verbessern
exact	genau
bound	gebunden
parameter	Parameter
processor	Prozessor
node	Knoten
formal	formal
storm	Sturm
micro	Mikro
colleges	Hochschulen
mile	Meile
challenges	Herausforderungen
editors	Redakteure
supreme	höchste
brothers	Brüder
recognition	Anerkennung
ref	ref
estimate	schätzen
kid	Kind
inspection	Inspektion
consumers	Verbraucher
limits	Grenzen
territory	Gebiet
weapons	Bewaffnung
delay	verzögern
pilot	Pilot
contributions	Beiträge
continuous	kontinuierlich
initiative	Initiative
novel	Roman
execution	Ausführung
disability	Behinderung
ultra	Ultra
winner	Gewinner
episode	Folge
potter	Töpfer
dish	Gericht
plays	Theaterstücke
bulletin	Bekanntmachung
ia	ia
modify	ändern
truly	wirklich
universe	Universum
candidate	Kandidat
slot	Slot
outstanding	hervorragend
ha	Ha
planned	geplant
lodge	Hütte
mirror	Spiegel
tournament	Turnier
consideration	Berücksichtigung
sessions	Sitzungen
kernel	Kern
buyers	Käufer
journals	Zeitschriften
gray	grau
catalogue	Katalog
charged	berechnet
broad	breit
und	und
chosen	gewählt
demo	Demo
hate	Hass
terminal	Terminal
publishers	Verlag
nights	Nächte
liquid	Flüssigkeit
rice	Reis
reservation	Reservierung
foods	Lebensmittel
guard	bewachen
saving	Einsparung
empire	Reich
newly	neu
raise	erziehen
illegal	illegal
expansion	Erweiterung
premier	Premier
tomorrow	Morgen
milk	Milch
drama	Theater
visiting	Besuch
contest	Wettbewerb
collected	gesammelt
bands	Bands
suitable	geeignet
absolutely	absolut
audit	Prüfung
chamber	Kammer
guinea	Guinea
findings	Ergebnisse
iso	iso
typical	typisch
sum	Summe
chicken	Hähnchen
temporary	vorübergehend
attend	besuchen
shower	Dusche
sending	Versendung
sufficient	ausreichend
shell	Schale
province	Provinz
catholic	katholisch
governor	Gouverneur
beer	Bier
contribution	Beitrag
formula	Formel
constitution	Verfassung
packaging	Verpackung
reliable	zuverlässig
doubt	Zweifel
earn	verdienen
periods	Perioden
attacks	Anschläge
merchandise	Waren
symptoms	Symptome
memorial	Denkmal
twin	Zwilling
insert	einfügen
gateway	Tor
drawing	Zeichnung
candidates	Kandidaten
ordered	bestellt
biological	biologisch
fighting	Kampf
transition	Übergang
preferences	Vorlieben
spy	Spion
romance	Romantik
instrument	Instrument
split	Teilt
themes	Themen
powers	Befugnisse
heaven	Himmel
bits	Bits
pregnant	schwanger
classification	Einstufung
focused	konzentriert
physician	Arzt
asking	fragen
blocks	Blöcke
lo	lo
spiritual	geistig
diabetes	Diabetes
ml	ml
shift	Verschiebung
sit	sitzen
bodies	Körper
photographs	Fotos
cutting	Schneiden
writers	Schriftsteller
flexible	flexibel
loved	liebte
favourites	Favoriten
mapping	Kartierung
numerous	zahlreich
relatively	verhältnismäßig
represents	repräsentiert
superior	überlegen
preferred	bevorzugt
saved	Gerettet
intellectual	intellektuelle
granted	gewährt
carbon	Kohlenstoff
comfortable	gemütlich
magnetic	magnetisch
interaction	Interaktion
listening	Hören
crisis	Krise
outlook	Ausblick
massive	massiv
bright	hell
formed	gebildet
piano	Klavier
echo	Echo
revolution	Revolution
displays	Displays
plasma	Plasma
earnings	Verdienste
mystery	Geheimnis
landscape	Landschaft
mechanical	mechanisch
journey	Reise
banner	Banner
fig	Feige
counties	Grafschaften
acquisition	Erwerb
recognized	anerkannt
dreams	Träume
notification	Benachrichtigung
kg	kg
teach	lehren
rapid	schnell
pull	ziehen
ut	ut
seminar	Seminar
investments	Investitionen
wheels	Räder
specify	angeben
sensitive	empfindlich
templates	Vorlagen
formats	Formate
holds	hält
router	Router
concrete	Beton
si	si
folder	Mappe
completion	Fertigstellung
pulse	Impuls
technique	Technik
voting	Wählen
courts	Justiz
converted	umgewandelt
metro	Metro
anniversary	Jahrestag
improvements	Verbesserungen
strip	Streifen
specification	Spezifikation
accident	Unfall
nick	Kerbe
accessible	zugänglich
resident	Bewohner
plot	Handlung
typically	typisch
representation	Darstellung
pump	Pumpe
exists	existiert
arrangements	Vereinbarungen
conferences	Konferenzen
consumption	Verbrauch
narrow	eng
threat	Bedrohung
surveys	Umfragen
sitting	Sitzung
consultant	Berater
controller	Regler
committees	Ausschüsse
penis	Penis
castle	Schloss
gardens	Gardens
labels	Etiketten
willing	bereit
bio	bio
acting	Schauspielkunst
heads	Köpfe
exam	Prüfung
residence	Residenz
density	Dichte
hundred	hundert
strange	seltsam
sustainable	nachhaltig
statistical	statistisch
mention	erwähnen
innovation	Innovation
grey	grau
parallel	parallel
operate	arbeiten
bills	Banknoten
stable	stabil
definitions	Definitionen
von	von
doctors	Ärzte
lesson	Lektion
cinema	Kino
elections	Wahlen
reaction	Reaktion
blank	leer
enhanced	verbessert
entitled	berechtigt
severe	schwer
generate	generieren
newspapers	Zeitungen
hospitals	Krankenhäuser
vi	vi
humor	Humor
aged	alt
monitors	Monitore
exception	Ausnahme
duration	Dauer
bulk	Masse
visits	Besuche
capabilities	Fähigkeiten
recommendation	Empfehlung
sin	Sünde
organized	organisiert
ba	ba
para	para
adoption	Annahme
improving	Verbesserung
expensive	teuer
buffalo	Büffel
organisations	Organisationen
plane	Ebene
programmes	Programme
mechanism	Mechanismus
ee	ee
marked	markiert
driven	Gefahren
bottle	Flasche
innovative	innovativ
massage	Massage
conclusion	Fazit
closing	Schließen
thousand	tausend
legend	Legende
villa	Villa
bone	Knochen
columns	Säulen
disorders	Störungen
collaboration	Zusammenarbeit
detection	Entdeckung
inner	innere
formation	Formation
med	med
engineers	Ingenieure
entity	Entität
cruises	Kreuzfahrten
gate	Tor
roman	römisch
duties	Aufgaben
erotic	erotisch
tone	Ton
ethics	Ethik
dragon	Drachen
busy	beschäftigt
captain	Kapitän
brings	bringt
heating	Heizung
leg	Bein
neck	Hals
wing	Flügel
scripts	Skripte
abc	ABC
appointed	ernannt
dealing	Behandlung
commit	verpflichten
rail	Schiene
trips	Reisen
gap	Spalt
sides	Seiten
tube	Tube
corresponding	dazugehörigen
descriptions	Beschreibungen
belt	Gürtel
jacket	Jacke
animation	Animation
oracle	Orakel
er	er
productions	Produktionen
aviation	Luftfahrt
proud	stolz
disaster	Katastrophe
console	Konsole
commands	Befehle
jr	jr
telecommunications	Telekommunikation
instructor	Lehrer
giant	Riese
achieved	erreicht
injuries	Verletzungen
approaches	Ansätze
usual	gewöhnlich
stamps	Briefmarken
angle	Winkel
rob	rauben
designers	Designer
liberty	Freiheit
era	Epoche
convert	Konvertieren
possibility	Möglichkeit
analyst	Analytiker
dangerous	gefährlich
reliability	Zuverlässigkeit
respectively	beziehungsweise
volunteers	Freiwillige
derived	abgeleiteten
pleasure	Vergnügen
honor	Ehre
oriented	orientiert
eagle	Adler
prayer	Gebet
workshops	Workshops
hurricane	Hurrikan
quiet	ruhig
producer	Hersteller
represented	repräsentiert
responsibilities	Verantwortlichkeiten
cheese	Käse
carefully	vorsichtig
productivity	Produktivität
crown	Krone
par	Par
diagnosis	Diagnose
maker	Hersteller
crack	Riss
principle	Prinzip
picks	Picks
gang	Gang
fetish	Fetisch
appearance	Aussehen
smoke	Rauch
filters	Filter
incorporated	inkorporiert
craft	Kunst
fellow	Gefährte
blind	blind
lounge	Salon
mad	wütend
algorithm	Algorithmus
strongly	stark
cafe	Cafe
ken	ken
proteins	Proteine
su	su
familiar	familiär
capable	fähig
admission	Eintritt
shoe	Schuh
elected	gewählt
carrying	Tragen
terrorism	Terrorismus
joy	Freude
editions	Ausgaben
ethnic	ethnisch
parliament	Parlament
actor	Darsteller
finds	Funde
seal	Dichtung
situations	Situationen
fifth	fünfte
citizen	Bürger
vertical	vertikal
corrections	Korrekturen
describes	beschreibt
disabilities	Behinderungen
substance	Substanz
prohibited	verboten
pipe	Rohr
soldiers	Soldaten
guardian	Wächter
lecture	Vorlesung
simulation	Simulation
layout	Layout
initiatives	Initiativen
ill	krank
concentration	Konzentration
lay	legen
interpretation	Deutung
dirty	dreckig
taught	unterrichtet
worker	Arbeitnehmer
optimization	Optimierung
temple	Tempel
substances	Substanzen
prove	beweisen
discovered	entdeckt
wings	Flügel
genetic	genetisch
restrictions	Beschränkungen
thin	dünn
exhibition	Ausstellung
ridge	Grat
modem	Modem
bringing	bringen
sick	krank
evaluate	bewerten
tropical	tropisch
collect	sammeln
vector	Vektor
definitely	bestimmt
turning	Drehung
existence	Existenz
commentary	Kommentar
developments	Entwicklungen
immigration	Einwanderung
destinations	Reiseziele
mutual	gegenseitig
syntax	Syntax
li	li
attribute	Attribut
prison	Gefängnis
skill	Fertigkeit
chairs	Stühle
surrounding	Umgebung
mountains	Berge
popularity	Popularität
inquiry	Anfrage
checked	geprüft
exhibit	Ausstellungsstück
throw	werfen
trend	Trend
cats	Katzen
desert	Wüste
ya	ya
coordinator	Koordinator
mercury	Quecksilber
burning	Verbrennung
escape	Flucht
receiver	Empfänger
progressive	progressiv
boats	Boote
championship	Meisterschaft
arcade	Arkade
impossible	unmöglich
tells	erzählt
obvious	offensichtlich
depression	Depression
graph	Graph
covering	Abdeckung
platinum	Platin
judgment	Beurteilung
talks	Gespräche
filing	Einreichung
foster	fördern
awarded	ausgezeichnet
trials	Versuche
masters	Meister
cartridge	Patrone
explanation	Erläuterung
org	org
fraud	Betrug
electricity	Elektrizität
spectrum	Spektrum
arrival	Ankunft
pottery	Keramik
emphasis	Betonung
awesome	genial
confirmed	Bestätigt
counts	zählt
crash	Absturz
lift	Aufzug
inter	inter
heights	Höhen
shadow	Schatten
expense	Ausgabe
venture	wagen
clinic	Klinik
healing	Heilung
princess	Prinzessin
entering	Eingeben
packet	Paket
studios	Studios
involvement	Beteiligung
dad	Papa
buttons	Tasten
placement	Platzierung
observations	Beobachtungen
winners	Gewinner
roads	Straßen
subsequent	anschließend
yard	Garten
disclosure	Bekanntgabe
establishment	Einrichtung
memories	Erinnerungen
te	te
creates	schafft
faces	Gesichter
tourist	Tourist
murder	Mord
adequate	angemessene
senator	Senator
presentations	Präsentationen
digest	verdauen
dust	Staub
wiki	Wiki
replaced	ersetzt
radar	Radar
losses	Verluste
combat	Kampf
reducing	Reduzierung
stopped	gestoppt
occupation	Besetzung
closely	eng
radiation	Strahlung
kings	Könige
shooting	Schießen
ear	Ohr
flags	Flaggen
baker	Bäcker
conservative	konservativ
shock	Schock
effectiveness	Wirksamkeit
tie	Krawatte
roof	Dach
demonstrate	zeigen
atmosphere	Atmosphäre
kiss	Kuss
beast	Tier
ra	ra
operated	betrieben
experiment	Experiment
targets	Ziele
purchases	Einkäufe
federation	Föderation
pizza	Pizza
invited	eingeladen
assignment	Zuordnung
mod	modern
queries	Abfragen
absence	Abwesenheit
vendors	Anbieter
yoga	Yoga
serves	dient
surprise	Überraschung
lamp	Lampe
jokes	Witze
counseling	Beratung
palace	Palast
satisfied	zufrieden
wins	Gewinnt
warehouse	Warenhaus
supposed	soll
ordinary	gewöhnliche
ghost	Geist
violation	Verstoß
boss	Boss
pride	Stolz
expectations	Erwartungen
independence	Unabhängigkeit
knowing	wissend
reporter	Reporter
metabolism	Stoffwechsel
champion	Champion
personally	persönlich
plenty	reichlich
solo	Solo
throat	Kehle
wealth	Reichtum
vacuum	Vakuum
dancing	Tanzen
recognize	erkenne
writes	schreibt
plaza	Piazza
quest	Suche
publish	veröffentlichen
screening	Abschirmung
trans	trans
pioneer	Pionier
forgotten	Vergessene
acrobat	Akrobat
plates	Platten
essays	Aufsätze
behaviour	Verhalten
telling	erzählen
fairly	ziemlich
intelligent	intelligent
modes	Modi
obligation	Verpflichtung
harbor	Hafen
traveler	Reisende
segment	Segment
enemy	Feind
puzzle	Puzzle
wells	Brunnen
restricted	beschränkt
republican	Republikaner
secrets	Geheimnisse
syndrome	Syndrom
attendance	Teilnahme
penalty	Elfmeter
drum	Trommel
enables	ermöglicht
builder	Baumeister
vista	Aussicht
flood	Flut
ease	Leichtigkeit
arguments	Argumente
arena	Arena
adventures	Abenteuer
pupils	Schüler
announcement	Ankündigung
outcome	Ergebnis
appreciate	schätzen
expanded	ergänzt
grown	gewachsen
lovely	schön
centres	Zentren
clause	Klausel
smile	Lächeln
lands	Länder
troops	Truppen
armed	bewaffnet
pine	Kiefer
cooling	Kühlung
gulf	Golf
trucks	LKW
mechanisms	Mechanismen
divorce	Scheidung
tradition	Tradition
pills	Pillen
tiger	Tiger
folks	Leute
sensor	Sensor
exposed	ausgesetzt
hunt	Jagd
angels	Engel
deputy	Stellvertreter
thai	thailändisch
emissions	Emissionen
physicians	Ärzte
complaint	Beschwerde
scenes	Szenen
experiments	Experimente
boost	Auftrieb
governance	Führung
mill	Mühle
founded	Gegründet
chronic	chronisch
den	Höhle
finger	Finger
keeps	hält
pound	Pfund
locate	Lokalisieren
pl	pl
trained	trainiert
implementing	Umsetzung
bread	Brot
motors	Motoren
tough	zäh
incident	Vorfall
dynamics	Dynamik
lie	Lüge
conversation	Konversation
decrease	verringern
worship	Anbetung
capability	Fähigkeit
ak	ak
precision	Präzision
damages	Schadenersatz
reserves	Reserve
solve	lösen
minority	Minderheit
diverse	vielfältig
ingredients	Zutaten
ah	Ah
tones	Töne
rehabilitation	Rehabilitation
sight	Sicht
clay	Lehm
weak	schwach
divided	geteilt
reception	Rezeption
wise	weise
odds	Chancen
seminars	Seminare
consequences	Folgen
makers	Entscheidungsträger
geography	Erdkunde
integrity	Integrität
legacy	Erbe
pleased	zufrieden
danger	Achtung
vitamin	Vitamin
processed	verarbeitet
phrase	Phrase
raising	erziehen
implications	Auswirkungen
functionality	Funktionalität
paradise	Paradies
hybrid	hybrid
reads	liest
emotional	emotional
glory	Ruhm
ja	ja
geographic	geographisch
exceed	überschreiten
rod	Stange
silk	Seide
babies	Babys
bi	Bi
romantic	romantisch
revealed	aufgedeckt
specialists	Spezialisten
generator	Generator
suspension	Suspension
sad	traurig
correction	Korrektur
wolf	Wolf
slowly	langsam
supplement	Ergänzung
portions	Teile
infant	Säugling
sectors	Branchen
fluid	Flüssigkeit
grounds	Begründung
meal	Mahlzeit
ta	ta
machinery	Maschinen
equation	Gleichung
baskets	Körbe
probability	Wahrscheinlichkeit
dimension	Abmessungen
studied	studierte
profits	Gewinne
devil	Teufel
grass	Gras
illustrated	illustriert
cherry	Kirsche
continental	kontinental
achievement	Leistung
limitations	Einschränkungen
funeral	Beerdigung
chapters	Kapitel
passenger	Passagier
convenient	praktisch
mars	Mars
sized	Größe
egg	Ei
signals	Signale
orientation	Orientierung
theft	Diebstahl
childhood	Kindheit
symbols	Symbole
lat	lat
meta	Meta
analog	Analog
talent	Talent
dated	datiert
wisdom	Weisheit
boundary	Grenze
elite	Elite
gi	gi
believes	glaubt
poems	Gedichte
jurisdiction	Zuständigkeit
robot	Roboter
displaying	Anzeige
witness	Zeuge
equipped	ausgestattet
stages	Stufen
sur	sur
acquired	erworben
assess	beurteilen
wash	waschen
entrance	Eingang
declaration	Erklärung
losing	verlieren
attempts	Versuche
noble	edel
automation	Automatisierung
impacts	Auswirkungen
rev	Umdrehung
advantages	Vorteile
knight	Ritter
aims	Ziele
extensions	Erweiterungen
appeals	Einsprüche
illness	Krankheit
ho	ho
alternatives	Alternativen
sh	Sch
soap	Seife
jam	Marmelade
unusual	ungewöhnlich
answered	antwortete
destruction	Zerstörung
migration	Migration
disorder	Störung
conventional	konventionell
wearing	tragen
axis	Achse
sought	gesucht
genes	Gene
median	Median
scanner	Scanner
herein	hierin
animated	lebhaft
adjustment	Einstellung
hero	Held
treatments	Behandlungen
attitude	Haltung
carpet	Teppich
lenses	Linsen
attended	besucht
difficulty	Schwierigkeit
punk	Punk
coalition	Koalition
enrollment	Einschreibung
duke	Herzog
pace	Tempo
producers	Produzenten
arc	Bogen
interfaces	Schnittstellen
atlas	Atlas
observation	Überwachung
torture	Folter
deleted	gelöscht
coat	Mantel
restoration	Wiederherstellung
convenience	Bequemlichkeit
returning	Rückkehr
opposition	Opposition
container	Container
defendant	Beklagte
supervisor	Supervisor
corps	Korps
actors	Schauspieler
liver	Leber
liable	haftbar
petition	Petition
antenna	Antenne
picked	gepflückt
belief	Glauben
killing	Tötung
shoulder	Schulter
decor	Dekor
ion	Ion
diameter	Durchmesser
podcast	Podcast
interactions	Wechselwirkungen
singer	Sänger
herald	Herold
aging	Altern
intervention	Intervention
plugin	Plugin
attraction	Attraktion
diving	Tauchen
modification	Änderung
suppose	annehmen
reed	Schilf
involve	betreffen
moderate	mäßig
mice	Mäuse
understood	verstanden
rapidly	schnell
ban	Verbot
assurance	Sicherheit
happening	Ereignis
vast	weit
mills	Mühlen
outline	Gliederung
receives	erhält
jeans	Jeans
compilation	Zusammenstellung
odd	ungerade
sigma	sigma
gr	GR
attractive	attraktiv
occasion	Gelegenheit
recordings	Aufnahmen
victim	Opfer
demands	Forderungen
careful	Vorsichtig
beam	Strahl
gardening	Gartenarbeit
obligations	Verbindlichkeiten
arrive	ankommen
orchestra	Orchester
licence	Lizenz
adjustable	einstellbar
allocation	Zuweisung
essay	Aufsatz
demonstrated	gezeigt
dialogue	Dialog
camps	Lager
declared	erklärt
trace	Spur
shut	geschlossen
packs	Packungen
ge	ge
installing	Installation
switches	Schalter
voluntary	freiwillig
thou	du
greatly	sehr
ng	ng
commonly	häufig
pe	pe
photographer	Fotograf
cry	Schrei
quantum	Quant
constructed	konstruiert
additions	Ergänzungen
requiring	erforderlich
arrow	Pfeil
engagement	Engagement
rough	Rau
weird	seltsam
lion	Löwe
weddings	Hochzeiten
oxygen	Sauerstoff
canyon	Schlucht
meters	Meter
merely	nur
calendars	Kalender
arrangement	Anordnung
conclusions	Schlussfolgerungen
bibliography	Literaturverzeichnis
pointer	Zeiger
compatibility	Kompatibilität
stretch	strecken
permits	Genehmigungen
cooperative	Kooperative
feeding	Ernährung
township	Gemeinde
rankings	Ranglisten
measuring	Messung
strap	Gurt
crowd	Menge
transfers	Transfers
olympic	olympisch
transformation	Transformation
dir	dir
customs	Zoll
administrators	Administratoren
personality	Persönlichkeit
hook	Haken
roulette	Roulette
decline	Ablehnen
cord	Kabel
cloud	Wolke
facilitate	erleichtern
val	val
explains	erklärt
proceed	Vorgehen
feelings	Gefühle
knife	Messer
adopt	adoptieren
denied	verweigert
donation	Spende
outer	äußere
crop	Ernte
rivers	Flüsse
nodes	Knoten
cited	zitiert
hub	Nabe
targeted	gezielt
realized	erkannte
founder	Gründer
decade	Dekade
dispute	Streit
tired	müde
adverse	negativ
excerpt	Auszug
discharge	entladen
drinks	Getränke
ace	As
voices	Stimmen
climbing	Kletterei
tons	Tonnen
perfume	Parfüm
hazardous	gefährlich
restore	wiederherstellen
stack	Stapel
methodology	Methodik
reputation	Ruf
democrats	Demokraten
hang	aufhängen
curve	Kurve
creator	Schöpfer
amber	Bernstein
museums	Museen
coding	Verschlüsselung
tracker	Tracker
variation	Variation
passage	Passage
transferred	übertragen
trunk	Kofferraum
photograph	Foto
waves	Wellen
camel	Kamel
distributor	Verteiler
chi	chi
gathering	Versammlung
projection	Projektion
mathematical	mathematisch
logical	logisch
sauce	Soße
fame	Ruhm
specialized	spezialisiert
corporations	Unternehmen
criticism	Kritik
automobile	Automobil
judges	Jury
remarks	Bemerkungen
detected	detektiert
paintings	Gemälde
walked	ging
arising	entstehen
populations	Populationen
afraid	ängstlich
acoustic	akustisch
cassette	Kassette
indicator	Indikator
jpg	jpg
mistake	Fehler
eliminate	beseitigen
mineral	Mineral
ruby	Rubin
beads	Perlen
fortune	Vermögen
canvas	Segeltuch
threshold	Schwelle
parish	Gemeinde
screens	Bildschirme
cemetery	Friedhof
stadium	Stadion
exploration	Erkundung
mins	min
stem	Stengel
astronomy	Astronomie
contests	Wettbewerbe
flu	Grippe
costume	Kostüm
bikes	Fahrräder
bishop	Bischof
pulled	zog
corn	Mais
compression	Kompression
establishing	Festlegung
farmer	Farmer
tin	Zinn
slave	Sklave
instantly	sofort
coaching	Coaching
examined	geprüft
encoding	Codierung
submissions	Einreichungen
heroes	Helden
painted	gemalt
portrait	Porträt
terrorist	Terrorist
ethical	ethisch
carriers	Träger
mobility	Mobilität
struggle	Kampf
schemes	Regelungen
suffering	Leiden
neutral	neutral
fisher	Fischer
rat	Ratte
spears	Speere
joining	Beitritt
heading	Überschrift
artificial	künstlich
bearing	Lager
spectacular	spektakulär
worlds	Welten
guilty	schuldig
activation	Aktivierung
haven	Oase
tablet	Tablette
jury	Jury
dos	DOS
tail	Schwanz
charm	Charme
violent	heftig
potentially	möglicherweise
ranch	Ranch
constraints	Einschränkungen
crossing	Kreuzung
inclusive	inklusive
cottage	Hütte
drunk	betrunken
considerable	beträchtlich
crimes	Verbrechen
resolved	aufgelöst
byte	Byte
nose	Nase
branches	Geäst
alien	Ausländer
processors	Prozessoren
broke	Pleite
complexity	Komplexität
constantly	ständig
resolve	Entschlossenheit
territories	Gebiete
thesis	These
discs	Scheiben
frequent	häufig
ceiling	Decke
pixels	Pixel
gen	gen
diamonds	Diamanten
fleet	Flotte
bunch	Bündel
theoretical	theoretisch
referral	Verweisung
quit	Verlassen
protocols	Protokolle
lung	Lunge
substitute	Ersatz
brilliant	brillant
ti	ti
gel	Gel
spoken	gesprochen
omega	Omega
evaluated	bewertet
stayed	blieb
sees	sieht
termination	Beendigung
watched	schaute
households	Haushalte
redeem	einlösen
grain	Korn
regime	Regime
bull	Stier
architectural	architektonisch
differ	abweichen
movements	Bewegungen
repairs	Reparaturen
breath	Atem
amenities	Komfort
virtually	virtuell
mart	Markt
candle	Kerze
hanging	hängend
colored	farbig
tale	Geschichte
formerly	früher
projector	Beamer
situated	gelegen
seeks	sucht
strictly	streng
psychological	psychologisch
vitamins	Vitamine
elegant	elegant
gains	Gewinne
renewal	Erneuerung
genealogy	Genealogie
deemed	als
scoring	Wertung
expenditure	Ausgaben
critics	Kritik
algorithms	Algorithmen
hacker	Hacker
salon	Salon
turbo	Turbo
cure	heilen
ni	ni
thinks	denkt
suggestion	Vorschlag
soldier	Soldat
bomb	Bombe
harm	Schaden
interval	Intervall
mirrors	Spiegel
investigate	untersuchen
thy	deine
panels	Platten
repeated	wiederholt
assault	Angriff
deer	Hirsch
tongue	Zunge
bowling	Bowling
tri	tri
monkey	Affe
proportion	Anteil
skirt	Rock
analyses	Analysen
drawings	Zeichnungen
significance	Bedeutung
scenario	Szenario
ye	Ihr
arabic	Arabisch
gauge	Spur
protecting	Schutz
faced	konfrontiert
solving	Auflösung
produces	produziert
intensive	intensiv
chains	Ketten
sixth	sechste
engage	engagieren
switching	Schaltung
correspondence	Korrespondenz
imports	Importe
supervision	Aufsicht
expenditures	Ausgaben
separation	Trennung
testimony	Zeugnis
suspect	vermuten
mandatory	verpflichtend
boundaries	Grenzen
celebration	Feier
filtering	Filter
spouse	Ehepartner
exotic	exotisch
viewer	Zuschauer
reaching	reichend
laugh	Lachen
surgical	chirurgisch
destroy	zerstören
citation	Zitat
yo	yo
premises	Lokal
proved	bewährt
offensive	beleidigend
imperial	Kaiserliche
dozen	Dutzend
deployment	Einsatz
cloth	Stoff
lotus	Lotus
salmon	Lachs
cargo	Ladung
directive	Direktive
mate	Kamerad
butter	Butter
pepper	Pfeffer
weapon	Waffe
burden	Belastung
tapes	Bänder
zones	Zonen
isle	Insel
slim	schlank
maple	Ahorn
grocery	Lebensmittelgeschäft
governing	Regierungs
depot	Depot
alt	alt
pie	Kuchen
blend	Mischung
emission	Emission
apparent	ersichtlich
instructional	Lehr
permissions	Berechtigungen
toilet	Toilette
ranked	Platz
routes	Routen
mounting	Montage
tied	gebunden
balanced	ausgewogen
delayed	verspätet
dale	Tal
calculation	Berechnung
villas	Villen
occasions	Gelegenheiten
equations	Gleichungen
oils	Öl
sept	September
exceptional	außergewöhnlich
anxiety	Angst
spatial	räumlich
respondents	Befragten
considerations	Überlegungen
pays	zahlt
sunny	sonnig
delivers	liefert
je	je
necklace	Halskette
composite	zusammengesetzt
lang	lang
theaters	Theater
designing	Entwerfen
hopes	Hoffnungen
assessments	Beurteilungen
diagram	Diagramm
footwear	Schuhwerk
sg	sg
peoples	Völker
victor	Sieger
licenses	Lizenzen
ranges	Bereiche
pairs	Paare
sensitivity	Empfindlichkeit
preservation	Erhaltung
isolated	isoliert
interim	Interim
assisted	unterstützt
divine	göttlich
approve	genehmigen
compound	Verbindung
intensity	Intensität
technological	technologisch
abortion	Abtreibung
dialog	Dialog
venues	Veranstaltungsorte
blast	sprengen
addressing	Adressierung
pole	Pole
shield	Schild
membrane	Membran
desperate	verzweifelt
mothers	Mütter
demonstration	Demonstration
governmental	Regierungs
manufactured	hergestellt
candles	Kerzen
variations	Variationen
moms	Mütter
sacred	heilig
addiction	Sucht
chrome	Chrom
refused	verweigert
brake	Bremse
exterior	Außen
greeting	Gruß
ecology	Ökologie
glen	Tal
unemployment	Arbeitslosigkeit
scored	erzielter
enhancement	Erweiterung
clone	Klon
velocity	Geschwindigkeit
lambda	Lambda
composed	zusammengesetzt
tears	Tränen
oasis	Oase
cab	Taxi
fa	Fa
societies	Gesellschaften
silicon	Silizium
identical	identisch
petroleum	Petroleum
compete	konkurrieren
ist	ist
lover	Liebhaber
belong	gehören
lips	Lippen
escort	begleiten
pond	Teich
ferry	Fähre
rabbit	Hase
profession	Beruf
dam	Damm
physiology	Physiologie
exports	Ausfuhr
tire	Reifen
participant	Teilnehmer
electron	Elektron
loads	Ladungen
heather	Heidekraut
motel	Motel
unions	Gewerkschaften
treasury	Fiskus
occupied	belegt
scales	Waage
strain	Belastung
arrested	verhaftet
investigations	Untersuchungen
gained	gewonnen
laundry	Wäsche
placing	Erteilung
adjust	einstellen
assessed	bewertet
encryption	Verschlüsselung
filling	Füllung
imposed	auferlegte
silence	Schweigen
soviet	sowjetisch
possession	Besitz
treaty	Vertrag
trainer	Trainer
organ	Organ
lemon	Zitrone
darkness	Dunkelheit
span	Spanne
joke	Scherz
packing	Verpackung
statute	Satzung
rejected	abgelehnt
shelter	Schutz
chapel	Kapelle
manufacture	Herstellung
layers	Lagen
celebrate	feiern
appliance	Gerät
mixture	Mischung
rider	Fahrer
radius	Radius
impressive	beeindruckend
sheep	Schaf
architect	Architekt
lectures	Vorlesungen
wines	Weine
cups	Tassen
ash	Asche
contributors	Beiträger
salad	Salat
violations	Verletzungen
temperatures	Temperaturen
competitions	Wettbewerbe
preserve	erhalten
poem	Gedicht
staying	bleiben
easter	Ostern
theories	Theorien
repository	Repository
streams	Strom
landing	Landung
executed	hingerichtet
negotiations	Verhandlungen
realistic	realistisch
asks	fragt
synopsis	Zusammenfassung
composer	Komponist
bean	Bohne
sword	Schwert
modifications	Modifikationen
coral	Koralle
pixel	Pixel
paths	Wegen
bubble	Blase
por	por
acquire	erwerben
contrary	Gegenteil
tribune	Tribun
vessel	Schiff
acids	Säuren
viruses	Viren
stickers	Aufkleber
reactions	Reaktionen
beliefs	Glauben
squad	Kader
analyze	analysieren
divisions	Divisionen
swim	schwimmen
nano	nano
concerts	Konzerte
males	Männchen
retain	behalten
colours	Farben
execute	ausführen
tunnel	Tunnel
genres	Genre
patents	Patente
wheat	Weizen
chronicles	Chroniken
obtaining	Beschaffung
beaver	Biber
readings	Lesungen
enlargement	Erweiterung
eagles	Adler
bases	Basen
accused	Angeklagte
campaigns	Kampagnen
unity	Einheit
defines	definiert
instances	Instanzen
indigenous	einheimisch
begun	begonnen
packets	Pakete
anchor	Anker
socks	Socken
trigger	auslösen
cholesterol	Cholesterin
differential	Differential
surfaces	Oberflächen
terrible	furchtbar
routers	Router
clocks	Uhren
arthritis	Arthritis
bios	BIOS
females	Weibchen
reflects	spiegelt
taxation	Besteuerung
fever	Fieber
cuisine	Küche
surely	sicherlich
practitioners	Praktiker
theorem	Satz
inflation	Inflation
thee	dich
compounds	Verbindungen
drums	Schlagzeug
reasonably	vernünftig
bare	blank
radical	Radikale
recommends	empfiehlt
controlling	Regelung
treasure	Schatz
flame	Flamme
pit	Grube
mono	Mono
particles	Partikel
floating	schwimmend
coordinate	Koordinate
exclusively	ausschließlich
limitation	Einschränkung
struck	geschlagen
illustration	Illustration
warnings	Warnungen
construct	bauen
apps	Apps
inquiries	Anfragen
annex	annektieren
inspiration	Inspiration
freight	Fracht
eclipse	Finsternis
affects	wirkt
forecasts	Prognosen
detect	entdecken
actively	aktiv
complicated	kompliziert
injured	verletzt
expressions	Ausdrücke
ton	Tonne
courier	Kurier
hints	Hinweise
gif	gif
conflicts	Konflikte
beverage	Getränk
tribute	Tribut
immune	immun
forestry	Forstwirtschaft
barriers	Barrieren
cant	kippen
rarely	selten
offerings	Angebote
barrier	Barriere
bicycle	Fahrrad
furnishings	Einrichtung
arise	entstehen
celtic	keltisch
particle	Partikel
humidity	Feuchtigkeit
bottles	Flaschen
dm	dm
renaissance	Renaissance
ordinance	Verordnung
photographers	Fotografen
infections	Infektionen
chess	Schach
operates	arbeitet
festivals	Feste
possibilities	Möglichkeiten
duck	Ente
canal	Kanal
contributing	Beitrag
cow	Kuh
analytical	analytisch
costumes	Kostüme
strict	streng
circulation	Verkehr
offense	Delikt
assumption	Annahme
hobby	Hobby
tries	Versuche
invention	Erfindung
technician	Techniker
executives	Führungskräfte
enquiries	Anfragen
cognitive	kognitiv
exploring	erforschen
trick	Trick
enquiry	Anfrage
closure	Schließung
timber	Bauholz
volt	Volt
intense	heftig
supporters	Unterstützer
statutes	Satzung
enrolled	eingeschrieben
sensors	Sensoren
screw	Schraube
ministers	Minister
publicly	öffentlich
suffered	litt
intake	Aufnahme
butterfly	Schmetterling
mechanics	Mechanik
headers	Header
mistakes	Fehler
numerical	numerisch
defining	definieren
counting	Zählen
reflection	Betrachtung
invitation	Einladung
sodium	Natrium
hormone	Hormon
childrens	Kinder
brick	Backstein
grip	Griff
medieval	mittelalterlich
porcelain	Porzellan
captured	gefangen
decent	anständig
casting	Guss
translated	übersetzt
donna	Donna
warrior	Krieger
cabin	Kabine
scanning	Scannen
polo	Polo
copying	Kopieren
horn	Horn
journalism	Journalismus
frog	Frosch
grammar	Grammatik
intention	Absicht
tires	Reifen
undertaken	unternommen
hazard	Gefahr
episodes	Folgen
circular	kreisförmig
anger	Zorn
illustrations	Abbildungen
chances	Chancen
happiness	Glück
bizarre	bizarr
ur	ur
fruits	Früchte
identifier	Kennzeichnung
ribbon	Band
calculations	Berechnungen
jpeg	jpeg
startup	Anfang
handy	praktisch
swap	Wechsel
exempt	befreit
crops	Pflanzen
reduces	reduziert
accomplished	durchgeführt
geometry	Geometrie
impression	Eindruck
guild	Gilde
correlation	Korrelation
sim	sim
nervous	nervös
fragrance	Duft
replica	Replik
tribe	Stamm
trades	Trades
superb	hervorragend
rid	loswerden
trinity	Dreieinigkeit
handled	abgewickelt
legends	Legenden
boom	Boom
calm	Ruhe
champions	Meister
floors	Etagen
selections	Auswahlen
comparing	Vergleichen
speaks	spricht
vocational	beruflich
pharmacies	Apotheken
ln	ln
roller	Rolle
batch	Stapel
organize	organisieren
appreciated	geschätzt
alter	ändern
edges	Kanten
mixing	Vermischung
handles	Griffe
harmony	Harmonie
distinguished	vornehm
asthma	Asthma
assumptions	Annahmen
regulated	geregelt
triangle	Dreieck
amend	ändern
anticipated	erwartet
oriental	orientalisch
reward	Belohnung
hydrogen	Wasserstoff
comparable	vergleichbar
advocate	befürworten
confusion	Verwechslung
inputs	Eingänge
warranties	Garantien
genome	Genom
medal	Medaille
coaches	Trainer
vessels	Schiffe
harbour	Hafen
eco	Öko
vulnerable	verletzlich
arrange	ordnen
artistic	künstlerisch
honors	Ehrungen
reflected	reflektiert
unified	einheitlich
breed	Rasse
detector	Detektor
ignored	ignoriert
precise	präzise
evaluating	Auswertung
lip	Lippe
gather	versammeln
forming	Bildung
journalists	Journalisten
slight	leicht
indirect	indirekt
amongst	unter
foundations	Stiftungen
horizon	Horizont
nu	nu
deeply	tief
liabilities	Verbindlichkeiten
prizes	Preise
decreased	verringert
describing	beschreiben
optics	Optik
pursue	verfolgen
lightning	Blitz
ou	ou
quotations	Zitate
inspector	Inspektor
snake	Schlange
reminder	Erinnerung
searched	gesucht
plains	Flachland
insights	Einblicke
abilities	Fähigkeiten
initiated	initiiert
karaoke	Karaoke
trap	Falle
lonely	einsam
ve	ve
observe	beobachten
containers	Behälter
attitudes	Einstellungen
berry	Beere
collar	Halsband
integrate	integrieren
sociology	Soziologie
exhibits	Exponate
dies	stirbt
terrace	Terrasse
bacteria	Bakterien
ought	sollen
delicious	köstlich
traditions	Traditionen
finite	endlich
sends	sendet
durable	dauerhaft
allied	verbündet
moisture	Feuchtigkeit
transform	verwandeln
timer	Timer
tablets	Tablets
gotten	bekommen
educators	Erzieher
vegetable	Gemüse
verse	Vers
independently	unabhängig
competitors	Konkurrenz
rocket	Rakete
aye	Ja
bullet	Kugel
towers	Türme
visibility	Sichtweite
latitude	Breite
consciousness	Bewusstsein
tumor	Tumor
ugly	hässlich
deposits	Einlagen
mistress	Herrin
encounter	Begegnung
watts	Watt
forty	vierzig
tubes	Röhren
attempted	versucht
priest	Priester
analysts	Analysten
hammer	Hammer
invasion	Invasion
runner	Läufer
rows	Reihen
administered	verabreicht
notion	Begriff
spelling	Rechtschreibung
arctic	Arktis
rewards	Belohnt
beneath	unter
strengthen	stärken
defend	verteidigen
infrared	infrarot
seventh	siebte
belly	Bauch
aggressive	aggressiv
advertisements	Anzeigen
quarters	Quartier
stolen	gestohlen
determines	bestimmt
sculpture	Skulptur
poly	Poly
ears	Ohren
fist	Faust
neo	Neo
motivation	Motivation
passengers	Passagiere
consistently	konsequent
surplus	Überschuss
dig	graben
taxi	Taxi
appreciation	Anerkennung
om	om
restriction	Beschränkung
guitars	Gitarren
essence	Wesen
mighty	mächtig
humanity	Menschheit
transcription	Transkription
complications	Komplikationen
scholars	Wissenschaftler
galaxy	Galaxis
caring	Pflege
testament	Testament
dominant	Dominant
stomach	Bauch
partially	teilweise
minimize	minimieren
ranks	Reihen
debut	Debüt
generations	Generationen
tournaments	Turniere
deny	verweigern
anatomy	Anatomie
headphones	Kopfhörer
fraction	Fraktion
trio	Trio
proceeding	Vorgehen
cube	Würfel
defects	Defekte
uncertainty	Unsicherheit
breakdown	Nervenzusammenbruch
settled	geregelt
vaccine	Impfstoff
fate	Schicksal
bookings	Buchungen
republicans	Republikaner
jungle	Dschungel
zen	Zen
dis	dis
prediction	Prognose
ecological	ökologisch
oval	Oval
implies	impliziert
ser	ser
appraisal	Bewertung
prospect	Aussicht
geographical	geographisch
donor	Spender
tension	Spannung
trash	Müll
shapes	Formen
tier	Stufe
earl	Graf
homeland	Heimat
championships	Meisterschaft
breeds	Rassen
disco	Disko
aus	aus
finishing	Veredelung
emotions	Emotionen
eternal	ewig
rotation	Drehung
nam	nam
productive	produktiv
boulevard	Boulevard
pig	Schwein
metric	metrisch
penalties	Strafen
varied	abwechslungsreicher
grande	grande
actress	Darstellerin
assign	zuordnen
accommodate	unterbringen
tigers	Tiger
villages	Dörfer
shade	Schatten
chorus	Chor
rhythm	Rhythmus
digit	Ziffer
symphony	Symphonie
sudden	plötzlich
accepting	Annehmen
pools	Schwimmbäder
lyric	lyrisch
isolation	Isolierung
speeds	Geschwindigkeiten
sustained	nachhaltig
matched	abgestimmt
approximate	ungefähr
rope	Seil
rational	rational
programmer	Programmierer
fighters	Kämpfer
inherited	vererbt
incomplete	unvollständig
vocals	Gesang
fountain	Brunnen
legitimate	legitim
biographies	Biographien
investigator	Ermittler
plaintiff	Kläger
gentle	sanft
worthy	würdig
architects	Architekten
saints	Heilige
entrepreneur	Unternehmer
carries	trägt
duo	Duo
excessive	überhöht
saves	spart
regarded	angesehen
valuation	Bewertung
unexpected	unerwartet
fog	Nebel
characteristic	charakteristisch
lobby	Empfangshalle
outlined	skizzierte
enormous	enorm
karma	Karma
consist	bestehen
queens	Königinnen
academics	Wissenschaftler
tribes	Stämme
distinction	Unterscheidung
hazards	Gefahren
exemption	Befreiung
tenant	Mieter
sustainability	Nachhaltigkeit
tattoo	Tätowierung
algebra	Algebra
shadows	Schatten
silly	dumm
freely	frei
mild	mild
fur	Pelz
readily	leicht
affiliation	Zugehörigkeit
fence	Zaun
infinite	unendlich
clan	Clan
revolutionary	Revolutionär
bracelets	Armbänder
remedy	Abhilfe
breathing	Atmung
briefly	kurz
thickness	Dicke
graphical	grafische
genius	Genius
discussing	Diskussion
fighter	Kämpfer
meaningful	sinnvoll
adapted	adaptiert
estates	Ländereien
rug	Teppich
democrat	Demokrat
borough	Bezirk
maintains	hält
ka	ka
retained	beibehalten
marble	Marmor
dem	DM
meditation	Meditation
microphone	Mikrofon
combining	Vereinigung
giants	Riesen
organizing	organisieren
memo	Memo
ham	Schinken
solved	gelöst
tide	Tide
partition	Trennwand
invisible	unsichtbar
consoles	Konsolen
magnet	Magnet
translations	Übersetzungen
jaguar	Jaguar
commodity	Ware
kilometers	Kilometer
guarantees	Garantien
gothic	gotisch
cylinder	Zylinder
witch	Hexe
buck	Bock
enemies	Feinde
consultancy	Beratung
enjoying	genießen
patrol	patrouillieren
smell	Geruch
carnival	Karneval
roughly	grob
sticker	Aufkleber
promises	Versprechen
reef	Riff
divide	Teilen
consecutive	aufeinanderfolgenden
bon	bon
representations	Vorstellungen
chan	chan
tunes	Melodien
mas	mas
phrases	Sätze
kai	kai
peninsula	Halbinsel
boring	langweilig
dom	dom
speeches	Reden
reaches	erreicht
schema	Schema
catalogs	Kataloge
ministries	Ministerien
parliamentary	parlamentarisch
prefix	Präfix
savannah	Savanne
barrel	Fass
nerve	Nerv
dans	dans
planets	Planeten
deficit	Defizit
renew	erneuern
coupled	gekoppelt
circuits	Schaltungen
texture	Textur
acknowledge	bestätigen
tent	Zelt
identifies	identifiziert
qualification	Qualifikation
locks	Schlösser
miniature	Miniatur
euros	Euro
pirates	Piraten
aerial	Antenne
hawk	Falke
consequence	Folge
systematic	systematisch
perceived	wahrgenommen
origins	Ursprünge
hired	gemietet
makeup	bilden
ui	ui
weights	Gewichte
geological	geologisch
lasting	dauerhaft
wicked	böse
introduces	einleitet
pushed	geschoben
ro	ro
slope	Steigung
poet	Dichter
conspiracy	Verschwörung
theology	Theologie
nails	Nägel
evident	offensichtlich
rides	Fahrten
epic	Epos
organizer	Veranstalter
allergy	Allergie
sake	Sake
combinations	Kombinationen
preceding	vorangestellt
merit	verdienen
enzyme	Enzym
planes	Flugzeuge
disks	Scheiben
amplifier	Verstärker
arbitrary	willkürlich
prominent	prominent
sans	sans
builds	baut
contacted	kontaktiert
shaft	Welle
lean	lehnen
occasional	gelegentlich
innovations	Innovationen
reviewing	Überprüfung
panic	Panik
citizenship	Staatsbürgerschaft
excuse	Ausrede
reforms	Reformen
onion	Zwiebel
sandwich	Sandwich
alto	Alt
hierarchy	Hierarchie
abandoned	verlassen
circles	Kreise
beats	Beats
merry	fröhlich
cult	Kult
dash	Strich
passive	passiv
valued	geschätzt
cage	Käfig
courage	Mut
elevation	Elevation
lap	Runde
utilization	Nutzung
beverages	Getränke
ping	Klingeln
entertaining	unterhaltsam
prerequisite	Voraussetzung
frontier	Grenze
refugees	Flüchtlinge
knights	Ritter
hypothesis	Hypothese
medicines	Medikamente
altered	geändert
doctrine	Lehre
scenic	szenisch
enhancements	Erweiterungen
intersection	Überschneidung
sewing	Nähen
collectors	Sammler
recognised	anerkannt
rage	Rage
prix	prix
astrology	Astrologie
advisors	Berater
pavilion	Pavillon
tactics	Taktik
supplemental	Zusatz
talented	talentiert
pillow	Kissen
spreading	Verbreitung
provinces	Provinzen
steal	stehlen
parcel	Paket
incidence	Vorfall
fears	Ängste
predict	vorhersagen
flavor	Geschmack
hungry	hungrig
metallic	metallisch
interference	Interferenz
warriors	Krieger
atmospheric	atmosphärisch
halo	Heiligenschein
parental	Eltern
referenced	verwiesen
strikes	Streiks
ant	Ameise
proposition	Vorschlag
apt	geeignet
dealt	behandelt
trader	Händler
thrown	geworfen
criterion	Kriterium
badge	Abzeichen
civilization	Zivilisation
heath	Heide
tremendous	enorm
performs	führt
realm	Reich
corrected	korrigiert
helmet	Helm
encountered	angetroffen
tsunami	Tsunami
scholar	Gelehrte
surrounded	umgeben
geology	Geologie
creatures	Kreaturen
cleared	gelöscht
accomplish	erreichen
corners	Ecken
vegetarian	Vegetarier
yeast	Hefe
pas	pas
investigated	sucht
ambassador	Botschafter
coated	beschichtete
doom	Untergang
routines	Routinen
beings	Wesen
reliance	Vertrauen
myth	Mythos
brook	Bach
fu	fu
phenomenon	Phänomen
ensemble	Ensemble
assured	versicherte
conscious	bewusst
accent	Akzent
wives	Ehefrauen
utilize	nutzen
pledge	Versprechen
vampire	Vampir
dock	Dock
organised	organisiert
musician	Musiker
limiting	Begrenzung
restored	restauriert
hint	Hinweis
armor	Rüstung
remark	Anmerkung
dozens	Dutzende
varies	variiert
reasoning	Argumentation
guards	Wächter
openings	Öffnungen
replacing	Ersetzung
researcher	Forscher
councils	Räte
occupations	Berufe
acknowledged	anerkannt
pork	Schweinefleisch
zu	zu
equilibrium	Gleichgewicht
pipes	Rohre
cottages	Hütten
merge	verschmelzen
privilege	Privileg
develops	entwickelt
chassis	Chassis
estimation	Einschätzung
barn	Scheune
frost	Frost
institutes	Institute
mold	Schimmel
dame	Freifrau
yacht	Yacht
prefers	bevorzugt
drilling	Bohrung
herb	Kraut
breach	Bruch
whale	Wal
traveller	Reisende
appropriations	Mittel
suspected	vermutlich
tomatoes	Tomaten
instructors	Lehrer
momentum	Schwung
fin	Flosse
pastor	Pastor
mud	Schlamm
emerald	Smaragd
grows	wächst
tract	Traktat
ul	ul
ballet	Ballett
journalist	Journalist
religions	Religionen
garlic	Knoblauch
shine	scheinen
explosion	Explosion
briefs	Slip
signatures	Unterschriften
ozone	Ozon
disciplines	Disziplinen
casa	casa
conversations	Gespräche
radios	Radios
tariff	Tarif
simplified	vereinfachte
muscles	Muskeln
swift	schnell
vagina	Vagina
champagne	Champagner
deviation	Abweichung
samba	Samba
employ	beschäftigen
penguin	Pinguin
magical	magisch
influences	Einflüsse
inspections	Inspektionen
irrigation	Bewässerung
miracle	Wunder
hydraulic	hydraulisch
penetration	Penetration
wound	Wunde
belle	Schöne
rosa	rosa
conviction	Überzeugung
lazy	faul
qualities	Qualitäten
fathers	Väter
charging	Lade
importantly	wichtig
petite	zierlich
apparatus	Gerät
terrain	Terrain
explaining	Erläuterung
strips	Streifen
nomination	Nominierung
empirical	empirisch
worm	Wurm
dependence	Abhängigkeit
discrete	diskret
beginner	Anfänger
lid	Deckel
sexuality	Sexualität
sapphire	Saphir
privileges	Privilegien
specializing	spezialisiert
marking	Markierung
sheriff	Sheriff
declined	abgelehnt
spies	Spion
motorcycles	Motorräder
elect	wählen
highways	Autobahnen
concentrate	konzentrieren
intimate	intim
molecules	Moleküle
rounds	Runde
refrigerator	Kühlschrank
intervals	Intervalle
sentences	Sätze
holocaust	Holocaust
flyer	Flieger
peas	Erbsen
dosage	Dosierung
variance	Unterschied
navigator	Navigator
needle	Nadel
baths	Bad
brakes	Bremsen
og	og
ko	ko
owns	besitzt
destiny	Schicksal
landscapes	Landschaften
computation	Berechnung
hay	Heu
salvation	Heil
predictions	Vorhersagen
learners	Lern
token	Zeichen
zinc	Zink
sacrifice	Opfern
seekers	Sucher
guru	Guru
suited	geeignet
numeric	numerisch
anthropology	Anthropologie
emperor	Kaiser
grad	grad
belts	Gürtel
blacks	Schwarze
educated	gebildet
proudly	stolz
necessity	Notwendigkeit
curves	Kurven
touring	Touren
vertex	Scheitel
tomato	Tomate
travels	Reisen
pale	blass
functioning	Funktion
economies	Wirtschaft
undertake	unternehmen
declare	erklären
valves	Ventile
gaps	Lücken
achievements	Erfolge
tear	reißen
teaches	lehrt
nil	Null
stranger	Fremder
nest	Nest
tribunal	Gericht
ruled	ausgeschlossen
pensions	Pensionen
prayers	Gebete
cop	Polizist
adolescent	Jugendliche
nominations	Nominierungen
banana	Banane
introductory	einleitend
reservoir	Reservoir
occurrence	Auftreten
idol	Idol
bloody	blutig
remind	erinnern
charming	reizend
tooth	Zahn
respected	respektierte
stays	Aufenthalte
affair	Affäre
restrict	beschränken
mines	Minen
portraits	Porträts
interpreted	interpretiert
evaluations	Auswertungen
elimination	Beseitigung
metres	Meter
hypothetical	hypothetisch
helicopter	Hubschrauber
pencil	Bleistift
performer	Künstler
commissions	Provisionen
sphere	Kugel
moss	Moos
ratios	Verhältnisse
concord	Eintracht
graduated	graduierte
endorsed	unterstützt
surprising	überraschend
lance	Lanze
ladder	Leiter
cork	Kork
senators	Senatoren
bleeding	Blutung
characterization	Charakterisierung
likelihood	Wahrscheinlichkeit
lanes	Bahnen
fundamentals	Grundlage
contamination	Kontamination
dome	Kuppel
bless	segnen
negotiation	Verhandlung
crest	Kamm
opponents	Gegner
triumph	Triumph
nominated	nominiert
welding	Schweißen
orgasm	Orgasmus
alloy	Legierung
plots	Stellplätze
gently	sanft
locking	Sperrung
controversial	umstritten
draws	Unentschieden
fridge	Kühlschrank
blades	Klingen
loops	Schlaufen
surge	Schwall
trauma	Trauma
advert	Inserat
defensive	Defensive
forbidden	verboten
vanilla	Vanille
programmers	Programmierer
monitored	überwacht
installations	Installationen
souls	Seelen
motivated	motiviert
dumb	Dumm
hollow	hohl
vault	Gewölbe
groove	Rille
revelation	Offenbarung
pursuit	Verfolgung
delegation	Delegation
wires	Drähte
dictionaries	Wörterbücher
transparency	Transparenz
orbit	Orbit
currencies	Währungen
niger	Niger
positioning	Positionierung
colony	Kolonie
cannon	Kanone
circus	Zirkus
promoted	gefördert
trout	Forelle
feat	Leistung
temporarily	vorübergehend
cooked	gekocht
transmit	übertragen
frequencies	Frequenzen
reflections	Reflexionen
hunger	Hunger
municipality	Gemeinde
detective	Detektiv
cement	Zement
experiencing	erleben
fireplace	Kamin
endorsement	Billigung
textiles	Textilien
missile	Rakete
psychiatry	Psychiatrie
assists	Assists
auditor	Rechnungsprüfer
violin	Geige
prophet	Prophet
oxide	Oxid
magnificent	ausgezeichnet
promptly	sofort
adaptation	Anpassung
harmful	schädlich
sexually	sexuell
enclosure	Gehege
glucose	Glucose
norm	Norm
playback	Wiedergabe
turtle	Schildkröte
distances	Entfernungen
absorption	Absorption
treasures	Schätze
fossil	Fossil
badly	schlecht
communist	Kommunist
entrepreneurs	Unternehmer
robots	Roboter
foul	Foul
biodiversity	Biodiversität
excitement	Aufregung
verbal	verbal
seas	Meere
mysterious	mysteriös
novelty	Neuheit
tiles	Fliesen
librarian	Bibliothekar
switched	schaltet
ru	ru
pose	Pose
grams	Gramm
therapist	Therapeut
budgets	Budget
goat	Ziege
render	machen
sail	Segel
commissioners	Kommissare
dense	dicht
brave	mutig
forwarding	Spedition
awful	furchtbar
airplane	Flugzeug
organisms	Organismen
telescope	Fernrohr
asbestos	Asbest
advancement	Förderung
willow	Weide
resumes	Bewerbungen
existed	existierte
generators	Generatoren
generates	erzeugt
potatoes	Kartoffeln
thorough	gründlich
receptors	Rezeptoren
optimum	Optimum
creature	Kreatur
lone	einsam
subtle	subtil
stripes	Streifen
firmware	Firmware
shepherd	Schäfer
cradle	Wiege
chancellor	Kanzler
flour	Mehl
controversy	Kontroverse
legendary	legendär
choir	Chor
avoiding	Vermeidung
beautifully	schön
expects	erwartet
jumping	Springen
fabrics	Stoffe
polymer	Polymer
hygiene	Hygiene
virtue	Tugend
surgeons	Chirurgen
mandate	Mandat
corpus	Korpus
terminology	Terminologie
gentleman	Gentleman
convicted	verurteilt
jets	Jet
indices	Indizes
qui	qui
threatening	bedrohlich
activists	Aktivisten
prisoner	Häftling
encourages	ermutigt
assembled	gebaut
terminals	Terminals
crude	roh
examines	Untersucht
viking	Wikinger
cleanup	Aufräumen
conditional	bedingt
attacked	angegriffen
arrives	kommt
translator	Übersetzer
automobiles	Automobil
tractor	Traktor
continent	Kontinent
fares	Tarife
longitude	Längengrad
hoped	hoffte
insertion	Einfügung
constraint	Zwang
strengthening	Stärkung
wishing	wünschen
insulation	Isolierung
infringement	Verletzung
bent	gebogen
subjective	subjektiv
monsters	Monster
asylum	Asyl
stake	Anteil
cocktail	Cocktail
varieties	Sorten
poison	Gift
dominated	dominiert
costly	teuer
derivatives	Derivate
prevents	verhindert
rifle	Gewehr
racism	Rassismus
interpret	interpretieren
accord	Übereinstimmung
modest	bescheiden
gamers	Spieler
sorting	Sortierung
liaison	Liaison
bulbs	Glühbirnen
tourists	Touristen
behaviors	Verhaltensweisen
clarify	klären
waist	Taille
attributed	zugeschrieben
owl	Eule
crystals	Kristalle
exceeds	überschreitet
complementary	komplementär
battles	Kämpfe
bitter	bitter
memorandum	Memorandum
dragons	Drachen
din	Lärm
incredibly	unglaublich
delegates	Delegierte
psychiatric	psychiatrisch
teenagers	Jugendliche
courtyard	Hof
presidents	Präsidenten
depart	abfahren
expressly	ausdrücklich
lily	Lilie
oversight	Aufsicht
resin	Harz
allies	Alliierte
preserved	konserviert
crossed	gekreuzt
ascending	aufsteigend
nominal	nominal
decay	zerfallen
quartz	Quarz
registers	Register
eighth	achte
authorised	autorisiert
improves	verbessert
advocates	Befürworter
phenomena	Phänomene
tilt	Neigung
granite	Granit
masses	Volk
athlete	Athlet
franc	Franc
similarity	Ähnlichkeit
leak	Leck
adviser	Berater
booklet	Broschüre
expecting	erwartet
turnover	Umsatz
urine	Urin
towel	Handtuch
ginger	Ingwer
chromosome	Chromosom
als	als
flies	Fliegen
competence	Kompetenz
crying	Weinen
amateurs	Amateure
crane	Kran
investigating	Untersuchung
rotten	faul
habit	Gewohnheit
honour	Ehre
protects	schützt
iris	Iris
manages	verwaltet
erosion	Erosion
carpenter	Zimmermann
khan	Khan
insufficient	unzureichend
formulation	Formulierung
clever	klug
lords	Herren
enjoyable	angenehm
crescent	Halbmond
sixty	sechzig
concentrated	konzentriert
distinguish	unterscheiden
ei	ei
projections	Projektionen
spark	Funke
securing	Sicherung
pathway	Weg
detectors	Detektoren
spike	Spitze
ingredient	Zutat
curtain	Vorhang
disclosed	offenbart
tactical	taktisch
pilots	Piloten
expedition	Expedition
operative	operativ
humour	Humor
mol	mol
imprint	Impressum
assisting	Unterstützung
defect	Defekt
poorly	schlecht
goddess	Göttin
observers	Beobachter
magnets	Magneten
formulas	Formeln
spacious	geräumig
argues	argumentiert
soils	Böden
organs	Organe
det	det
loyalty	Loyalität
faithful	treu
offence	Delikt
lithium	Lithium
leap	Sprung
founding	Gründung
swan	Schwan
planting	Pflanzung
covenant	Bündnis
archaeology	Archäologie
sailor	Matrose
cares	Sorgen
sanctuary	Heiligtum
statue	Statue
quotation	Zitat
majors	Majors
manipulation	Manipulation
bells	Glocken
toxicity	Toxizität
transmitter	Sender
neighborhoods	Nachbarschaften
trophy	Trophäe
emotion	Emotion
sights	Sehenswürdigkeiten
uniforms	Uniformen
wounded	verwundet
derivative	Derivat
occupancy	Belegung
doses	Dosen
educate	erziehen
prejudice	Vorurteil
technicians	Techniker
probable	wahrscheinlich
issuance	Ausgabe
decoration	Dekoration
nationals	Angehörige
trojan	Trojaner
assistants	Assistenten
counselor	Berater
enacted	erlassen
unstable	instabil
urged	gedrängt
reflecting	reflektierenden
gaining	Gewinnung
definitive	endgültig
traveled	gereist
adapt	anpassen
accession	Beitritt
regulator	Regler
fuels	Brennstoffe
soy	Soja
neat	ordentlich
naming	Benennung
stern	Stern
crafted	gearbeitete
idiot	Dummkopf
comprised	besteht
aliens	Aliens
edits	Änderungen
raven	Rabe
dwelling	Wohnung
symbolic	symbolisch
angles	Winkel
pressures	Drücke
venus	Venus
flames	Flammen
primitive	Primitive
stocking	Strumpf
ecosystem	Ökosystem
halls	Hallen
simplicity	Einfachheit
demon	Dämon
welcomed	begrüßt
notation	Notation
aunt	Tante
crow	Krähe
semantic	semantisch
discontinued	abgesetzt
decides	entscheidet
globalization	Globalisierung
asses	Esel
compass	Kompass
evolved	gewachsen
infantry	Infanterie
renowned	berühmt
corridor	Gang
philosophical	philosophisch
justification	Rechtfertigung
vacant	unbesetzt
fixing	Festsetzung
gram	Gramm
hiding	versteckt
dye	Farbstoff
alphabet	Alphabet
cleaned	gereinigt
honored	geehrt
optic	optisch
telephones	Telefone
diaries	Tagebücher
grief	Trauer
sweat	Schweiß
dolphin	Delphin
wonders	Wunder
ventilation	Belüftung
masks	Masken
bust	Büste
alley	Gasse
pathways	Bahnen
telegraph	Telegraph
monument	Monument
formally	formal
dew	Tau
withdrawn	zurückgezogen
debates	Debatten
identities	Identitäten
deficiency	Mangel
saddle	Sattel
malaria	Malaria
loyal	treu
tendency	Tendenz
utilized	verwendet
ein	ein
binoculars	Fernglas
initiate	einleiten
purely	rein
vivid	lebendig
allegations	Behauptungen
corresponds	entspricht
daemon	Daemon
celebrated	gefeiert
hunters	Jäger
acted	handelten
coefficient	Koeffizient
skull	Schädel
continuation	Fortsetzung
servant	Diener
falcon	Falke
jointly	gemeinsam
avoided	vermieden
explanations	Erklärungen
renewed	erneuert
critic	Kritiker
sediment	Sediment
squares	Quadrate
vans	Lieferwagen
cone	Kegel
survived	überlebt
prevalence	Häufigkeit
fragment	Fragment
commits	verpflichtet
cobra	Kobra
threw	warf
hoc	hoc
performers	Darsteller
dessert	Dessert
dissertation	Dissertation
ninth	neunte
enthusiasm	Begeisterung
celebrations	Feierlichkeiten
governors	Gouverneure
atoms	Atome
tissues	Gewebe
ramp	Rampe
nicely	schön
della	della
domination	Vorherrschaft
chords	Akkorde
impairment	Beeinträchtigung
molecule	Molekül
