von	od
zu	do
im	u
zum	za
ist	je
auf	na
Das	da
durch	po
Dies	ovaj
mit	s
ich	ja
Sie	vas
es	to
oder	ili
Sein	biti
sind	su
beim	na
alle	svi
haben	imati
Neu	novi
wir	mi
werden	htjeti
Zuhause	Dom
uns	nas
Über	oko
ob	ako
Seite	stranica
meine	moj
hat	ima
Suche	traži
frei	besplatno
aber	ali
unser	naše
ein	jedan
andere	drugo
machen	čini
Information	informacija
Zeit	vrijeme
er	on
welche	koji
ihr	njihov
Nachrichten	vijesti
benutzen	koristiti
Dort	tamo
sehen	vidjeti
damit	tako
Wer	tko
Netz	mreža
ebenfalls	također
bekommen	dobiti
pm	pm
Aussicht	pogled
c	c
e	e
zuerst	prvi
gewesen	bila
würde	bi
wurden	su
s	a
mögen	Kao
x	x
als	od
finden	pronaći
Preis	cijena
zurück	leđa
oben	vrh
Menschen	narod
hätten	imala
Liste	popis
Name	Ime
gerade	samo
Jahr	godina
Tag	dan
in	u
zwei	dva
Gesundheit	zdravlje
n	n
Re	ponovno
benutzt	koristi
gehen	ići
b	b
letzte	posljednji
machen	napraviti
Sie	ih
sollte	treba
Produkt	proizvod
System	sistem
Post	pošta
ihr	nju
Stadt	Grad
t	t
Politik	politika
Nummer	broj
Unterstützung	podrška
Botschaft	poruka
nach	nakon
dann	zatim
Januar	siječanj
gut	dobro
d	d
woher	gdje
Info	Informacije
Rechte	prava
Bücher	knjige
hoch	visok
Schule	škola
m	m
jeder	svaki
Links	linkovi
sie	ona
Jahre	godine
Auftrag	narudžba
sehr	vrlo
Buch	knjiga
Artikel	stavke
Unternehmen	društvo
r	r
lesen	čitati
Gruppe	skupina
Sex	seks
viele	mnogi
Benutzer	korisnik
de	de
einstellen	set
Allgemeines	general
Forschung	istraživanje
Universität	sveučilište
Januar	siječanj
Post	pošta
voll	puni
Bewertungen	recenzije
Programm	program
kennt	znati
Spiele	igre
Weg	put
Tage	dana
p	p
Teil	dio
könnte	mogao
groß	Sjajno
vereinigt	ujedinjen
echt	stvaran
f	f
International	međunarodna
Center	centar
Reise	putovati
Bemerkungen	komentari
gemacht	napravljen
Entwicklung	razvoj
Bericht	izvješće
Mitglied	član
Einzelheiten	detalji
Linie	crta
Bedingungen	Pojmovi
Vor	prije
Hotels	hoteli
tat	učinio
senden	poslati
Recht	pravo
Art	tip
lokal	lokalne
jene	oni
Ergebnisse	rezultati
Büro	ured
National	nacionalna
Auto	automobil
Design	dizajn
nehmen	uzeti
Gesendet	objavljeno
Adresse	adresa
Gemeinschaft	zajednica
innerhalb	unutar
Zustände	Države
wollen	željeti
Telefon	telefon
DVD	DVD
Gegenstand	predmet
zwischen	između
Forum	forum
Familie	obitelj
l	l
lange	dugo
w	w
Show	pokazati
O	o
sogar	čak
schwarz	crno
Besondere	poseban
Index	indeks
Sein	biće
Frau	žene
viel	mnogo
Schild	znak
Datei	datoteka
Verknüpfung	veza
öffnen	otvoren
Süd	jug
Fall	slučaj
Projekt	projekt
Seiten	stranica
Ausführung	verzija
Sektion	odjeljak
besitzen	vlastiti
Haus	kuća
Sicherheit	sigurnosti
G	g
Bezirk	okrug
amerikanisch	američki
Foto	foto
Spiel	igra
Mitglieder	članovi
Leistung	vlast
Netzwerk	mreža
Computer	Računalo
Systeme	sustavi
drei	tri
Ort	mjesto
Ende	kraj
h	h
ihm	mu
pro	po
Zugriff	pristup
denken	razmišljati
Norden	sjeverno
Ressourcen	resursi
Strom	Trenutno
groß	velik
Medien	media
Recht	zakon
Steuerung	kontrolirati
Wasser	voda
Geschichte	povijest
Größe	veličina
persönlich	osobni
führen	vodič
Geschäft	dućan
Verzeichnis	imenik
Veränderung	promijeniti
Weiß	bijela
Text	tekst
klein	mali
Wertung	klijenata
Bewertung	stopa
Regierung	vlada
Kinder	djeca
Rückkehr	povratak
Studenten	studenti
v	v
Konto	račun
mal	puta
Niveau	nivo
Digital	digitalni
Profil	profil
Bisherige	prijašnji
bilden	oblik
Veranstaltungen	događaji
Liebe	ljubav
alt	star
John	Ivan
Main	glavni
Anruf	poziv
Bild	slika
Abteilung	odjel
Titel	titula
nicht	ne
k	k
y	y
Versicherung	osiguranje
soll	treba
Eigentum	svojstvo
Klasse	klasa
CD	CD
Qualität	kvaliteta
jeden	svaki
Auflistung	spisak
Inhalt	sadržaj
Land	zemlja
wenig	malo
Werkzeuge	alat
niedrig	nizak
Antworten	odgovor
Kunde	kupac
Dezember	prosinac
vergleichen	usporediti
Filme	filmovi
Hochschule	koledž
Wert	vrijednost
Artikel	članak
Mann	čovjek
Arbeitsplätze	poslovi
j	j
Lebensmittel	hrana
Autor	Autor
anders	drugačiji
u	u
lernen	naučiti
Verkauf	prodaja
drucken	otisak
Kurs	tečaj
Job	posao
Zimmer	soba
Stock	zaliha
Ausbildung	trening
auch	isto
Kredit	Kreditna
Punkt	točka
Wissenschaft	znanost
Männer	muškarci
Kategorien	kategorije
Westen	Zapad
aussehen	izgled
Englisch	Engleski
Mannschaft	tim
Gut	imanje
Box	kutija
Bedingungen	Uvjeti
Fotos	fotografije
Fröhlich	homoseksualac
Faden	nit
Kategorie	kategorija
Hinweis	Bilješka
Leben	uživo
groß	veliki
Galerie	galerija
Tabelle	stol
jedoch	međutim
Juni	lipanj
Oktober	listopad
November	studeni
Markt	tržište
Bibliothek	knjižnica
Aktion	akcijski
Anfang	početak
Serie	niz
Eigenschaften	značajke
Luft	zrak
Industrie	industrija
planen	plan
Mensch	ljudski
Ja	Da
zweite	drugi
heiß	vruće
Kosten	cijena
Film	film
Foren	forumi
März	ožujak
la	la
September	rujan
sagen	reći
gehen	odlazak
medizinisch	medicinski
Freund	prijatelj
Dezember	prosinca
Server	server
Anwendung	primjena
Mitarbeiter	osoblje
abspielen	igra
Probleme	pitanja
April	travanj
Benutzer	Korisnici
Straße	ulica
Thema	tema
gegen	protiv
bekam	dobio
Blog	blog
Party	Zabava
Zahlung	plaćanje
Ausrüstung	oprema
Lassen	pustiti
Programme	programi
legal	pravni
kürzlich	nedavni
Park	park
Handlung	čin
Problem	problem
rot	Crvena
geben	dati
Erinnerung	memorija
Performance	izvođenje
Sozial	socijalni
q	q
Geschichte	priča
verkaufen	prodavati
Optionen	opcije
Erfahrung	iskustvo
Schlüssel	ključ
Karosserie	tijelo
jung	mladi
wichtig	važno
Feld	polje
wenige	nekoliko
Osten	istočno
Single	singl
ii	ii
Alter	dob
Verein	klub
Beispiel	primjer
Mädchen	djevojke
z	z
Straße	cesta
Geschenk	dar
Frage	pitanje
ca	ca
hart	teško
Zahlen	platiti
vier	četiri
Poker	poker
Problem	problem
Angebot	opseg
Gebäude	zgrada
Verkäufer	prodavač
Gericht	sud
Februar	veljača
Ergebnis	proizlaziti
Licht	svjetlo
schreiben	pisati
Krieg	rat
Angebot	ponuda
Blau	plava
Gruppen	grupe
al	al
einfach	lako
gegeben	dan
anfordern	zahtjev
Fax	faks
China	Kina
Herstellung	izrađivanje
Bild	slika
Bedürfnisse	potrebe
möglich	moguće
Monat	mjesec
Haupt	glavni
Star	zvijezda
Zukunft	budućnost
Raum	prostor
Ausschuss	odbor
Hand	ruka
Sonne	Sunce
Karten	kartice
London	London
Treffen	sastanak
werden	postati
Kind	dijete
behalten	zadržati
Porno	pornografija
Aktie	udio
ähnlich	sličan
Garten	vrt
Schulen	škola
Million	milijuna
hinzugefügt	dodano
Referenz	upućivanje
Firmen	tvrtke
Baby	dijete
Lernen	učenje
Energie	energija
Lauf	trčanje
Lieferung	dostava
Beliebt	popularan
Begriff	termin
Film	film
Geschichten	priče
stellen	staviti
Tagebuch	časopis
Berichte	izvještaji
co	ko
Versuchen	probati
Bilder	slika
beachten	obavijest
Gott	bog
Original	izvornik
Kopf	glava
Radio	radio
Zelle	ćelija
Rat	vijeće
enthält	uključuje
Spur	staza
Diskussion	rasprava
Archiv	arhiva
Andere	drugi
Zustimmung	sporazum
Format	format
Gesellschaft	društvo
Monate	mjeseci
Sicherheit	sigurnosni
Freunde	prijatelji
sicher	Naravno
Auflage	izdanje
Mitteilungen	poruke
Marketing	Marketing
sagen	reći
Verband	asocijacija
bietet	pruža
Spaß	zabava
bereits	već
Grün	zelena
Studien	studije
schließen	Zatvoriti
verbreitet	uobičajen
Spezifisch	specifično
mehrere	nekoliko
Leben	život
Sammlung	kolekcija
namens	zvao
kurz	kratak
Kunst	umjetnost
Menge	mnogo
Fragen	pitati
begrenzt	ograničen
Lösungen	rješenja
Direktor	direktor
Strand	plaža
Vergangenheit	prošlost
natürlich	prirodni
Elektronik	elektronika
auf	na
Zeitraum	razdoblje
Planung	planiranje
sagt	kaže
offiziell	službeno
beschädigen	pokvariti
erledigt	učinio
technisch	tehnička
Fenster	prozor
Profi	profesionalac
Region	regija
Insel	otoka
Aufzeichnung	snimiti
Direkte	direktno
Konferenz	konferencija
Aufzeichnungen	ploče
st	st
Kreis	okrug
Kalender	kalendar
Kosten	troškovi
Stil	stil
Erklärung	izjava
Meilen	milja
Ressource	resurs
Anwendungen	aplikacije
Dokument	dokument
Wort	riječ
Werk	djela
Material	materijal
Rechnung	račun
geschrieben	napisan
Regeln	pravila
Finale	konačni
Ding	stvar
Center	centar
Anforderungen	zahtjevi
WAHR	PRAVI
Protokoll	minuta
sonst	drugo
Kennzeichen	ocjena
Rock	stijena
Schlecht	loše
Individuell	pojedinac
Plus	plus
Auto	auto
Abdeckung	pokriti
bearbeiten	Uredi
zusammen	zajedno
Videos	video
schnell	brzo
Funktion	funkcija
Tatsache	činjenica
bekommen	uzimajući
global	globalno
Technik	tech
Treffen	sastati
weit	daleko
wirtschaftlich	ekonomski
en	hr
Spieler	igrač
Projekte	projekti
Menge	iznos
Uhr	Gledati
inbegriffen	uključen
Gefühl	osjetiti
Bank	banka
Risiko	rizik
Angebote	Popularna
verschiedene	raznovrstan
Wörter	riječi
Produktion	proizvodnja
kommerziell	trgovački
Gewicht	težina
Herz	srce
Behandlung	liječenje
Punkte	bodova
Wissen	znanje
Zeitschrift	časopis
Error	greška
Kamera	fotoaparat
Mädchen	djevojka
Konstruktion	izgradnja
Spielzeuge	igračke
Eingetragen	zabilježen
Domain	domena
Methoden	metode
Kapitel	poglavlje
Schutz	zaštita
Politik	politika
breit	širok
Schönheit	ljepota
Manager	menadžer
Indien	Indija
Position	položaj
genommen	poduzete
Sortieren	vrsta
Inserate	oglasi
bekannt	znan
Hälfte	pola
Fälle	slučajevi
Schritt	korak
Ingenieurwesen	inženjering
einfach	jednostavan
schnell	brz
Lizenz	licenca
See	jezero
ganze	čitav
jährlich	godišnji
veröffentlicht	Objavljeno
Kirche	crkva
Methode	način
aktiv	aktivan
Antwort	odgovor
Zahl	lik
Materialien	materijali
genug	dovoljno
entworfen	konstruiran
unter	među
Tod	smrt
Verlust	gubitak
Gesicht	lice
Marke	marka
Rabatt	popust
Auswirkungen	efekti
erstellt	stvorio
Normen	standardi
Bit	bit
politisch	politički
Königreich	kraljevstvo
Base	baza
tun	rade
Darlehen	krediti
Schuhe	cipele
Eintrag	ulaz
bleibe	boravak
Aufträge	narudžbe
Verfügbarkeit	dostupnost
Zusammenfassung	Sažetak
Wende	skretanje
Wachstum	rast
Agentur	agencija
König	kralj
europäisch	europska
Aktivität	aktivnost
Kopieren	kopirati
Western	zapadni
Macht	sila
Beschäftigung	zapošljavanje
Bucht	zaljev
Fluss	Rijeka
Kommission	komisija
Paket	paket
gesehen	vidio
Spieler	igrači
Motor	motor
Hafen	luka
Album	album
regional	Regionalni
halt	Stop
gestartet	počeo
Verwaltung	uprava
Bar	bar
Institut	institut
Ansichten	pregleda
doppelt	dvostruko
Hund	pas
bald	uskoro
Linien	linije
elektronisch	elektronička
Leistungen	prednosti
erforderlich	potreban
Drucker	printer
Bedingung	stanje
Wirksam	djelotvoran
glauben	vjerovati
Organisation	organizacija
bewirken	posljedica
Verstand	um
Auswahl	izbor
Kasino	kasino
pdf	pdf
Tour	obilazak
Kreuz	križ
Hoffnung	nada
Konzern	korporacija
Wunsch	želja
Lösung	riješenje
reifen	zreo
Rolle	uloga
Wochen	tjedni
sicher	siguran
niedriger	niži
notwendig	potreban
Union	unija
mon	mon
com	com
besonders	posebno
fein	fino
Stunde	sat
Gas	plin
Kompetenzen	vještine
sechs	šest
Buchse	grm
Inseln	otoci
Rat	savjet
Werdegang	karijera
Entscheidung	odluka
verlassen	napustiti
Vor	prije
enorm	ogroman
Frau	žena
Anlagen	postrojenja
bieten	ponuda
Mitte	srednji
Kabel	kabel
Chancen	prilike
Einnahme	uzimanje
Werte	vrijednosti
Aufteilung	podjela
Kommen	dolazak
Objekt	objekt
lesbisch	lezbijka
angemessen	prikladan
Maschine	mašina
Logo	logo
Länge	dužina
nett	Lijepo
Ergebnis	postići
Statistiken	statistika
Klient	klijent
Probe	uzorak
Investition	ulaganje
geschickt	poslao
gezeigt	prikazan
Weihnachten	Božić
Kultur	Kultura
Blitz	bljesak
Frau	ms
Wahl	izbor
Kurse	tečajevi
Verbraucher	potrošač
Hallo	bok
fremd	strana
Künstler	umjetnik
Möbel	namještaj
Kanal	kanal
Brief	pismo
Modus	način
Telefone	telefoni
Ideen	ideje
Struktur	struktura
Grad	stupanj
Vertrag	ugovor
Super	super
männlich	muški
Angelegenheit	stvar
fast	skoro
gelegen	nalazi
mehrere	višekratnik
Verteilung	distribucija
Editor	urednik
Gasthaus	gostionica
industriell	industrijski
Potenzial	potencijal
Lied	pjesma
los	los
fallen	pad
Idee	ideja
Räume	sobe
Kommunikations	komunikacije
Sieg	pobijediti
primär	osnovni
Krebs	Rak
Zahlen	brojevi
Grund	razlog
Werkzeug	alat
Frühling	Proljeće
Stiftung	temelj
Antworten	odgovor
Stimme	glas
Zeitplan	raspored
Unterlagen	dokumenti
Zweck	Svrha
Feature	svojstvo
Bett	krevet
kommt	dolazi
Polizei	policija
unabhängig	samostalan
Ansatz	pristup
braun	smeđ
physikalisch	fizička
Hügel	brdo
Karten	Karte
halt	držati
Bewertungen	ocjene
glücklich	sretan
Schmied	kovač
entwickelt	razvijen
danken	zahvaliti
sicher	sef
einzigartig	jedinstvena
Umfrage	pregled
vor	prije
Telefon	telefon
Sport	sport
bereit	spreman
Tier	životinja
Quellen	izvori
Population	populacija
pa	godišnje
regulär	redovan
sichern	siguran
Geschäftstätigkeit	operacije
einfach	jednostavno
Beweis	dokaz
Bahnhof	stanica
verstehen	razumjeti
Möglichkeit	opcija
Tal	dolina
wahrscheinlich	vjerojatno
Meer	more
Publikationen	publikacije
verbessern	poboljšati
Verbindung	veza
Herausgeber	izdavač
Halle	dvorana
Anti	anti
Netzwerke	mreže
Erde	Zemlja
Eltern	roditelji
Auswirkung	udarac
Transfer	prijenos
Einführung	Uvod
Küche	kuhinja
stark	jak
Hochzeit	vjenčanje
Eigenschaften	nekretnine
Krankenhaus	bolnica
Boden	tlo
Schiff	brod
Unterkunft	smještaj
Krankheit	bolest
Ausgezeichnet	izvrstan
perfekt	savršen
Haar	dlaka
Gelegenheit	prilika
Ausrüstung	oprema
klassisch	klasik
Basis	osnova
Befehl	naredba
Städte	gradovi
ausdrücken	izraziti
vergeben	dodijeliti
Entfernung	udaljenost
Baum	drvo
Bewertung	procjena
Mauer	zid
beteiligt	umiješan
el	el
extra	ekstra
insbesondere	posebno
Budget	budžet
Führungen	vodiči
Erfolg	uspjeh
maximal	maksimum
ma	majka
Betrieb	operacija
bestehende	postojanje
ganz	dosta
ausgewählt	odabran
Junge	dječak
Restaurants	restorani
schön	lijep
Warnung	upozorenje
Standorte	lokacije
Pferd	konj
Abstimmung	glasanje
Blumen	cvijeće
Sterne	zvijezde
Listen	arena
Inhaber	vlasnik
Tiere	životinje
Wege	načine
Sohn	sin
Bereitstellen	pružanje
Regel	Pravilo
Gehäuse	kućište
nimmt	traje
bringen	donijeti
Katalog	katalog
max	maksimum
Mutter	majka
Behörde	vlast
erzählte	rekao
Programm	program
beigetreten	spojen
Eingang	ulazni
Strategie	strategija
Füße	noge
Agent	agent
gültig	vrijedi
modern	moderan
Senior	stariji
sexy	seksi
Lehren	nastava
Tür	vrata
großartig	veličanstven
Versuch	suđenje
Einheiten	jedinice
cool	svjež
normal	normalan
Unternehmen	poduzeće
Schiffe	brodovi
ganz	čitav
positiv	pozitivan
Fitness	sposobnost
Chinesisch	kineski
Meinung	mišljenje
Fußball	nogomet
abstrakt	sažetak
Ausgabe	izlaz
Mittel	fondovi
Herr	mr
wahrscheinlich	Vjerojatno
entwickeln	razviti
Künstler	izvođači
Alternative	alternativa
Verantwortung	odgovornost
Java	Java
Gast	gost
Veröffentlichung	objavljivanje
bestehen	proći
Verhältnis	odnosi
Vertrauen	povjerenje
Transporter	kombi
enthält	sadrži
Mehr	multi
Republik	republika
Gebühren	naknada
Komponenten	komponente
Ferien	odmor
Jahrhundert	stoljeće
akademisch	akademski
Hilfe	pomoć
abgeschlossen	dovršen
Haut	koža
Grafik	grafika
indisch	Indijanac
Ring	prsten
Klasse	razred
Berg	planina
Organisationen	organizacija
Filter	filtar
Platte	ploča
Fußboden	kat
Kauf	kupovina
Spiel	utakmica
vorgeschlagen	zaprosio
benötigen	zahtijevati
Jungen	dječaci
Morgen	jutro
erlaubt	omogućuje
Eiweiß	protein
Pflanze	biljka
berichtet	izvijestio
schlagen	pogoditi
Millimeter	mm
Schwimmbad	bazen
Mini	mini
Politik	politika
Partner	partner
Autoren	autori
Bretter	ploče
Fisch	riba
Mitgliedschaft	članstvo
Mission	misija
Auge	oko
Schnur	niz
Sinn	osjećaj
geändert	promijenjen
freigegeben	oslobođen
Bühne	faza
intern	interni
geboren	rođen
ausführlich	detaljan
japanisch	japanski
Rennen	utrka
genehmigt	odobren
Ziel	cilj
außer	osim
Charakter	lik
Instandhaltung	održavanje
Fähigkeit	sposobnost
ed	ed
vergewaltigen	silovanje
Batterie	baterija
Jugend	mladež
Druck	pritisak
eingereicht	podnijeti
Schuld	dug
Mittel	srednji
Fernsehen	televizija
interessiert	zainteresiran
Ader	srž
Unterbrechung	pauza
Zwecke	svrhe
Sets	setovi
tanzen	ples
Holz	drvo
definiert	definiran
Papiere	novine
Auszeichnungen	nagrade
Gebühr	pristojba
Studio	studio
Leser	čitač
Gerät	uređaj
etabliert	osnovan
Antworten	odgovori
Miete	najam
las	las
dunkel	mrak
extern	vanjski
Apfel	jabuka
le	le
Anleitung	instrukcije
Mindest	min
angeboten	ponudio
Theorie	teorija
Löschen	ukloniti
Hilfe	pomoć
visuell	vidni
Gastgeber	domaćin
Vielfalt	raznolikost
Lehrer	učitelji
Handbuch	priručnik
Block	blok
Fächer	teme
Mittel	agenti
Reparatur	popravak
Messe	pravedan
stehlen	željezo
Verstehen	razumijevanje
Lieder	Pjesme
Fest	fiksni
falsch	pogrešno
Anfang	početak
Hände	ruke
az	AZ
Paris	Pariz
wird	dobiva
Sektor	sektor
Kapazität	kapacitet
un	uN
Fett	mast
Vater	otac
elektrisch	električni
sah	pila
Instrumente	instrumenti
Offizier	časnik
Treiber	vozač
Unternehmen	poduzeća
tot	mrtav
unbekannte	nepoznat
Restaurant	restoran
Mike	mikrofon
Ausflug	putovanje
mi	mi
Arm	siromašan
Beziehung	odnos
Arbeitskräfte	radnici
Frieden	mir
traditionell	tradicionalan
zeigt	pokazivanje
kreativ	kreativan
Küste	obala
Vorteil	korist
Finanzierung	financiranje
Geräte	uređaji
Herr	gospodar
gewähren	odobriti
Unter	pod
Fiktion	fikcija
Uhren	satovi
Karriere	karijere
geht	ide
LED	vodio
Museum	muzej
Ventilator	ventilator
Transport	prijevoz
interessant	zanimljiv
Blogs	blogovi
Auswertung	procjena
ehemalige	prijašnji
Zone	zona
Komplex	kompleks
th	th
Katze	mačka
sterben	umrijeti
vorgeführt	predstavili
eben	ravan
fließen	teći
Agenturen	agencije
Literatur	književnost
Elternteil	roditelj
Rahmen	postavljanje
DR	doktor
Rahmen	ljestvica
Wirtschaft	Ekonomija
hilfreich	koristan
monatlich	mjesečno
kritisch	kritično
Rahmen	okvir
Musical	mjuzikl
Definition	definicija
Sekretär	tajnica
Pfad	staza
Chef	glavni
gibt	daje
Pakete	paketi
Detail	detalj
Gesetze	zakoni
geändert	promijenjen
Start	početi
königlich	kraljevski
reinigen	čist
Kerl	momak
Titel	naslovi
relevant	relevantan
Gerechtigkeit	pravda
verbinden	Spojiti
Tasse	kupa
Korb	košara
angewandt	primijenjen
wöchentlich	tjedni
vol	vol
Installation	montaža
pp	str
Beachtung	pažnja
vorrücken	napredovati
überspringen	preskočiti
Diät	dijeta
Armee	vojska
Ausrüstung	zupčanik
Unterschied	razlika
dürfen	dopušteno
richtig	ispravan
Nation	narod
Verkauf	prodaja
viele	mnogo
Stück	komad
Blatt	list
Feste	firma
Sieben	sedam
Elemente	elementi
Spezies	vrsta
springen	skok
Zellen	Stanice
Modul	modul
Urlaubsort	pribjeći
Zertifikat	potvrda
Minister	ministar
Bewegung	pokret
Mode	moda
Richtungen	smjerovi
Besucher	posjetitelji
Dokumentation	dokumentacija
Handel	trgovački
Wald	šuma
Anrufe	pozivi
Berichterstattung	pokrivenost
Paar	par
Angabe	davanje
Chance	prilika
Vision	vizija
Ball	lopta
Ende	završni
Kunden	klijenti
Aktionen	akcije
diskutieren	raspravljati
Tor	cilj
erfolgreich	uspješan
verkauft	prodan
Wind	vjetar
Gemeinden	zajednice
klinisch	klinički
Lage	situacija
Märkte	tržišta
Verlagswesen	objavljivanje
erscheinen	pojaviti
Entwicklung	razvoju
Leben	život
bestimmen	odrediti
Temperatur	temperatura
Ankündigungen	najave
geduldig	pacijent
tatsächlich	stvaran
historisch	povijesni
Stein	kamen
Bob	bob
Handel	trgovina
Personen	osobe
schwer	težak
wissenschaftlich	znanstvena
Satellit	satelit
Tests	testovi
Dorf	selo
Konten	računi
Amateur	amater
Ex	ex
getroffen	sastali
Schmerzen	bol
Faktoren	čimbenici
Kaffee	kava
Käufer	kupac
Poster	poster
Kante	rub
funktional	funkcionalna
Wurzel	korijen
fi	fi
geschlossen	zatvoreno
Ferien	Praznici
Rosa	ružičasta
Balance	ravnoteža
Überwachung	nadgledanje
Antworten	odgovora
Schuss	šut
Initiale	početni
Etikette	označiti
Sekunde	sek
Kanon	kanon
Liga	liga
Abfall	gubljenje
Minute	minuta
Bus	autobus
Anbieter	usluga
Wörterbuch	rječnik
Buchhaltung	računovodstvo
Herstellung	proizvodnja
Abschnitte	dijelovi
Stuhl	stolica
Anstrengung	napor
Phase	faza
Fantasie	fantazija
po	PO
va	va
Professor	profesor
Installieren	instalirati
Hemd	košulja
Kleider	odjeća
Fuß	noga
Brust	grudi
Techniken	Tehnike
Dollar	dolara
Religion	religija
Genehmigung	dopuštenje
wild	divlji
Generation	generacija
Fräulein	propustiti
chemisch	kemijski
Arzt	liječnik
Aufgabe	zadatak
reduzieren	smanjiti
gebracht	donio
Übung	vježba
Fehler	buba
Garantie	jamčiti
Führer	vođa
se	sebi
Prozesse	procesi
weich	mekan
Treffen	sastanci
Sekunden	sekundi
Flug	let
Kongress	kongres
Treibstoff	gorivo
gehen	hodati
hergestellt	izrađen
Heilige	svetac
Streit	argument
Wettbewerb	konkurencija
Drogen	lijekovi
Joint	zajednički
Prämie	premija
frisch	svježe
Figuren	likovi
Rechtsanwalt	pravnik
di	di
Faktor	faktor
tausende	tisuća
km	km
Strom	potok
Wohnungen	apartmani
pflücken	odabrati
Hören	sluh
östlich	istočni
Therapie	terapija
Einträge	unosi
unterzeichnet	potpisan
administrativ	upravni
ernst	ozbiljan
Grenze	ograničiti
Schritte	koraci
Geschäfte	trgovine
Knechtschaft	ropstvo
del	del
Anstrengungen	napori
informiert	informiran
ga	gA
Gedanken	misli
Bach	potok
ft	ft
Menge	količina
wesentlich	osnovni
Touren	ture
Belastung	opterećenje
sofort	odmah
Maschinen	strojevi
vorgesehen	određen
schwer	teško
bedeckt	pokriven
Wiederherstellung	oporavak
integriert	integriran
Aufbau	konfiguracija
Schwanz	penis
Händler	trgovac
umfassend	opsežan
Experte	stručnjak
schützen	zaštititi
solide	solidan
Präsentation	prezentacija
wurde	postao
Orange	narančasta
Beachtung	usklađenost
Thema	tema
Reich	bogat
Kampagne	kampanja
vs	vs
Gitarre	gitara
finden	nalaz
Beispiele	primjeri
Geist	duh
ar	ar
Ansprüche	zahtjevi
Annahme	prihvaćanje
Strategien	strategije
mo	mj
Angelegenheiten	poslovi
beabsichtigt	namijenjen
sa	sa
Tore	ciljevi
mieten	najam
Wahl	izbor
vorschlagen	predložiti
Ast	podružnica
Dienen	poslužiti
Mitgliedsorganisationen	podružnice
montieren	montiranje
Latein	latinski
Multimedia	multimedijalni
verwalten	upravljati
Ecke	ugao
Rang	rang
Element	element
Geburt	rođenja
Virus	virus
interaktiv	interaktivni
Anfragen	zahtjevi
trennen	odvojen
Quartal	četvrtina
Verfahren	postupak
Führung	rukovodstvo
definieren	definirati
religiös	vjerski
Fakten	činjenicama
Frühstück	doručak
Säule	kolona
Glauben	vjera
Kette	lanac
identifizieren	identificirati
Avenue	avenija
fehlt	nedostaje
Empfehlungen	preporuke
gerührt	pomaknuto
erreichen	dohvatiti
Vergleich	usporedba
Moment	trenutak
verlängert	produžen
Sequenz	slijed
Zoll	palac
Attacke	napad
Zentren	centri
Öffnung	otvor
Labor	laboratorija
Reservieren	rezerva
Gamma	gama
produzieren	proizvoditi
Wahrheit	istina
Zähler	brojač
Fehler	neuspjeh
folgt	slijedi
Dollar	dolar
Lager	kamp
die	des
Filme	filmovi
Brücke	most
füllen	ispuniti
Bewegung	pokret
Drucken	tiskanje
Entwurf	Nacrt
Diagramm	grafikon
gespielt	igrao
Kontakte	kontakti
Leser	čitači
Clubs	klubovi
wa	wa
Abenteuer	avantura
Opfer	ponuda
profitieren	dobit
Führung	čelnici
Poster	plakati
Institutionen	institucije
Assistent	asistent
Variable	varijabla
dj	dj
Parken	parkiralište
gestern	jučer
entschlossen	odlučan
Werkstatt	radionica
Weg	otišao
Codes	kodovi
Arten	vrste
Erweiterung	nastavak
Aussagen	izjava
vollständig	potpuno
Mannschaften	timovi
Fort	tvrđava
cm	cm
Senat	senat
komisch	smiješno
Gen	gen
gedreht	okrenut
Scheibe	disk
Muster	uzorak
Boot	čamac
Theater	kazalište
Hersteller	proizvođači
Sponsor	sponzor
klassisch	klasična
Symbol	ikona
Garantie	garancija
gewidmet	posvećen
Richtung	smjer
Basketball	košarka
Objekte	objekti
löschen	izbrisati
Abend	večer
Versammlung	skupština
nuklear	nuklearni
Maus	miš
Signal	signal
Verbrecher	kriminalac
ausgegeben	izdaje
mächtig	snažan
Traum	san
FALSCH	NETOČNO
da	da
Besetzung	baciti
Blume	cvijet
Personal	osoblje
bestanden	prošao
geliefert	isporučuje
Stürze	Slapovi
Seele	duša
fördern	unaprijediti
angegeben	navedeno
Statistiken	statistika
Profis	profesionalci
erscheint	Čini
tragen	nositi
Flagge	zastava
Abdeckungen	korice
em	em
Vorteil	prednost
Hallo	zdravo
Design	dizajna
pflegen	održavati
Tourismus	turizam
Priorität	prioritet
Erwachsene	odrasli
Grafik	grafički
Atom	atom
Zahlungen	plaćanja
Bindung	vezivanje
kurz	kratak
beendet	završeno
gewinnt	osvajanjem
anonym	anoniman
Skript	skripta
serviert	služio
will	želi
bereit	pripremljen
Leere	poništiti
Etikett	označiti
Interview	intervju
mischen	miješati
Rahmen	okvir
Scheibe	disk
Eingerichtet	instaliran
Königin	kraljica
Kredite	krediti
deutlich	jasno
Fix	popraviti
Griff	rukovati
Süss	slatko
Kriterien	kriteriji
assoziieren	suradnik
ne	NE
Verhalten	ponašanje
vergrößern	uvećati
Strahl	zraka
Einnahmen	prihod
messen	mjera
Stimmen	glasova
du	du
Pflicht	dužnost
Diskussionen	rasprave
Bär	snositi
gewinnen	dobit
Festival	festival
Labor	laboratorija
Ozean	ocean
Flüge	letovi
Fachwelt	stručnjaci
Zeichen	znakovi
Tiefe	dubina
Zug	vlak
trocken	suho
erkunden	istražiti
Spa	banja
Konzept	koncept
fast	skoro
Handhabung	rukovanje
Ursprung	podrijetlo
Milliarde	milijardi
Intelligenz	inteligencija
gekauft	kupio
con	protiv
Nationen	nacije
Route	put
gebrochen	slomljen
Schlacht	bitka
sprechen	govoriti
Protokoll	protokol
Abfrage	pitanje
Partnerschaft	partnerstvo
Ausdruck	izraz
es	es
Rede	govor
Draht	žica
Vorschläge	prijedlozi
Ersatz	zamjena
Band	traka
strategisch	strateški
Richter	suditi
Acid	kiselina
Bytes	bajtova
Cent	cent
gezwungen	prisiljeni
kompatibel	kompatibilan
Wohnung	apartman
Null	nula
Null	nula
Redner	zvučnik
Beratung	savjetodavni
Konstrukteur	dizajner
pr	pr
Ehe	brak
rollen	svitak
Banken	banke
fr	fr
Teilnehmer	sudionici
Geheimnis	tajna
Negativ	negativan
Favoriten	favoriti
Theater	kazalište
Federung	izvori
var	var
ausführen	izvesti
Übersetzung	prijevod
Schätzungen	procjene
Verletzung	ozljeda
Ministerium	ministarstvo
Treiber	vozači
Anwalt	odvjetnik
Figuren	figure
geschützt	zaštićen
Vorschlag	prijedlog
teilen	dijeljenje
Portal	portal
Beta	beta
gratis	besplatno
zu	prema
leicht	malo
helfen	pomoći
Verhalten	ponašanje
enthalten	sadržane
Gesetzgebung	zakonodavstvo
Berufung	zvanje
Parameter	parametri
Profile	profili
Angelegenheiten	pitanja
Häuser	kuća
Steuerung	kontrole
kombiniert	kombinirana
letzte	ultimativno
Vertreter	predstavnik
geringer	manji
Abteilungen	odjeli
Bewohner	stanovnici
angezeigt	prikazati
Mama	mama
reduziert	smanjen
Selten	rijedak
durchgeführt	izvedena
extrem	krajnost
Proben	uzorci
Riegel	barovi
Prognose	prognoza
entfernt	ukloniti
Zyklus	ciklus
enthalten	sadržati
Richtigkeit	točnost
Schlaf	spavati
mg	mg
Vogel	ptica
Apotheke	ljekarna
Schaffung	stvaranje
statisch	statički
Jäger	Lovac
Adressen	adrese
Dame	dama
Kristall	kristal
berühmt	poznat
Schriftsteller	pisac
Vorsitzende	predsjednik
Getränk	piće
Akademie	akademija
dynamisch	dinamičan
Essen	jesti
permanent	trajan
Reinigung	čišćenje
bildet	tvori
Mappe	portfelj
praktisch	praktičan
geliefert	isporučena
Infrastruktur	infrastruktura
Farbe	boja
Verkäufer	prodavač
Philosophie	filozofija
Verordnung	regulacija
Offiziere	službenici
Ziel	cilj
Gebote	ponude
Ernährung	ishrana
Aufzeichnung	snimanje
Junior	mlađi
les	les
Kap	rt
Ringe	prstenovi
Spitze	Savjet
wunderbar	predivan
Fahrkarte	ulaznica
angekündigt	najavio
vermuten	nagađati
wem	kome
Fußball	nogomet
Mathematik	matematika
einführen	uvoz
Entsendung	postavljanje
Gegenwart	prisutnost
automatisch	automatski
Besichtigung	gledanja
gepflegt	održavati
CH	CH
Dan	Dan
Hunde	psi
Direktoren	direktori
Aspekte	aspekti
voraus	naprijed
Mond	mjesec
Beteiligung	sudjelovanje
planen	shema
Fliege	letjeti
Weise	držanje
Matrix	matrica
Kombination	kombinacija
Änderung	amandman
Stärke	snaga
Truthahn	purica
Bibliotheken	knjižnice
richtig	ispravan
Grad	stupnjeva
Unternehmen	poduzeća
Delta	delta
Angst	strah
suche	traži
Zoll	inča
Konvention	konvencija
Anteile	dionice
Schulleiter	glavni
Komfort	udobnost
Farben	boje
Kriege	ratovi
Bestellung	naručivanje
gehalten	čuva
Alpha	alfa
Beschwerde	apel
Kreuzfahrt	krstarenje
Bonus	bonus
Hallo	ej
Gebäude	građevine
Angebote	specijalaca
schlagen	pobijediti
Batterien	baterije
wird	postaje
fährt	diskovi
Waffen	oružje
Tee	čaj
verbessert	poboljšan
leisten	postići
Positionen	pozicije
Kleid	haljina
Abonnement	pretplata
Händler	prodavač
zeitgenössisch	suvremeni
Himmel	nebo
Rom	ROM
getragen	prenosi
Exposition	izlaganje
verbergen	sakriti
Unterschrift	potpis
Müller	mlinar
Bereitstellung	opskrba
Kleider	odjeća
Rahmen	okviri
bestimmt	sigurno
Zeitung	novine
Spielzeug	igračka
Schicht	sloj
gedruckt	tiskan
langsam	usporiti
Entfernung	uklanjanje
Haftung	odgovornost
Drucker	pisači
Hinzufügen	dodajući
Stelle	mjesto
verbringen	potrošiti
Fabrik	tvornica
Innere	unutrašnjost
wachsen	rasti
optisch	optički
Beförderung	promocija
relativ	rođak
tolle	nevjerojatan
Punkt	točka
Identität	identitet
Umwandlung	pretvaranje
Gefühl	osjećaj
versteckt	skriven
angemessen	razuman
Revision	revizija
beeinflussen	utjecaj
Verhältnis	omjer
Bedeutung	važnost
Regen	kiša
Planet	planeta
Kopien	kopije
erlauben	dozvola
Sehen	vidim
Beweis	dokaz
Bass	bas
Rezept	recept
leer	prazan
Beispiel	primjer
Loch	rupa
Reiten	vožnja
Büro	zavod
Erhaltung	konzervacija
Paar	par
Ideal	idealan
Brille	naočale
verzeichnet	zabilježena
Don	Don
Stücke	komada
fertig	gotov
Parks	parkovi
Rechtsanwälte	odvjetnici
Stress	stres
Sahne	krema
ss	ss
läuft	radi
entdecken	otkriti
ap	ap
Muster	obrasci
Hügel	brda
nm	nm
Berater	savjetnik
bewusst	svjestan
gestalten	oblik
Evolution	evolucija
Zertifikate	potvrde
Ziele	ciljevi
Stationen	stanice
empfohlen	predložio
op	op
Überreste	ostaci
Firmen	tvrtke
Euro	euro
Operator	operater
Strukturen	strukture
generisch	opći
Enzyklopädie	enciklopedija
Verwendung	upotreba
Tinte	tinta
gemischt	mješovit
Volkszählung	popis
Rad	kotač
Lieferanten	dobavljači
kompakt	kompaktan
Poesie	poezija
Beleuchtung	svjetla
Verfolgung	praćenje
Engel	anđeo
Vorbereitung	priprema
Versuch	pokušaj
Empfang	primanje
Streichhölzer	šibice
Übereinstimmung	suglasnost
Breite	širina
Motoren	motori
vergessen	zaboraviti
Feld	red
diskutiert	raspravljati
genau	točan
Klima	klima
griechisch	grčki
Anweisung	instrukcija
Verwaltung	upravljanje
roh	sirov
Unterschiede	Razlike
erklären	objasniti
Gründen	uspostaviti
ausgedrückt	izrazio
Umfang	opseg
Scharf	oštar
ben	Ben
Absatz	stav
töten	ubiti
Mathematik	matematika
Vergütung	kompenzacija
Export	izvoz
Manager	menadžeri
Module	moduli
geführt	provedena
Versionen	verzije
weiß	zna
beschreiben	opisati
Bürger	građani
Erbe	nasljeđe
Ärger	nevolja
Trainer	trener
landwirtschaftlich	poljoprivredni
erweitern	proširiti
Publikum	publika
zugewiesen	dodijeljena
Sammlungen	zbirke
Ewigkeit	dobi
Spezialist	specijalista
Koch	kuhati
beeinflussen	utjecati
Jungfrau	Djevica
erfahren	iskusan
Ermittlung	istraga
angehoben	uzdignut
Hut	šešir
Institution	institucija
gerichtet	usmjerene
betroffen	pogođeni
Fahrrad	bicikl
total	potpuno
Teller	ploča
Kosten	troškovi
zeigen	naznačiti
blond	plavuša
Verfahren	postupak
Favorit	ljubimac
Eigenschaften	karakteristike
der	der
verlieren	izgubiti
organisch	organski
suchen	tražiti
Erfahrungen	iskustva
Alben	albuma
Verträge	ugovori
Gäste	gosti
Gastgeber	domaćin
Krankheiten	oboljenja
über	o
äquivalent	ekvivalent
Chemie	kemija
Kits	setove
Logik	logika
Prinz	princ
Kreis	krug
Boden	tlo
Psychologie	psihologija
nass	mokar
Umstände	okolnosti
Investor	investitor
elementar	osnovni
Sponsoren	sponzori
Fuchs	lisica
unbegrenzt	neograničen
reagieren	odgovarati
Größen	veličine
einfach	običan
Ausfahrt	Izlaz
Arm	ruka
Schlüssel	ključevi
Welle	val
heilig	svet
Handlungen	djela
Beratung	vođenje
Weg	trag
Symbol	simbol
Autobahn	autocesta
beobachtete	promatranom
Dean	dekan
Konfiguration	postaviti
Umfrage	anketa
Arten	stilovi
gefüllt	ispunjen
Bindung	veza
Kanäle	kanali
Blinddarm	dodatak
Schokolade	čokolada
Portion	dio
Umfang	djelokrug
Lieferant	dobavljač
Kabel	kabeli
Baumwolle	pamuk
Anforderung	zahtjev
getötet	ubijen
Rand	granica
alt	antički
Debatte	debata
Vertreter	predstavnici
beginnt	počinje
Schwangerschaft	trudnoća
Sehenswürdigkeiten	atrakcije
gelernt	naučeno
Transaktionen	transakcije
Forscher	istraživač
historisch	povijesni
Mann	suprug
autorisiert	odobren
verrückt	lud
bevorstehende	Nadolazeći
Konzert	koncert
Partituren	rezultate
Wirksamkeit	efikasnost
Komödie	komedija
angenommen	usvojen
effizient	učinkovit
linear	linearan
Engagement	opredjeljenje
Spezialität	specijalitet
Bären	medvjedi
hüpfen	hmelj
Träger	prijevoznik
Konstante	konstantno
Visa	Visa
Mund	usta
Meter	metar
verbunden	povezan
Interviews	razgovori
Konzepte	pojmovi
Gewehr	puška
reflektieren	odraziti
rein	čist
Hölle	pakao
Obst	voće
beginnt	počinje
qualifiziert	kvalificiran
Reform	reforma
Linse	leće
behandelt	liječi
Entdeckung	otkriće
zeichnen	crtati
klassifiziert	svrstan
annehmen	pretpostaviti
Allianz	savez
bestätigen	potvrditi
Ingenieur	inženjer
konsistent	dosljedan
ersetzen	zamijeniti
Spielraum	odobrenje
Konverter	konverter
Organisation	organizacija
Baby	dijete
Schecks	provjere
erreicht	postignut
Werden	postaje
Zielsetzung	cilj
angezeigt	naznačeno
Zucker	šećer
Crew	posada
Beine	noge
Stock	štap
Beziehung	odnos
aktiviert	omogućeno
Genre	žanr
Freiwillige	dobrovoljac
Rückseite	stražnji
demokratisch	demokratski
verbessern	povećati
genau	točno
gebunden	granica
Parameter	parametar
Prozessor	procesor
Knoten	čvor
formal	formalan
Sturm	oluja
Mikro	mikro
Hochschulen	fakulteti
Meile	milja
Herausforderungen	izazovi
Redakteure	urednici
höchste	vrhovni
Brüder	braća
Anerkennung	priznanje
ref	Najbolje
schätzen	procjena
Kind	dijete
Inspektion	inspekcija
Verbraucher	potrošači
Grenzen	granice
Gebiet	teritorija
Bewaffnung	oružje
verzögern	odgoditi
Pilot	pilot
Beiträge	doprinosi
kontinuierlich	stalan
Initiative	inicijativa
Roman	roman
Ausführung	izvršenje
Behinderung	invalidnost
Ultra	ultra
Gewinner	pobjednik
Folge	epizoda
Töpfer	lončar
Gericht	jelo
Theaterstücke	igra
Bekanntmachung	bilten
ia	ia
ändern	izmijeniti
wirklich	uistinu
Universum	svemir
Kandidat	kandidat
Slot	prorez
hervorragend	izvanredan
Ha	Ha
geplant	planirani
Hütte	loža
Spiegel	ogledalo
Turnier	turnir
Berücksichtigung	obzir
Sitzungen	sjednice
Kern	zrno
Käufer	kupci
Zeitschriften	časopisi
grau	siva
Katalog	katalog
berechnet	optužen
breit	širok
und	und
gewählt	odabran
Demo	demo
Hass	mrziti
Terminal	terminal
Verlag	izdavači
Nächte	noću
Flüssigkeit	tekući
Reis	riža
Reservierung	rezervacija
Lebensmittel	hrana
bewachen	straža
Einsparung	ušteda
Reich	carstvo
neu	novo
erziehen	podići
illegal	nezakonit
Erweiterung	ekspanzija
Premier	premijer
Morgen	sutra
Milch	mlijeko
Theater	drama
Besuch	gostujući
Wettbewerb	Natjecanje
gesammelt	prikupljeni
Bands	bendovi
geeignet	pogodan
absolut	apsolutno
Prüfung	revizija
Kammer	komora
Guinea	Gvineja
Ergebnisse	nalazi
iso	izo
typisch	tipičan
Summe	iznos
Hähnchen	piletina
vorübergehend	privremen
besuchen	prisustvovati
Dusche	tuš
Versendung	slanje
ausreichend	dovoljan
Schale	ljuska
Provinz	pokrajina
katholisch	katolički
Gouverneur	guverner
Bier	pivo
Beitrag	doprinos
Formel	formula
Verfassung	ustav
Verpackung	ambalaža
zuverlässig	pouzdan
Zweifel	sumnjati
verdienen	zaraditi
Perioden	razdoblja
Anschläge	napadi
Waren	roba
Symptome	simptomi
Denkmal	spomen
Zwilling	blizanac
einfügen	umetnuti
Tor	prolaz
Zeichnung	crtanje
Kandidaten	kandidati
bestellt	naredio
biologisch	biološki
Kampf	borba
Übergang	tranzicija
Vorlieben	postavke
Spion	špijun
Romantik	romantika
Instrument	instrument
Teilt	podjela
Themen	teme
Befugnisse	sile
Himmel	raj
Bits	komadići
schwanger	trudna
Einstufung	klasifikacija
konzentriert	usmjerena
Arzt	liječnik
fragen	traži
Blöcke	blokovi
lo	gle
geistig	duhovni
Diabetes	dijabetes
ml	ml
Verschiebung	smjena
sitzen	sjediti
Körper	tjelesa
Fotos	fotografije
Schneiden	rezanje
Schriftsteller	pisci
flexibel	fleksibilno
liebte	voljen
Favoriten	favoriti
Kartierung	kartografija
zahlreich	brojan
verhältnismäßig	relativno
repräsentiert	predstavlja
überlegen	superioran
bevorzugt	poželjna
Gerettet	spremaju
intellektuelle	intelektualac
gewährt	odobreno
Kohlenstoff	ugljen
gemütlich	udobno
magnetisch	magnetski
Interaktion	interakcija
Hören	slušanje
Krise	kriza
Ausblick	pogled
massiv	masivan
hell	svijetao
gebildet	formirana
Klavier	klavir
Echo	jeka
Revolution	revolucija
Displays	prikazuje
Plasma	plazma
Verdienste	zarada
Geheimnis	misterija
Landschaft	pejzaž
mechanisch	mehanički
Reise	putovanje
Banner	zastava
Feige	smokva
Grafschaften	županije
Erwerb	akvizicija
anerkannt	priznat
Träume	snovi
Benachrichtigung	obavijest
kg	kg
lehren	učiti
schnell	brz
ziehen	Vuci
ut	Juta
Seminar	seminar
Investitionen	investicije
Räder	kotači
angeben	odrediti
empfindlich	osjetljiv
Vorlagen	predlošci
Formate	formati
hält	drži
Router	usmjerivač
Beton	beton
si	si
Mappe	mapa
Fertigstellung	završetak
Impuls	puls
Technik	tehnika
Wählen	glasanje
Justiz	sudovi
umgewandelt	pretvaraju
Metro	metro
Jahrestag	godišnjica
Verbesserungen	poboljšanja
Streifen	traka
Spezifikation	specifikacija
Unfall	nesreća
Kerbe	zarez
zugänglich	dostupan
Bewohner	Rezidencija
Handlung	zemljište
typisch	tipično
Darstellung	prikaz
Pumpe	pumpa
existiert	postoji
Vereinbarungen	aranžmani
Konferenzen	konferencije
Verbrauch	potrošnja
eng	suziti
Bedrohung	prijetnja
Umfragen	ankete
Sitzung	sjedenje
Berater	konzultant
Regler	kontrolor
Ausschüsse	odbori
Penis	penis
Schloss	dvorac
Gardens	vrtovi
Etiketten	etikete
bereit	spreman
bio	bio
Schauspielkunst	gluma
Köpfe	glave
Prüfung	ispit
Residenz	prebivalište
Dichte	gustoća
hundert	stotina
seltsam	čudan
nachhaltig	održiv
statistisch	statistički
erwähnen	spomenuti
Innovation	inovacija
grau	siva
parallel	paralelno
arbeiten	raditi
Banknoten	novčanice
stabil	stabilan
Definitionen	definicije
von	von
Ärzte	liječnici
Lektion	lekcija
Kino	kino
Wahlen	izbori
Reaktion	reakcija
leer	prazan
verbessert	poboljšane
berechtigt	pravo
schwer	ozbiljan
generieren	generirati
Zeitungen	novine
Krankenhäuser	bolnice
vi	vi
Humor	humor
alt	star
Monitore	monitori
Ausnahme	izuzetak
Dauer	trajanje
Masse	Glavnina
Besuche	posjeta
Fähigkeiten	sposobnosti
Empfehlung	preporuka
Sünde	grijeh
organisiert	organizirani
ba	ba
para	stavak
Annahme	posvajanje
Verbesserung	poboljšanje
teuer	skup
Büffel	bizon
Organisationen	organizacija
Ebene	avion
Programme	programi
Mechanismus	mehanizam
ee	ee
markiert	obilježen
Gefahren	upravljan
Flasche	boca
innovativ	inovativan
Massage	masaža
Fazit	zaključak
Schließen	zatvaranje
tausend	tisuću
Legende	legenda
Villa	vila
Knochen	kost
Säulen	stupovi
Störungen	poremećaji
Zusammenarbeit	kolaboracija
Entdeckung	otkrivanje
innere	unutrašnji
Formation	formacija
med	med
Ingenieure	inženjeri
Entität	osoba
Kreuzfahrten	krstarenja
Tor	vrata
römisch	rimski
Aufgaben	dužnosti
erotisch	erotski
Ton	ton
Ethik	etika
Drachen	zmaj
beschäftigt	zaposlen
Kapitän	kapetan
bringt	donosi
Heizung	grijanje
Bein	noga
Hals	vrat
Flügel	krilo
Skripte	skripta
ABC	abeceda
ernannt	postavljen
Behandlung	bavljenje
verpflichten	počiniti
Schiene	željeznički
Reisen	putovanja
Spalt	praznina
Seiten	strane
Tube	cijev
dazugehörigen	odgovara
Beschreibungen	opisi
Gürtel	pojas
Jacke	jakna
Animation	animacija
Orakel	proročanstvo
er	er
Produktionen	produkcija
Luftfahrt	zrakoplovstvo
stolz	ponos
Katastrophe	katastrofa
Konsole	konzola
Befehle	naredbe
jr	jr
Telekommunikation	telekomunikacija
Lehrer	instruktor
Riese	gigantski
erreicht	postići
Verletzungen	ozljede
Ansätze	pristupi
gewöhnlich	uobičajen
Briefmarken	marke
Winkel	kut
rauben	opljačkati
Designer	dizajneri
Freiheit	sloboda
Epoche	doba
Konvertieren	Pretvoriti
Möglichkeit	mogućnost
Analytiker	analitičar
gefährlich	opasno
Zuverlässigkeit	pouzdanost
beziehungsweise	odnosno
Freiwillige	volonteri
abgeleiteten	izveden
Vergnügen	zadovoljstvo
Ehre	čast
orientiert	orijentiran
Adler	orao
Gebet	molitva
Workshops	radionice
Hurrikan	uragan
ruhig	miran
Hersteller	proizvođač
repräsentiert	zastupljeni
Verantwortlichkeiten	odgovornosti
Käse	sir
vorsichtig	pažljivo
Produktivität	produktivnost
Krone	kruna
Par	jednakost
Diagnose	dijagnoza
Hersteller	tvorac
Riss	pukotina
Prinzip	načelo
Picks	motika
Gang	banda
Fetisch	fetiš
Aussehen	izgled
Rauch	dim
Filter	filteri
inkorporiert	inkorporiran
Kunst	čamac
Gefährte	kolega
blind	slijep
Salon	salon
wütend	lud
Algorithmus	algoritam
stark	snažno
Cafe	kafić
ken	znanje
Proteine	proteini
su	Su
familiär	upoznat
fähig	sposoban
Eintritt	ulaz
Schuh	cipela
gewählt	izabran
Tragen	nošenje
Terrorismus	terorizam
Freude	radost
Ausgaben	izdanja
ethnisch	etnički
Parlament	parlament
Darsteller	glumac
Funde	nalazi
Dichtung	pečat
Situationen	situacije
fünfte	peti
Bürger	građanin
vertikal	vertikala
Korrekturen	ispravke
beschreibt	opisuje
Behinderungen	invaliditetom
Substanz	supstanca
verboten	zabranjen
Rohr	cijev
Soldaten	vojnici
Wächter	čuvar
Vorlesung	predavanje
Simulation	simuliranje
Layout	raspored
Initiativen	inicijative
krank	bolestan
Konzentration	koncentracija
legen	položiti
Deutung	tumačenje
dreckig	prljav
unterrichtet	učio
Arbeitnehmer	radnik
Optimierung	optimizacija
Tempel	hram
Substanzen	tvari
beweisen	dokazati
entdeckt	otkriven
Flügel	krila
genetisch	genetski
Beschränkungen	ograničenja
dünn	tanak
Ausstellung	izložba
Grat	greben
Modem	modem
bringen	donošenje
krank	bolestan
bewerten	procijeniti
tropisch	tropski
sammeln	prikupiti
Vektor	vektor
bestimmt	definitivno
Drehung	tokarenje
Existenz	postojanje
Kommentar	komentar
Entwicklungen	razvoj
Einwanderung	imigracija
Reiseziele	destinacije
gegenseitig	zajednički
Syntax	sintaksa
li	li
Attribut	atribut
Gefängnis	zatvor
Fertigkeit	vještina
Stühle	stolice
Umgebung	okolni
Berge	planine
Popularität	popularnost
Anfrage	pitanje
geprüft	provjeren
Ausstellungsstück	izložak
werfen	bacanje
Trend	trend
Katzen	mačke
Wüste	pustinja
ya	ya
Koordinator	koordinator
Quecksilber	Merkur
Verbrennung	spaljivanje
Flucht	pobjeći
Empfänger	prijamnik
progressiv	progresivan
Boote	brodovi
Meisterschaft	prvenstvo
Arkade	arkada
unmöglich	nemoguće
erzählt	govori
offensichtlich	očigledan
Depression	depresija
Graph	grafikon
Abdeckung	pokrivati
Platin	platina
Beurteilung	osuda
Gespräche	razgovori
Einreichung	podnošenje
fördern	gajiti
ausgezeichnet	nagrađen
Versuche	ispitivanja
Meister	majstori
Patrone	kaseta
Erläuterung	obrazloženje
org	org
Betrug	prevara
Elektrizität	elektricitet
Spektrum	spektar
Ankunft	dolazak
Keramik	posuđe
Betonung	isticanje
genial	super
Bestätigt	potvrđen
zählt	broji
Absturz	sudar
Aufzug	lift
inter	između
Höhen	visine
Schatten	sjena
Ausgabe	trošak
wagen	pothvat
Klinik	Klinika
Heilung	liječenje
Prinzessin	princeza
Eingeben	ulazak
Paket	paket
Studios	studio
Beteiligung	učešće
Papa	tata
Tasten	tipke
Platzierung	plasman
Beobachtungen	zapažanja
Gewinner	pobjednici
Straßen	ceste
anschließend	sljedeći
Garten	dvorište
Bekanntgabe	otkriće
Einrichtung	osnivanje
Erinnerungen	sjećanja
te	TE
schafft	stvara
Gesichter	lica
Tourist	turist
Mord	ubiti
angemessene	adekvatan
Senator	senator
Präsentationen	prezentacije
verdauen	probaviti
Staub	prah
Wiki	wiki
ersetzt	zamijeniti
Radar	radar
Verluste	gubici
Kampf	borba
Reduzierung	smanjivanje
gestoppt	prestao
Besetzung	okupacija
eng	tijesno
Strahlung	radijacija
Könige	kraljevi
Schießen	pucanje
Ohr	uho
Flaggen	zastave
Bäcker	pekar
konservativ	konzervativan
Schock	šok
Wirksamkeit	efikasnost
Krawatte	kravata
Dach	krov
zeigen	pokazati
Atmosphäre	atmosfera
Kuss	poljubac
Tier	zvijer
ra	ra
betrieben	operiran
Experiment	eksperiment
Ziele	ciljevi
Einkäufe	kupi
Föderation	federacija
Pizza	pizza
eingeladen	pozvan
Zuordnung	zadatak
modern	modni
Abfragen	upita
Abwesenheit	odsutnost
Anbieter	dobavljači
Yoga	joga
dient	služi
Überraschung	iznenađenje
Lampe	svjetiljka
Witze	vicevi
Beratung	savjetovanje
Palast	palača
zufrieden	zadovoljan
Gewinnt	pobjeda
Warenhaus	skladište
soll	trebala
gewöhnliche	običan
Geist	duh
Verstoß	povreda
Boss	šef
Stolz	ponos
Erwartungen	očekivanja
Unabhängigkeit	nezavisnost
wissend	poznavanje
Reporter	reporter
Stoffwechsel	metabolizam
Champion	prvak
persönlich	lično
reichlich	mnogo
Solo	solo
Kehle	grlo
Reichtum	bogatstvo
Vakuum	vakuum
Tanzen	ples
erkenne	prepoznati
schreibt	piše
Piazza	trg
Suche	traganje
veröffentlichen	objaviti
Abschirmung	probir
trans	trans
Pionier	pionir
Vergessene	zaboravljen
Akrobat	akrobata
Platten	ploče
Aufsätze	eseji
Verhalten	ponašanje
erzählen	reći
ziemlich	pošteno
intelligent	inteligentan
Modi	načini
Verpflichtung	obaveza
Hafen	luka
Reisende	putnik
Segment	segment
Feind	neprijatelj
Puzzle	puzzle
Brunnen	bunara
beschränkt	ograničen
Republikaner	republikanac
Geheimnisse	tajne
Syndrom	sindrom
Teilnahme	pohađanje
Elfmeter	kazna
Trommel	bubanj
ermöglicht	omogućuje
Baumeister	graditelj
Aussicht	vidik
Flut	poplava
Leichtigkeit	olakšati
Argumente	argumenti
Arena	arena
Abenteuer	avanture
Schüler	zjenice
Ankündigung	Obavijest
Ergebnis	ishod
schätzen	cijeniti
ergänzt	proširen
gewachsen	odrastao
schön	lijep
Zentren	centri
Klausel	klauzula
Lächeln	osmijeh
Länder	zemljišta
Truppen	trupe
bewaffnet	naoružan
Kiefer	bor
Kühlung	hlađenje
Golf	zaljev
LKW	kamioni
Mechanismen	mehanizmi
Scheidung	razvod
Tradition	tradicija
Pillen	tablete
Tiger	tigar
Leute	ljudi
Sensor	senzor
ausgesetzt	izložen
Jagd	lov
Engel	anđeli
Stellvertreter	zamjenik
thailändisch	thai
Emissionen	emisija
Ärzte	liječnici
Beschwerde	prigovor
Szenen	scene
Experimente	pokusi
Auftrieb	pojačati
Führung	vladavina
Mühle	mlin
Gegründet	osnovan
chronisch	kroničan
Höhle	jazbina
Finger	prst
hält	drži
Pfund	funta
Lokalisieren	pronaći
pl	pl
trainiert	obučen
Umsetzung	provođenje
Brot	kruh
Motoren	motori
zäh	tvrd
Vorfall	incident
Dynamik	dinamika
Lüge	laž
Konversation	razgovor
verringern	smanjenje
Anbetung	obožavanje
Fähigkeit	sposobnost
ak	ak
Präzision	preciznost
Schadenersatz	štete
Reserve	rezerve
lösen	riješiti
Minderheit	manjina
vielfältig	drugačiji
Zutaten	Sastojci
Ah	Ah
Töne	tonovi
Rehabilitation	rehabilitacija
Sicht	vid
Lehm	glina
schwach	slab
geteilt	podijeljen
Rezeption	recepcija
weise	mudar
Chancen	izgledi
Seminare	seminari
Folgen	posljedice
Entscheidungsträger	odluka
Erdkunde	geografija
Integrität	integritet
Erbe	nasljedstvo
zufrieden	zadovoljan
Achtung	opasnost
Vitamin	vitamin
verarbeitet	obrađen
Phrase	fraza
erziehen	podizanje
Auswirkungen	implikacije
Funktionalität	funkcionalnost
Paradies	raj
hybrid	hibrid
liest	čita
emotional	emotivan
Ruhm	slava
ja	ja
geographisch	geografski
überschreiten	prekoračiti
Stange	štap
Seide	svila
Babys	bebe
Bi	dvo
romantisch	romantičan
aufgedeckt	objavi
Spezialisten	stručnjaci
Generator	generator
Suspension	suspenzija
traurig	tužan
Korrektur	korekcija
Wolf	vuk
langsam	polako
Ergänzung	dopuniti
Teile	dijelovi
Säugling	dječji
Branchen	sektori
Flüssigkeit	tekućina
Begründung	teren
Mahlzeit	obrok
ta	tA
Maschinen	strojevi
Gleichung	jednadžba
Körbe	košare
Wahrscheinlichkeit	vjerojatnost
Abmessungen	dimenzija
studierte	studirao
Gewinne	dobit
Teufel	vrag
Gras	trava
illustriert	ilustrirano
Kirsche	trešnja
kontinental	kontinentalni
Leistung	dostignuće
Einschränkungen	ograničenja
Beerdigung	pogreb
Kapitel	poglavlja
Passagier	putnik
praktisch	zgodan
Mars	Mars
Größe	veličine
Ei	jaje
Signale	signali
Orientierung	orijentacija
Diebstahl	krađa
Kindheit	djetinjstvo
Symbole	simboli
lat	lat
Meta	meta
Analog	analog
Talent	talenat
datiert	datiran
Weisheit	mudrost
Grenze	granica
Elite	elita
gi	vojnik
glaubt	vjeruje
Gedichte	pjesme
Zuständigkeit	nadležnost
Roboter	robot
Anzeige	prikazivanje
Zeuge	svjedok
ausgestattet	opremljen
Stufen	faze
sur	sur
erworben	stečena
beurteilen	procijeniti
waschen	pranje
Eingang	ulaz
Erklärung	izjava
verlieren	gubljenje
Versuche	pokušaji
edel	plemenite
Automatisierung	automatizacija
Auswirkungen	utjecaji
Umdrehung	revolucija
Vorteile	prednosti
Ritter	vitez
Ziele	ciljevi
Erweiterungen	ekstenzije
Einsprüche	žalbe
Krankheit	bolest
ho	Ho
Alternativen	alternative
Sch	sh
Seife	sapun
Marmelade	pekmez
ungewöhnlich	neuobičajen
antwortete	odgovorio
Zerstörung	razaranje
Migration	migracija
Störung	poremećaj
konventionell	konvencionalne
tragen	nošenje
Achse	os
gesucht	traži
Gene	geni
Median	srednja
Scanner	skener
hierin	ovdje
lebhaft	animirani
Einstellung	podešavanje
Held	junak
Behandlungen	tretmani
Haltung	stav
Teppich	tepih
Linsen	leće
besucht	prisustvovao
Schwierigkeit	teškoća
Punk	punk
Koalition	koalicija
Einschreibung	upis
Herzog	vojvoda
Tempo	tempo
Produzenten	proizvođači
Bogen	luk
Schnittstellen	sučelja
Atlas	atlas
Überwachung	zapažanje
Folter	mučenje
gelöscht	izbrisana
Mantel	kaput
Wiederherstellung	obnova
Bequemlichkeit	pogodnost
Rückkehr	povratak
Opposition	opozicija
Container	kontejner
Beklagte	tuženik
Supervisor	nadglednik
Korps	korpus
Schauspieler	glumci
Leber	jetra
haftbar	odgovoran
Petition	peticija
Antenne	antena
gepflückt	izabran
Glauben	vjerovanje
Tötung	ubijanje
Schulter	rame
Dekor	dekor
Ion	ion
Durchmesser	promjer
Podcast	podcast
Wechselwirkungen	interakcije
Sänger	pjevač
Herold	glasnik
Altern	starenje
Intervention	intervencija
Plugin	uključiti
Attraktion	privlačnost
Tauchen	ronjenje
Änderung	modifikacija
annehmen	pretpostaviti
Schilf	trska
betreffen	obuhvatiti
mäßig	umjeren
Mäuse	miševi
verstanden	razumjeti
schnell	brzo
Verbot	zabrana
Sicherheit	uvjerenje
Ereignis	događa
weit	ogroman
Mühlen	mlinovi
Gliederung	obris
erhält	prima
Jeans	traperice
Zusammenstellung	kompilacija
ungerade	neparan
sigma	sigma
GR	gr
attraktiv	atraktivan
Gelegenheit	prilika
Aufnahmen	snimke
Opfer	žrtva
Forderungen	zahtjevi
Vorsichtig	pažljiv
Strahl	snop
Gartenarbeit	vrtlarstvo
Verbindlichkeiten	obveze
ankommen	stići
Orchester	orkestar
Lizenz	licenca
einstellbar	prilagodljiv
Zuweisung	namjena
Aufsatz	esej
gezeigt	pokazao
Dialog	dijalog
Lager	kampovi
erklärt	proglašen
Spur	trag
geschlossen	zatvoriti
Packungen	omot
