von	de
zu	à
im	dans
zum	pour
ist	est
auf	sur
Das	cette
durch	par
Dies	ce
mit	avec
ich	je
Sie	toi
es	il
oder	ou
Sein	être
sind	sont
beim	à
alle	tout
haben	avoir
Neu	Nouveau
wir	nous
werden	volonté
Zuhause	maison
uns	nous
Über	sur
ob	si
Seite	page
meine	mon
hat	a
Suche	chercher
frei	gratuit
aber	mais
unser	notre
ein	un
andere	autre
machen	faire
Information	information
Zeit	temps
er	il
welche	lequel
ihr	leur
Nachrichten	nouvelles
benutzen	utilisation
Dort	Là
sehen	voir
damit	alors
Wer	qui
Netz	toile
ebenfalls	aussi
bekommen	obtenir
pm	pm
Aussicht	vue
c	c
e	e
zuerst	premier
gewesen	été
würde	aurait
wurden	étaient
s	s
mögen	comme
x	X
als	que
finden	trouver
Preis	prix
zurück	arrière
oben	Haut
Menschen	gens
hätten	avait
Liste	liste
Name	prénom
gerade	juste
Jahr	an
Tag	journée
in	dans
zwei	deux
Gesundheit	santé
n	n
Re	ré
benutzt	utilisé
gehen	aller
b	b
letzte	dernier
machen	faire
Sie	leur
sollte	devrait
Produkt	produit
System	système
Post	poster
ihr	sa
Stadt	ville
t	t
Politik	politique
Nummer	nombre
Unterstützung	soutien
Botschaft	message
nach	après
dann	puis
Januar	jan
gut	bien
d	ré
woher	où
Info	Info
Rechte	droits
Bücher	livres
hoch	haute
Schule	école
m	m
jeder	chaque
Links	liens
sie	elle
Jahre	années
Auftrag	commande
sehr	très
Buch	livre
Artikel	articles
Unternehmen	compagnie
r	r
lesen	lis
Gruppe	groupe
Sex	sexe
viele	beaucoup
Benutzer	utilisateur
de	de
einstellen	ensemble
Allgemeines	général
Forschung	recherche
Universität	Université
Januar	janvier
Post	courrier
voll	plein
Bewertungen	avis
Programm	programme
kennt	connaître
Spiele	Jeux
Weg	façon
Tage	journées
p	p
Teil	partie
könnte	pourrait
groß	génial
vereinigt	uni
echt	réal
f	F
International	international
Center	centre
Reise	Voyage
Bemerkungen	commentaires
gemacht	fabriqué
Entwicklung	développement
Bericht	rapport
Mitglied	membre
Einzelheiten	détails
Linie	ligne
Bedingungen	termes
Vor	avant
Hotels	hôtels
tat	fait
senden	envoyer
Recht	droite
Art	type
lokal	local
jene	ceux
Ergebnisse	résultats
Büro	Bureau
National	nationale
Auto	voiture
Design	conception
nehmen	prendre
Gesendet	posté
Adresse	adresse
Gemeinschaft	communauté
innerhalb	dans
Zustände	États
wollen	vouloir
Telefon	téléphone
DVD	DVD
Gegenstand	assujettir
zwischen	entre
Forum	forum
Familie	famille
l	l
lange	longue
w	w
Show	montrer
O	o
sogar	même
schwarz	noir
Besondere	spécial
Index	indice
Sein	étant
Frau	femmes
viel	beaucoup
Schild	signe
Datei	fichier
Verknüpfung	lien
öffnen	ouvrir
Süd	Sud
Fall	Cas
Projekt	projet
Seiten	pages
Ausführung	version
Sektion	section
besitzen	posséder
Haus	maison
Sicherheit	Sécurité
G	g
Bezirk	comté
amerikanisch	américain
Foto	photo
Spiel	Jeu
Mitglieder	membres
Leistung	Puissance
Netzwerk	réseau
Computer	ordinateur
Systeme	systèmes
drei	Trois
Ort	endroit
Ende	fin
h	h
ihm	lui
pro	par
Zugriff	accès
denken	pense
Norden	Nord
Ressourcen	Ressources
Strom	actuel
groß	gros
Medien	médias
Recht	loi
Steuerung	contrôle
Wasser	eau
Geschichte	histoire
Größe	Taille
persönlich	personnel
führen	guider
Geschäft	boutique
Verzeichnis	annuaire
Veränderung	changement
Weiß	blanc
Text	texte
klein	petit
Wertung	évaluation
Bewertung	taux
Regierung	gouvernement
Kinder	enfants
Rückkehr	revenir
Studenten	élèves
v	v
Konto	Compte
mal	fois
Niveau	niveau
Digital	numérique
Profil	profil
Bisherige	précédent
bilden	forme
Veranstaltungen	événements
Liebe	amour
alt	vieux
John	John
Main	principale
Anruf	appel
Bild	image
Abteilung	département
Titel	Titre
nicht	non
k	k
y	y
Versicherung	Assurance
soll	doit
Eigentum	propriété
Klasse	classe
CD	CD
Qualität	qualité
jeden	chaque
Auflistung	inscription
Inhalt	contenu
Land	pays
wenig	peu
Werkzeuge	outils
niedrig	faible
Antworten	répondre
Kunde	client
Dezember	décembre
vergleichen	comparer
Filme	films
Hochschule	Université
Wert	valeur
Artikel	article
Mann	homme
Arbeitsplätze	emplois
j	j
Lebensmittel	aliments
Autor	auteur
anders	différent
u	u
lernen	apprendre
Verkauf	vente
drucken	impression
Kurs	cours
Job	emploi
Zimmer	chambre
Stock	Stock
Ausbildung	entraînement
auch	aussi
Kredit	crédit
Punkt	point
Wissenschaft	science
Männer	Hommes
Kategorien	catégories
Westen	Ouest
aussehen	Regardez
Englisch	Anglais
Mannschaft	équipe
Gut	biens
Box	boîte
Bedingungen	conditions
Fotos	Photos
Fröhlich	gai
Faden	fil
Kategorie	Catégorie
Hinweis	Remarque
Leben	vivre
groß	grand
Galerie	Galerie
Tabelle	table
jedoch	toutefois
Juni	juin
Oktober	octobre
November	novembre
Markt	marché
Bibliothek	bibliothèque
Aktion	action
Anfang	début
Serie	séries
Eigenschaften	fonctionnalités
Luft	air
Industrie	industrie
planen	plan
Mensch	Humain
Ja	Oui
zweite	seconde
heiß	chaud
Kosten	Coût
Film	film
Foren	forums
März	Mars
la	la
September	septembre
sagen	dire
gehen	Aller
medizinisch	médical
Freund	ami
Dezember	déc
Server	serveur
Anwendung	application
Mitarbeiter	Personnel
abspielen	jouer
Probleme	problèmes
April	avril
Benutzer	utilisateurs
Straße	rue
Thema	sujet
gegen	contre
bekam	eu
Blog	Blog
Party	fête
Zahlung	Paiement
Ausrüstung	équipement
Lassen	laisser
Programme	programmes
legal	légal
kürzlich	récent
Park	parc
Handlung	acte
Problem	problème
rot	rouge
geben	donner
Erinnerung	Mémoire
Performance	performance
Sozial	social
q	q
Geschichte	récit
verkaufen	vendre
Optionen	Options
Erfahrung	expérience
Schlüssel	clé
Karosserie	corps
jung	Jeune
wichtig	important
Feld	champ
wenige	peu
Osten	est
Single	unique
ii	ii
Alter	âge
Verein	club
Beispiel	Exemple
Mädchen	filles
z	z
Straße	route
Geschenk	cadeau
Frage	question
ca	Californie
hart	difficile
Zahlen	Payer
vier	quatre
Poker	poker
Problem	problème
Angebot	gamme
Gebäude	bâtiment
Verkäufer	vendeur
Gericht	tribunal
Februar	février
Ergebnis	résultat
Licht	lumière
schreiben	écrire
Krieg	guerre
Angebot	offre
Blau	bleu
Gruppen	groupes
al	Al
einfach	facile
gegeben	donné
anfordern	demande
Fax	fax
China	Chine
Herstellung	fabrication
Bild	image
Bedürfnisse	Besoins
möglich	possible
Monat	mois
Haupt	Majeur
Star	étoile
Zukunft	avenir
Raum	espace
Ausschuss	Comité
Hand	main
Sonne	Soleil
Karten	cartes
London	Londres
Treffen	réunion
werden	devenir
Kind	enfant
behalten	garder
Porno	porno
Aktie	partager
ähnlich	similaire
Garten	jardin
Schulen	écoles
Million	million
hinzugefügt	ajoutée
Referenz	référence
Firmen	entreprises
Baby	bébé
Lernen	apprentissage
Energie	énergie
Lauf	courir
Lieferung	livraison
Beliebt	populaire
Begriff	terme
Film	film
Geschichten	histoires
stellen	mettre
Tagebuch	journal
Berichte	rapports
co	co
Versuchen	essayer
Bilder	images
beachten	remarquer
Gott	Dieu
Original	original
Kopf	tête
Radio	radio
Zelle	cellule
Rat	conseil
enthält	comprend
Spur	Piste
Diskussion	discussion
Archiv	archiver
Andere	autres
Zustimmung	accord
Format	format
Gesellschaft	société
Monate	mois
Sicherheit	sécurité
Freunde	copains
sicher	sûr
Auflage	édition
Mitteilungen	messages
Marketing	commercialisation
sagen	dire
Verband	association
bietet	fournit
Spaß	amusement
bereits	déjà
Grün	vert
Studien	études
schließen	Fermer
verbreitet	commun
Spezifisch	spécifique
mehrere	nombreuses
Leben	vivant
Sammlung	collection
namens	appelé
kurz	court
Kunst	lettres
Menge	lot
Fragen	demander
begrenzt	limité
Lösungen	solutions
Direktor	réalisateur
Strand	plage
Vergangenheit	passé
natürlich	Naturel
Elektronik	électronique
auf	sur
Zeitraum	période
Planung	Planification
sagt	dit
offiziell	officiel
beschädigen	mar
erledigt	terminé
technisch	technique
Fenster	fenêtre
Profi	pro
Region	Région
Insel	île
Aufzeichnung	record
Direkte	direct
Konferenz	conférence
Aufzeichnungen	archives
st	st
Kreis	district
Kalender	calendrier
Kosten	frais
Stil	style
Erklärung	déclaration
Meilen	miles
Ressource	Ressource
Anwendungen	applications
Dokument	document
Wort	mot
Werk	travaux
Material	Matériel
Rechnung	facture
geschrieben	écrit
Regeln	règles
Finale	final
Ding	chose
Center	centre
Anforderungen	exigences
WAHR	VRAI
Protokoll	minutes
sonst	autre
Kennzeichen	marque
Rock	Roche
Schlecht	mal
Individuell	individuel
Plus	plus
Auto	auto
Abdeckung	couverture
bearbeiten	modifier
zusammen	ensemble
Videos	vidéos
schnell	vite
Funktion	fonction
Tatsache	fait
bekommen	obtention
global	global
Technik	technologie
Treffen	rencontrer
weit	loin
wirtschaftlich	économique
en	en
Spieler	joueur
Projekte	projets
Menge	montant
Uhr	regarder
inbegriffen	inclus
Gefühl	ressentir
Bank	banque
Risiko	risque
Angebote	offres
verschiedene	divers
Wörter	mots
Produktion	production
kommerziell	commercial
Gewicht	poids
Herz	cœur
Behandlung	traitement
Punkte	points
Wissen	connaissance
Zeitschrift	magazine
Error	Erreur
Kamera	caméra
Mädchen	fille
Konstruktion	construction
Spielzeuge	jouets
Eingetragen	inscrit
Domain	domaine
Methoden	méthodes
Kapitel	chapitre
Schutz	protection
Politik	politiques
breit	large
Schönheit	beauté
Manager	directeur
Indien	Inde
Position	position
genommen	pris
Sortieren	Trier
Inserate	annonces
bekannt	connu
Hälfte	moitié
Fälle	cas
Schritt	étape
Ingenieurwesen	ingénierie
einfach	simple
schnell	rapide
Lizenz	Licence
See	Lac
ganze	entier
jährlich	annuel
veröffentlicht	publié
Kirche	église
Methode	méthode
aktiv	actif
Antwort	réponse
Zahl	figure
Materialien	matériaux
genug	assez
entworfen	conçu
unter	parmi
Tod	décès
Verlust	perte
Gesicht	visage
Marke	marque
Rabatt	remise
Auswirkungen	effets
erstellt	créé
Normen	normes
Bit	bit
politisch	politique
Königreich	Royaume
Base	base
tun	Faire
Darlehen	prêts
Schuhe	chaussures
Eintrag	entrée
bleibe	rester
Aufträge	ordres
Verfügbarkeit	disponibilité
Zusammenfassung	résumé
Wende	tour
Wachstum	croissance
Agentur	agence
König	Roi
europäisch	européen
Aktivität	activité
Kopieren	copie
Western	occidental
Macht	Obliger
Beschäftigung	emploi
Bucht	baie
Fluss	rivière
Kommission	commission
Paket	paquet
gesehen	vu
Spieler	joueurs
Motor	moteur
Hafen	Port
Album	album
regional	régional
halt	Arrêtez
gestartet	commencé
Verwaltung	administration
Bar	bar
Institut	institut
Ansichten	vues
doppelt	double
Hund	chien
bald	bientôt
Linien	lignes
elektronisch	électronique
Leistungen	avantages
erforderlich	nécessaire
Drucker	imprimante
Bedingung	condition
Wirksam	efficace
glauben	croyez
Organisation	organisation
bewirken	effet
Verstand	esprit
Auswahl	sélection
Kasino	casino
pdf	pdf
Tour	tour
Kreuz	traverser
Hoffnung	espérer
Konzern	société
Wunsch	souhait
Lösung	Solution
reifen	mature
Rolle	rôle
Wochen	semaines
sicher	certain
niedriger	inférieur
notwendig	nécessaire
Union	syndicat
mon	lun
com	com
besonders	particulier
fein	bien
Stunde	heure
Gas	gaz
Kompetenzen	compétences
sechs	six
Buchse	buisson
Inseln	îles
Rat	Conseil
Werdegang	carrière
Entscheidung	décision
verlassen	laisser
Vor	pré
enorm	énorme
Frau	femme
Anlagen	installations
bieten	offre
Mitte	milieu
Kabel	câble
Chancen	Opportunités
Einnahme	prise
Werte	valeurs
Aufteilung	division
Kommen	arrivant
Objekt	objet
lesbisch	lesbienne
angemessen	approprié
Maschine	machine
Logo	logo
Länge	longueur
nett	agréable
Ergebnis	But
Statistiken	statistiques
Klient	client
Probe	échantillon
Investition	investissement
geschickt	envoyé
gezeigt	montré
Weihnachten	Noël
Kultur	Culture
Blitz	flash
Frau	Mme
Wahl	choix
Kurse	cours
Verbraucher	consommateur
Hallo	salut
fremd	étranger
Künstler	artiste
Möbel	meubles
Kanal	canal
Brief	lettre
Modus	mode
Telefone	Téléphones
Ideen	idées
Struktur	structure
Grad	degré
Vertrag	Contrat
Super	super
männlich	mâle
Angelegenheit	matière
fast	presque
gelegen	situé
mehrere	plusieurs
Verteilung	Distribution
Editor	éditeur
Gasthaus	auberge
industriell	industriel
Potenzial	potentiel
Lied	chanson
los	los
fallen	tomber
Idee	idée
Räume	pièces
Kommunikations	communications
Sieg	gagner
primär	primaire
Krebs	cancer
Zahlen	Nombres
Grund	raison
Werkzeug	outil
Frühling	printemps
Stiftung	fondation
Antworten	répondre
Stimme	voix
Zeitplan	programme
Unterlagen	documents
Zweck	objectif
Feature	fonctionnalité
Bett	lit
kommt	vient
Polizei	police
unabhängig	indépendant
Ansatz	approche
braun	marron
physikalisch	physique
Hügel	colline
Karten	Plans
halt	tenir
Bewertungen	évaluations
glücklich	content
Schmied	forgeron
entwickelt	développé
danken	remercier
sicher	sûr
einzigartig	unique
Umfrage	enquête
vor	avant
Telefon	Téléphone
Sport	sport
bereit	prêt
Tier	animal
Quellen	sources
Population	population
pa	Pennsylvanie
regulär	ordinaire
sichern	garantir
Geschäftstätigkeit	opérations
einfach	simplement
Beweis	preuve
Bahnhof	gare
verstehen	comprendre
Möglichkeit	option
Tal	vallée
wahrscheinlich	Probablement
Meer	mer
Publikationen	publications
verbessern	améliorer
Verbindung	connexion
Herausgeber	éditeur
Halle	salle
Anti	anti
Netzwerke	réseaux
Erde	Terre
Eltern	Parents
Auswirkung	impact
Transfer	transfert
Einführung	introduction
Küche	cuisine
stark	fort
Hochzeit	mariage
Eigenschaften	Propriétés
Krankenhaus	hôpital
Boden	sol
Schiff	navire
Unterkunft	hébergement
Krankheit	maladie
Ausgezeichnet	excellent
perfekt	parfait
Haar	cheveux
Gelegenheit	opportunité
Ausrüstung	trousse
klassisch	classique
Basis	base
Befehl	commander
Städte	villes
ausdrücken	Express
vergeben	prix
Entfernung	distance
Baum	arbre
Bewertung	évaluation
Mauer	mur
beteiligt	impliqué
el	el
extra	supplémentaire
insbesondere	notamment
Budget	budget
Führungen	guides
Erfolg	Succès
maximal	maximum
ma	mère
Betrieb	opération
bestehende	existant
ganz	assez
ausgewählt	choisi
Junge	garçon
Restaurants	Restaurants
schön	beau
Warnung	Attention
Standorte	Emplacements
Pferd	cheval
Abstimmung	vote
Blumen	fleurs
Sterne	étoiles
Listen	listes
Inhaber	propriétaire
Tiere	animaux
Wege	façons
Sohn	fils
Bereitstellen	fournir
Regel	règle
Gehäuse	logement
nimmt	prend
bringen	apporter
Katalog	catalogue
max	max
Mutter	mère
Behörde	autorité
erzählte	Raconté
Programm	programme
beigetreten	relié
Eingang	contribution
Strategie	stratégie
Füße	pieds
Agent	agent
gültig	valide
modern	moderne
Senior	Sénior
sexy	sexy
Lehren	enseignement
Tür	porte
großartig	grandiose
Versuch	procès
Einheiten	unités
cool	cool
normal	Ordinaire
Unternehmen	entreprise
Schiffe	navires
ganz	tout
positiv	positif
Fitness	aptitude
Chinesisch	chinois
Meinung	opinion
Fußball	Football
abstrakt	abstrait
Ausgabe	sortie
Mittel	fonds
Herr	M
wahrscheinlich	probable
entwickeln	développer
Künstler	artistes
Alternative	alternative
Verantwortung	responsabilité
Java	Java
Gast	client
Veröffentlichung	publication
bestehen	passer
Verhältnis	rapports
Vertrauen	confiance
Transporter	van
enthält	contient
Mehr	multi
Republik	république
Gebühren	honoraires
Komponenten	Composants
Ferien	vacances
Jahrhundert	siècle
akademisch	académique
Hilfe	assistance
abgeschlossen	terminé
Haut	peau
Grafik	graphique
indisch	Indien
Ring	bague
Klasse	qualité
Berg	Montagne
Organisationen	organisations
Filter	filtre
Platte	panneau
Fußboden	sol
Kauf	achat
Spiel	rencontre
vorgeschlagen	proposé
benötigen	exiger
Jungen	garçons
Morgen	Matin
erlaubt	permet
Eiweiß	protéine
Pflanze	plante
berichtet	signalé
schlagen	frappé
Millimeter	mm
Schwimmbad	bassin
Mini	mini
Politik	politique
Partner	partenaire
Autoren	auteurs
Bretter	planches
Fisch	poisson
Mitgliedschaft	adhésion
Mission	mission
Auge	œil
Schnur	chaîne
Sinn	sens
geändert	modifié
freigegeben	libéré
Bühne	étape
intern	interne
geboren	née
ausführlich	détaillé
japanisch	Japonais
Rennen	course
genehmigt	approuvé
Ziel	cible
außer	sauf
Charakter	personnage
Instandhaltung	entretien
Fähigkeit	aptitude
ed	ed
vergewaltigen	râpé
Batterie	batterie
Jugend	jeunesse
Druck	pression
eingereicht	soumis
Schuld	dette
Mittel	moyen
Fernsehen	télévision
interessiert	intéressé
Ader	coeur
Unterbrechung	Pause
Zwecke	fins
Sets	ensembles
tanzen	Danse
Holz	bois
definiert	défini
Papiere	papiers
Auszeichnungen	prix
Gebühr	frais
Studio	studio
Leser	lecteur
Gerät	dispositif
etabliert	établi
Antworten	réponses
Miete	location
las	Las
dunkel	foncé
extern	externe
Apfel	Pomme
le	le
Anleitung	instructions
Mindest	min
angeboten	offert
Theorie	théorie
Löschen	retirer
Hilfe	aide
visuell	visuel
Gastgeber	hôte
Vielfalt	variété
Lehrer	enseignants
Handbuch	Manuel
Block	bloc
Fächer	sujets
Mittel	agents
Reparatur	réparation
Messe	juste
stehlen	acier
Verstehen	compréhension
Lieder	Chansons
Fest	fixé
falsch	faux
Anfang	début
Hände	mains
az	az
Paris	Paris
wird	obtient
Sektor	secteur
Kapazität	capacité
un	ONU
Fett	graisse
Vater	père
elektrisch	électrique
sah	vu
Instrumente	instruments
Offizier	officier
Treiber	chauffeur
Unternehmen	entreprises
tot	mort
unbekannte	inconnu
Restaurant	restaurant
Mike	Mike
Ausflug	voyage
mi	mi
Arm	pauvre
Beziehung	relation
Arbeitskräfte	ouvriers
Frieden	paix
traditionell	traditionnel
zeigt	projection
kreativ	Créatif
Küste	côte
Vorteil	avantage
Finanzierung	financement
Geräte	dispositifs
Herr	Seigneur
gewähren	subvention
Unter	sous
Fiktion	fiction
Uhren	montres
Karriere	carrières
geht	va
LED	LED
Museum	musée
Ventilator	ventilateur
Transport	transport
interessant	intéressant
Blogs	blogs
Auswertung	évaluation
ehemalige	ancien
Zone	zone
Komplex	complexe
th	e
Katze	chat
sterben	mourir
vorgeführt	présenté
eben	appartement
fließen	couler
Agenturen	agences
Literatur	Littérature
Elternteil	parent
Rahmen	réglage
DR	dr
Rahmen	échelle
Wirtschaft	économie
hilfreich	utile
monatlich	mensuel
kritisch	critique
Rahmen	Cadre
Musical	musical
Definition	définition
Sekretär	secrétaire
Pfad	chemin
Chef	chef
gibt	donne
Pakete	paquets
Detail	détail
Gesetze	lois
geändert	modifié
Start	commencer
königlich	Royal
reinigen	nettoyer
Kerl	gars
Titel	titres
relevant	pertinent
Gerechtigkeit	Justice
verbinden	relier
Tasse	Coupe
Korb	panier
angewandt	appliqué
wöchentlich	hebdomadaire
vol	vol
Installation	installation
pp	pp
Beachtung	attention
vorrücken	avance
überspringen	sauter
Diät	régime
Armee	armée
Ausrüstung	équipement
Unterschied	différence
dürfen	permis
richtig	correct
Nation	nation
Verkauf	vente
viele	beaucoup
Stück	pièce
Blatt	drap
Feste	raffermir
Sieben	Sept
Elemente	éléments
Spezies	espèce
springen	saut
Zellen	cellules
Modul	module
Urlaubsort	recours
Zertifikat	certificat
Minister	ministre
Bewegung	mouvement
Mode	mode
Richtungen	directions
Besucher	visiteurs
Dokumentation	Documentation
Handel	commerce
Wald	forêt
Anrufe	appels
Berichterstattung	couverture
Paar	couple
Angabe	donnant
Chance	chance
Vision	vision
Ball	ballon
Ende	fin
Kunden	clients
Aktionen	actes
diskutieren	discuter
Tor	objectif
erfolgreich	réussi
verkauft	vendu
Wind	vent
Gemeinden	communautés
klinisch	clinique
Lage	situation
Märkte	marchés
Verlagswesen	édition
erscheinen	apparaître
Entwicklung	développement
Leben	vies
bestimmen	déterminer
Temperatur	Température
Ankündigungen	annonces
geduldig	patient
tatsächlich	réel
historisch	historique
Stein	pierre
Bob	bob
Handel	Commerce
Personen	personnes
schwer	difficile
wissenschaftlich	scientifique
Satellit	Satellite
Tests	essais
Dorf	village
Konten	comptes
Amateur	amateur
Ex	ex
getroffen	rencontré
Schmerzen	douleur
Faktoren	facteurs
Kaffee	café
Käufer	acheteur
Poster	affiche
Kante	bord
funktional	fonctionnel
Wurzel	racine
fi	Fi
geschlossen	fermé
Ferien	vacances
Rosa	rose
Balance	équilibre
Überwachung	surveillance
Antworten	réponses
Schuss	coup
Initiale	initiale
Etikette	étiquette
Sekunde	seconde
Kanon	canon
Liga	ligue
Abfall	déchets
Minute	minute
Bus	autobus
Anbieter	fournisseur
Wörterbuch	dictionnaire
Buchhaltung	comptabilité
Herstellung	fabrication
Abschnitte	sections
Stuhl	chaise
Anstrengung	effort
Phase	phase
Fantasie	fantaisie
po	po
va	Virginie
Professor	professeur
Installieren	installer
Hemd	chemise
Kleider	vêtements
Fuß	pied
Brust	Sein
Techniken	techniques
Dollar	dollars
Religion	religion
Genehmigung	autorisation
wild	sauvage
Generation	génération
Fräulein	manquer
chemisch	chimique
Arzt	docteur
Aufgabe	tâche
reduzieren	réduire
gebracht	apporté
Übung	exercice
Fehler	punaise
Garantie	garantie
Führer	chef
se	se
Prozesse	processus
weich	doux
Treffen	réunions
Sekunden	secondes
Flug	vol
Kongress	congrès
Treibstoff	carburant
gehen	marche
hergestellt	produit
Heilige	Saint
Streit	argument
Wettbewerb	compétition
Drogen	drogues
Joint	mixte
Prämie	prime
frisch	Frais
Figuren	personnages
Rechtsanwalt	avocat
di	di
Faktor	facteur
tausende	milliers
km	km
Strom	courant
Wohnungen	appartements
pflücken	choisir
Hören	audition
östlich	est
Therapie	thérapie
Einträge	entrées
unterzeichnet	signé
administrativ	administratif
ernst	sérieux
Grenze	limite
Schritte	pas
Geschäfte	magasins
Knechtschaft	esclavage
del	del
Anstrengungen	efforts
informiert	informé
ga	Géorgie
Gedanken	pensées
Bach	ruisseau
ft	ft
Menge	quantité
wesentlich	essentiel
Touren	Tours
Belastung	charge
sofort	immédiatement
Maschinen	Machines
vorgesehen	désigné
schwer	lourd
bedeckt	couvert
Wiederherstellung	récupération
integriert	intégré
Aufbau	configuration
Schwanz	coq
Händler	marchande
umfassend	complet
Experte	expert
schützen	protéger
solide	solide
Präsentation	présentation
wurde	devenu
Orange	Orange
Beachtung	conformité
Thema	thème
Reich	riches
Kampagne	campagne
vs	contre
Gitarre	guitare
finden	découverte
Beispiele	exemples
Geist	esprit
ar	ar
Ansprüche	réclamations
Annahme	acceptation
Strategien	stratégies
mo	mo
Angelegenheiten	affaires
beabsichtigt	prévu
sa	sa
Tore	buts
mieten	louer
Wahl	élection
vorschlagen	suggérer
Ast	branche
Dienen	servir
Mitgliedsorganisationen	affiliés
montieren	monter
Latein	Latin
Multimedia	multimédia
verwalten	gérer
Ecke	coin
Rang	rang
Element	élément
Geburt	naissance
Virus	virus
interaktiv	interactif
Anfragen	demandes
trennen	séparé
Quartal	trimestre
Verfahren	procédure
Führung	direction
definieren	définir
religiös	religieux
Fakten	faits
Frühstück	déjeuner
Säule	colonne
Glauben	Foi
Kette	chaîne
identifizieren	identifier
Avenue	rue
fehlt	disparu
Empfehlungen	recommandations
gerührt	déplacé
erreichen	atteindre
Vergleich	Comparaison
Moment	moment
verlängert	élargi
Sequenz	séquence
Zoll	pouce
Attacke	attaque
Zentren	centres
Öffnung	ouverture
Labor	laboratoire
Reservieren	réserve
Gamma	gamma
produzieren	produire
Wahrheit	vérité
Zähler	compteur
Fehler	échec
folgt	suit
Dollar	dollar
Lager	camp
die	des
Filme	films
Brücke	pont
füllen	remplir
Bewegung	mouvement
Drucken	impression
Entwurf	Brouillon
Diagramm	graphique
gespielt	joué
Kontakte	Contacts
Leser	lecteurs
Clubs	clubs
wa	Washington
Abenteuer	aventure
Opfer	offre
profitieren	profit
Führung	dirigeants
Poster	affiches
Institutionen	institutions
Assistent	assistant
Variable	variable
dj	dj
Parken	parking
gestern	hier
entschlossen	déterminé
Werkstatt	atelier
Weg	disparu
Codes	codes
Arten	types
Erweiterung	extension
Aussagen	déclarations
vollständig	complètement
Mannschaften	équipes
Fort	fort
cm	cm
Senat	sénat
komisch	drôle
Gen	gène
gedreht	tourné
Scheibe	disque
Muster	modèle
Boot	bateau
Theater	théâtre
Hersteller	fabricants
Sponsor	parrainer
klassisch	classique
Symbol	icône
Garantie	garantie
gewidmet	dévoué
Richtung	direction
Basketball	basketball
Objekte	objets
löschen	effacer
Abend	soir
Versammlung	Assemblée
nuklear	nucléaire
Maus	Souris
Signal	signal
Verbrecher	criminel
ausgegeben	Publié
mächtig	puissant
Traum	rêver
FALSCH	FAUX
da	da
Besetzung	jeter
Blume	fleur
Personal	personnel
bestanden	passé
geliefert	fourni
Stürze	chutes
Seele	âme
fördern	promouvoir
angegeben	déclaré
Statistiken	Statistiques
Profis	professionnels
erscheint	apparaît
tragen	porter
Flagge	drapeau
Abdeckungen	couvertures
em	em
Vorteil	avantage
Hallo	Bonjour
Design	dessins
pflegen	maintenir
Tourismus	tourisme
Priorität	priorité
Erwachsene	adultes
Grafik	graphique
Atom	atome
Zahlungen	Paiements
Bindung	contraignant
kurz	bref
beendet	terminé
gewinnt	gagnant
anonym	anonyme
Skript	scénario
serviert	servi
will	veut
bereit	préparé
Leere	vide
Etikett	marque
Interview	entretien
mischen	mélanger
Rahmen	cadre
Scheibe	disque
Eingerichtet	installée
Königin	reine
Kredite	crédits
deutlich	clairement
Fix	réparer
Griff	manipuler
Süss	doux
Kriterien	Critères
assoziieren	associer
ne	ne
Verhalten	comportement
vergrößern	agrandir
Strahl	rayon
Einnahmen	revenu
messen	mesure
Stimmen	votes
du	du
Pflicht	devoir
Diskussionen	discussions
Bär	ours
gewinnen	Gain
Festival	Festival
Labor	laboratoire
Ozean	océan
Flüge	vols
Fachwelt	experts
Zeichen	signes
Tiefe	profondeur
Zug	train
trocken	sec
erkunden	explorer
Spa	spa
Konzept	concept
fast	presque
Handhabung	manipulation
Ursprung	origine
Milliarde	milliard
Intelligenz	intelligence
gekauft	acheté
con	escroquerie
Nationen	nations
Route	route
gebrochen	cassé
Schlacht	bataille
sprechen	parler
Protokoll	protocole
Abfrage	question
Partnerschaft	Partenariat
Ausdruck	expression
es	es
Rede	discours
Draht	câble
Vorschläge	suggestions
Ersatz	remplacement
Band	ruban
strategisch	stratégique
Richter	juge
Acid	acide
Bytes	octets
Cent	cent
gezwungen	forcé
kompatibel	compatible
Wohnung	appartement
Null	nul
Null	zéro
Redner	orateur
Beratung	consultant
Konstrukteur	designer
pr	pr
Ehe	mariage
rollen	rouleau
Banken	banques
fr	fr
Teilnehmer	participants
Geheimnis	secret
Negativ	négatif
Favoriten	favoris
Theater	théâtre
Federung	ressorts
var	var
ausführen	effectuer
Übersetzung	Traduction
Schätzungen	estimations
Verletzung	blessure
Ministerium	ministère
Treiber	conducteurs
Anwalt	avocat
Figuren	chiffres
geschützt	protégé
Vorschlag	proposition
teilen	partage
Portal	portail
Beta	bêta
gratis	gratuitement
zu	vers
leicht	légèrement
helfen	aider
Verhalten	conduite
enthalten	contenu
Gesetzgebung	législation
Berufung	appel
Parameter	paramètres
Profile	profils
Angelegenheiten	questions
Häuser	Maisons
Steuerung	contrôles
kombiniert	combiné
letzte	ultime
Vertreter	représentant
geringer	mineur
Abteilungen	départements
Bewohner	résidents
angezeigt	affiché
Mama	maman
reduziert	réduit
Selten	rare
durchgeführt	réalisée
extrem	extrême
Proben	échantillons
Riegel	barres
Prognose	prévoir
entfernt	supprimé
Zyklus	cycle
enthalten	contenir
Richtigkeit	précision
Schlaf	dormir
mg	mg
Vogel	oiseau
Apotheke	pharmacie
Schaffung	création
statisch	statique
Jäger	chasseur
Adressen	adresses
Dame	Dame
Kristall	cristal
berühmt	célèbre
Schriftsteller	écrivain
Vorsitzende	président
Getränk	boisson
Akademie	académie
dynamisch	dynamique
Essen	manger
permanent	permanent
Reinigung	nettoyage
bildet	constitue
Mappe	portefeuille
praktisch	pratique
geliefert	livré
Infrastruktur	Infrastructure
Farbe	Couleur
Verkäufer	vendeur
Philosophie	philosophie
Verordnung	règlement
Offiziere	officiers
Ziel	objectif
Gebote	offres
Ernährung	nutrition
Aufzeichnung	enregistrement
Junior	junior
les	les
Kap	cap
Ringe	anneaux
Spitze	pointe
wunderbar	formidable
Fahrkarte	billet
angekündigt	annoncé
vermuten	deviner
wem	qui
Fußball	football
Mathematik	math
einführen	importer
Entsendung	affectation
Gegenwart	présence
automatisch	automatique
Besichtigung	visualisation
gepflegt	entretenu
CH	ch
Dan	dan
Hunde	chiens
Direktoren	directeurs
Aspekte	aspects
voraus	devant
Mond	lune
Beteiligung	participation
planen	schème
Fliege	mouche
Weise	manière
Matrix	matrice
Kombination	combinaison
Änderung	amendement
Stärke	force
Truthahn	dinde
Bibliotheken	bibliothèques
richtig	correct
Grad	degrés
Unternehmen	entreprises
Delta	delta
Angst	peur
suche	recherche
Zoll	pouces
Konvention	convention
Anteile	actions
Schulleiter	principal
Komfort	confort
Farben	couleurs
Kriege	guerres
Bestellung	commande
gehalten	conservé
Alpha	alpha
Beschwerde	charme
Kreuzfahrt	croisière
Bonus	prime
Hallo	Hey
Gebäude	bâtiments
Angebote	promos
schlagen	battre
Batterien	batteries
wird	devient
fährt	disques
Waffen	bras
Tee	thé
verbessert	amélioré
leisten	atteindre
Positionen	positions
Kleid	robe
Abonnement	abonnement
Händler	Marchand
zeitgenössisch	contemporain
Himmel	ciel
Rom	ROM
getragen	porté
Exposition	exposition
verbergen	cacher
Unterschrift	Signature
Müller	meunier
Bereitstellung	disposition
Kleider	vêtements
Rahmen	cadres
bestimmt	certainement
Zeitung	journal
Spielzeug	jouet
Schicht	couche
gedruckt	imprimé
langsam	lent
Entfernung	suppression
Haftung	responsabilité
Drucker	imprimantes
Hinzufügen	ajouter
Stelle	place
verbringen	dépenser
Fabrik	usine
Innere	intérieur
wachsen	croître
optisch	optique
Beförderung	promotion
relativ	relatif
tolle	incroyable
Punkt	point
Identität	identité
Umwandlung	conversion
Gefühl	sentiment
versteckt	caché
angemessen	raisonnable
Revision	révision
beeinflussen	influence
Verhältnis	rapport
Bedeutung	importance
Regen	pluie
Planet	planète
Kopien	copies
erlauben	permis
Sehen	voyant
Beweis	preuve
Bass	basse
Rezept	ordonnance
leer	vide
Beispiel	exemple
Loch	trou
Reiten	balade
Büro	bureau
Erhaltung	préservation
Paar	paire
Ideal	idéal
Brille	spécification
verzeichnet	enregistré
Don	Don
Stücke	pièces
fertig	fini
Parks	parcs
Rechtsanwälte	avocats
Stress	stress
Sahne	crème
ss	ss
läuft	fonctionne
entdecken	découvrir
ap	ap
Muster	modèles
Hügel	collines
nm	nm
Berater	conseiller
bewusst	conscient
gestalten	forme
Evolution	évolution
Zertifikate	certificats
Ziele	objectifs
Stationen	stations
empfohlen	suggéré
op	op
Überreste	restes
Firmen	entreprises
Euro	euro
Operator	opérateur
Strukturen	structures
generisch	générique
Enzyklopädie	encyclopédie
Verwendung	usage
Tinte	encre
gemischt	mixte
Volkszählung	recensement
Rad	roue
Lieferanten	Fournisseurs
kompakt	compact
Poesie	poésie
Beleuchtung	lumières
Verfolgung	suivi
Engel	ange
Vorbereitung	préparation
Versuch	tentative
Empfang	recevoir
Streichhölzer	allumettes
Übereinstimmung	conformité
Breite	largeur
Motoren	moteurs
vergessen	oublier
Feld	tableau
diskutiert	discuté
genau	précis
Klima	climat
griechisch	grec
Anweisung	instruction
Verwaltung	gérant
roh	brut
Unterschiede	différences
erklären	Explique
Gründen	établir
ausgedrückt	exprimé
Umfang	ampleur
Scharf	tranchant
ben	ben
Absatz	paragraphe
töten	tuer
Mathematik	mathématiques
Vergütung	compensation
Export	exportation
Manager	gestionnaires
Module	modules
geführt	menée
Versionen	versions
weiß	sait
beschreiben	décrire
Bürger	citoyens
Erbe	patrimoine
Ärger	difficulté
Trainer	entraîneur
landwirtschaftlich	agricole
erweitern	développer
Publikum	public
zugewiesen	attribué
Sammlungen	collections
Ewigkeit	âge
Spezialist	spécialiste
Koch	cuisinier
beeinflussen	affecter
Jungfrau	vierge
erfahren	expérimenté
Ermittlung	enquête
angehoben	relevé
Hut	chapeau
Institution	institution
gerichtet	dirigée
betroffen	affecté
Fahrrad	bicyclette
total	totalement
Teller	assiette
Kosten	frais
zeigen	indiquer
blond	blond
Verfahren	procédure
Favorit	préféré
Eigenschaften	caractéristiques
der	der
verlieren	perdre
organisch	biologique
suchen	chercher
Erfahrungen	expériences
Alben	albums
Verträge	contrats
Gäste	invités
Gastgeber	hébergé
Krankheiten	maladies
über	concernant
äquivalent	équivalent
Chemie	chimie
Kits	kits
Logik	logique
Prinz	prince
Kreis	cercle
Boden	sol
Psychologie	psychologie
nass	humide
Umstände	conditions
Investor	investisseur
elementar	élémentaire
Sponsoren	sponsors
Fuchs	Renard
unbegrenzt	illimité
reagieren	répondre
Größen	tailles
einfach	plaine
Ausfahrt	Sortie
Arm	bras
Schlüssel	clés
Welle	vague
heilig	saint
Handlungen	actes
Beratung	orientation
Weg	Piste
Symbol	symbole
Autobahn	Autoroute
beobachtete	observé
Dean	doyen
Konfiguration	installer
Umfrage	sondage
Arten	modes
gefüllt	rempli
Bindung	liaison
Kanäle	filières
Blinddarm	annexe
Schokolade	Chocolat
Portion	portion
Umfang	portée
Lieferant	fournisseur
Kabel	câbles
Baumwolle	coton
Anforderung	exigence
getötet	tué
Rand	frontière
alt	ancien
Debatte	débat
Vertreter	représentants
beginnt	départs
Schwangerschaft	grossesse
Sehenswürdigkeiten	attractions
gelernt	appris
Transaktionen	transactions
Forscher	explorateur
historisch	historique
Mann	mari
autorisiert	autorisé
verrückt	fou
bevorstehende	prochain
Konzert	concert
Partituren	scores
Wirksamkeit	Efficacité
Komödie	comédie
angenommen	adopté
effizient	efficace
linear	linéaire
Engagement	engagement
Spezialität	spécialité
Bären	ours
hüpfen	saut
Träger	transporteur
Konstante	constant
Visa	visa
Mund	bouche
Meter	mètre
verbunden	lié
Interviews	interviews
Konzepte	concepts
Gewehr	pistolet
reflektieren	réfléchir
rein	pur
Hölle	enfer
Obst	fruit
beginnt	commence
qualifiziert	qualifié
Reform	réforme
Linse	lentille
behandelt	traités
Entdeckung	Découverte
zeichnen	dessiner
klassifiziert	classifié
annehmen	assumer
Allianz	Alliance
bestätigen	confirmer
Ingenieur	ingénieur
konsistent	cohérent
ersetzen	remplacer
Spielraum	dégagement
Konverter	convertisseur
Organisation	organisation
Baby	bébé
Schecks	chèques
erreicht	atteint
Werden	devenir
Zielsetzung	objectif
angezeigt	indiqué
Zucker	sucre
Crew	équipage
Beine	jambes
Stock	bâton
Beziehung	relation
aktiviert	activée
Genre	genre
Freiwillige	bénévole
Rückseite	arrière
demokratisch	démocratique
verbessern	améliorer
genau	exact
gebunden	lié
Parameter	paramètre
Prozessor	processeur
Knoten	nœud
formal	formel
Sturm	orage
Mikro	micro
Hochschulen	collèges
Meile	mile
Herausforderungen	défis
Redakteure	éditeurs
höchste	suprême
Brüder	frères
Anerkennung	reconnaissance
ref	ref
schätzen	estimation
Kind	enfant
Inspektion	inspection
Verbraucher	consommateurs
Grenzen	limites
Gebiet	territoire
Bewaffnung	armes
verzögern	retard
Pilot	pilote
Beiträge	contributions
kontinuierlich	continu
Initiative	initiative
Roman	roman
Ausführung	exécution
Behinderung	invalidité
Ultra	ultra
Gewinner	gagnant
Folge	épisode
Töpfer	potier
Gericht	plat
Theaterstücke	pièces
Bekanntmachung	bulletin
ia	ia
ändern	modifier
wirklich	vraiment
Universum	univers
Kandidat	candidat
Slot	fente
hervorragend	exceptionnel
Ha	Ha
geplant	prévu
Hütte	loge
Spiegel	miroir
Turnier	tournoi
Berücksichtigung	considération
Sitzungen	sessions
Kern	noyau
Käufer	acheteurs
Zeitschriften	revues
grau	gris
Katalog	catalogue
berechnet	accusé
breit	vaste
und	und
gewählt	choisi
Demo	demo
Hass	haine
Terminal	Terminal
Verlag	éditeurs
Nächte	nuits
Flüssigkeit	liquide
Reis	riz
Reservierung	réservation
Lebensmittel	nourriture
bewachen	garde
Einsparung	économie
Reich	Empire
neu	nouvellement
erziehen	élever
illegal	illégal
Erweiterung	expansion
Premier	premier
Morgen	demain
Milch	Lait
Theater	drame
Besuch	visite
Wettbewerb	concours
gesammelt	collectées
Bands	bandes
geeignet	adapté
absolut	absolument
Prüfung	vérification
Kammer	chambre
Guinea	Guinée
Ergebnisse	résultats
iso	iso
typisch	typique
Summe	somme
Hähnchen	poulet
vorübergehend	temporaire
besuchen	assister
Dusche	douche
Versendung	envoi
ausreichend	suffisant
Schale	coquille
Provinz	Province
katholisch	catholique
Gouverneur	gouverneur
Bier	Bière
Beitrag	contribution
Formel	formule
Verfassung	Constitution
Verpackung	emballage
zuverlässig	fiable
Zweifel	doute
verdienen	gagner
Perioden	périodes
Anschläge	attaques
Waren	marchandise
Symptome	symptômes
Denkmal	Mémorial
Zwilling	double
einfügen	insérer
Tor	passerelle
Zeichnung	dessin
Kandidaten	candidats
bestellt	commandé
biologisch	biologique
Kampf	combat
Übergang	transition
Vorlieben	préférences
Spion	espion
Romantik	romance
Instrument	instrument
Teilt	Divisé
Themen	thèmes
Befugnisse	pouvoirs
Himmel	paradis
Bits	morceaux
schwanger	Enceinte
Einstufung	classification
konzentriert	concentré
Arzt	médecin
fragen	demander
Blöcke	blocs
lo	lo
geistig	spirituel
Diabetes	Diabète
ml	ml
Verschiebung	décalage
sitzen	asseoir
Körper	corps
Fotos	photographies
Schneiden	Coupe
Schriftsteller	écrivains
flexibel	flexible
liebte	aimé
Favoriten	favoris
Kartierung	cartographie
zahlreich	nombreux
verhältnismäßig	relativement
repräsentiert	représente
überlegen	supérieur
bevorzugt	préféré
Gerettet	enregistré
intellektuelle	intellectuel
gewährt	accordé
Kohlenstoff	carbone
gemütlich	confortable
magnetisch	magnétique
Interaktion	interaction
Hören	écoute
Krise	crise
Ausblick	perspective
massiv	massif
hell	brillant
gebildet	formé
Klavier	piano
Echo	écho
Revolution	révolution
Displays	affiche
Plasma	plasma
Verdienste	gains
Geheimnis	mystère
Landschaft	paysage
mechanisch	mécanique
Reise	périple
Banner	bannière
Feige	figue
Grafschaften	comtés
Erwerb	acquisition
anerkannt	reconnu
Träume	rêves
Benachrichtigung	notification
kg	kg
lehren	apprendre
schnell	rapide
ziehen	tirer
ut	Utah
Seminar	séminaire
Investitionen	investissements
Räder	roues
angeben	spécifier
empfindlich	sensible
Vorlagen	modèles
Formate	formats
hält	détient
Router	routeur
Beton	béton
si	si
Mappe	dossier
Fertigstellung	achèvement
Impuls	impulsion
Technik	technique
Wählen	vote
Justiz	tribunaux
umgewandelt	converti
Metro	métro
Jahrestag	anniversaire
Verbesserungen	améliorations
Streifen	bande
Spezifikation	spécification
Unfall	accident
Kerbe	entaille
zugänglich	accessible
Bewohner	résident
Handlung	terrain
typisch	typiquement
Darstellung	représentation
Pumpe	pompe
existiert	existe
Vereinbarungen	arrangements
Konferenzen	conférences
Verbrauch	consommation
eng	étroit
Bedrohung	menace
Umfragen	enquêtes
Sitzung	séance
Berater	consultant
Regler	manette
Ausschüsse	comités
Penis	pénis
Schloss	Château
Gardens	jardins
Etiketten	Étiquettes
bereit	prêt
bio	bio
Schauspielkunst	agissant
Köpfe	têtes
Prüfung	examen
Residenz	résidence
Dichte	densité
hundert	cent
seltsam	étrange
nachhaltig	durable
statistisch	statistique
erwähnen	mention
Innovation	innovation
grau	gris
parallel	parallèle
arbeiten	fonctionner
Banknoten	factures
stabil	stable
Definitionen	définitions
von	von
Ärzte	médecins
Lektion	leçon
Kino	cinéma
Wahlen	élections
Reaktion	réaction
leer	blanc
verbessert	renforcée
berechtigt	intitulé
schwer	sévère
generieren	produire
Zeitungen	journaux
Krankenhäuser	hôpitaux
vi	vi
Humor	humour
alt	vieilli
Monitore	moniteurs
Ausnahme	exception
Dauer	durée
Masse	masse
Besuche	visites
Fähigkeiten	capacités
Empfehlung	recommandation
Sünde	péché
organisiert	organisé
ba	ba
para	para
Annahme	adoption
Verbesserung	améliorer
teuer	coûteux
Büffel	buffle
Organisationen	organisations
Ebene	avion
Programme	programmes
Mechanismus	mécanisme
ee	ee
markiert	marqué
Gefahren	poussé
Flasche	bouteille
innovativ	innovant
Massage	massage
Fazit	conclusion
Schließen	fermeture
tausend	mille
Legende	Légende
Villa	villa
Knochen	OS
Säulen	colonnes
Störungen	troubles
Zusammenarbeit	collaboration
Entdeckung	détection
innere	interne
Formation	formation
med	med
Ingenieure	ingénieurs
Entität	entité
Kreuzfahrten	Croisières
Tor	porte
römisch	romain
Aufgaben	fonctions
erotisch	érotique
Ton	Ton
Ethik	éthique
Drachen	dragon
beschäftigt	occupé
Kapitän	capitaine
bringt	apporte
Heizung	chauffage
Bein	jambe
Hals	cou
Flügel	aile
Skripte	scripts
ABC	abc
ernannt	nommé
Behandlung	transaction
verpflichten	commettre
Schiene	rail
Reisen	voyages
Spalt	écart
Seiten	côtés
Tube	tube
dazugehörigen	correspondant
Beschreibungen	descriptions
Gürtel	ceinture
Jacke	veste
Animation	animation
Orakel	oracle
er	er
Produktionen	productions
Luftfahrt	aviation
stolz	fier
Katastrophe	catastrophe
Konsole	console
Befehle	commandes
jr	jr
Telekommunikation	télécommunications
Lehrer	instructeur
Riese	géant
erreicht	réalisé
Verletzungen	blessures
Ansätze	approches
gewöhnlich	habituel
Briefmarken	timbres
Winkel	angle
rauben	Rob
Designer	concepteurs
Freiheit	liberté
Epoche	ère
Konvertieren	convertir
Möglichkeit	possibilité
Analytiker	analyste
gefährlich	dangereux
Zuverlässigkeit	fiabilité
beziehungsweise	respectivement
Freiwillige	bénévoles
abgeleiteten	dérivé
Vergnügen	plaisir
Ehre	honneur
orientiert	orienté
Adler	Aigle
Gebet	prière
Workshops	ateliers
Hurrikan	ouragan
ruhig	silencieux
Hersteller	producteur
repräsentiert	représentée
Verantwortlichkeiten	responsabilités
Käse	fromage
vorsichtig	soigneusement
Produktivität	productivité
Krone	couronne
Par	par
Diagnose	diagnostic
Hersteller	fabricant
Riss	fissure
Prinzip	principe
Picks	choix
Gang	gang
Fetisch	fétiche
Aussehen	apparence
Rauch	fumée
Filter	filtres
inkorporiert	incorporé
Kunst	artisanat
Gefährte	compagnon
blind	aveugle
Salon	salon
wütend	furieux
Algorithmus	algorithme
stark	fortement
Cafe	café
ken	ken
Proteine	protéines
su	su
familiär	familier
fähig	capable
Eintritt	admission
Schuh	chaussure
gewählt	élu
Tragen	portant
Terrorismus	terrorisme
Freude	joie
Ausgaben	éditions
ethnisch	ethnique
Parlament	parlement
Darsteller	acteur
Funde	découvertes
Dichtung	joint
Situationen	situations
fünfte	cinquième
Bürger	citoyen
vertikal	verticale
Korrekturen	corrections
beschreibt	décrit
Behinderungen	handicapées
Substanz	substance
verboten	interdit
Rohr	tuyau
Soldaten	soldats
Wächter	Gardien
Vorlesung	conférence
Simulation	simulation
Layout	disposition
Initiativen	initiatives
krank	mauvais
Konzentration	concentration
legen	allonger
Deutung	interprétation
dreckig	sale
unterrichtet	enseigné
Arbeitnehmer	ouvrier
Optimierung	optimisation
Tempel	temple
Substanzen	substances
beweisen	prouver
entdeckt	découvert
Flügel	ailes
genetisch	génétique
Beschränkungen	restrictions
dünn	mince
Ausstellung	exposition
Grat	crête
Modem	modem
bringen	apportant
krank	malade
bewerten	évaluer
tropisch	tropical
sammeln	collecte
Vektor	vecteur
bestimmt	absolument
Drehung	tournant
Existenz	existence
Kommentar	commentaire
Entwicklungen	développements
Einwanderung	immigration
Reiseziele	destinations
gegenseitig	mutuel
Syntax	syntaxe
li	li
Attribut	attribut
Gefängnis	prison
Fertigkeit	compétence
Stühle	chaises
Umgebung	alentours
Berge	montagnes
Popularität	popularité
Anfrage	enquête
geprüft	vérifié
Ausstellungsstück	exposition
werfen	jeter
Trend	tendance
Katzen	chats
Wüste	désert
ya	ya
Koordinator	coordinateur
Quecksilber	Mercure
Verbrennung	brûlant
Flucht	échapper
Empfänger	destinataire
progressiv	progressive
Boote	bateaux
Meisterschaft	championnat
Arkade	arcade
unmöglich	impossible
erzählt	dit
offensichtlich	évident
Depression	dépression
Graph	graphique
Abdeckung	couvrant
Platin	platine
Beurteilung	jugement
Gespräche	pourparlers
Einreichung	dépôt
fördern	favoriser
ausgezeichnet	décerné
Versuche	essais
Meister	maîtrise
Patrone	cartouche
Erläuterung	explication
org	org
Betrug	fraude
Elektrizität	électricité
Spektrum	spectre
Ankunft	arrivée
Keramik	poterie
Betonung	accentuation
genial	impressionnant
Bestätigt	confirmé
zählt	compte
Absturz	crash
Aufzug	ascenseur
inter	entre
Höhen	hauteurs
Schatten	ombre
Ausgabe	frais
wagen	entreprise
Klinik	clinique
Heilung	guérison
Prinzessin	Princesse
Eingeben	entrer
Paket	paquet
Studios	studios
Beteiligung	participation
Papa	papa
Tasten	boutons
Platzierung	placement
Beobachtungen	observations
Gewinner	gagnants
Straßen	routes
anschließend	subséquent
Garten	Cour
Bekanntgabe	divulgation
Einrichtung	établissement
Erinnerungen	souvenirs
te	te
schafft	crée
Gesichter	visages
Tourist	touristique
Mord	meurtre
angemessene	adéquat
Senator	sénateur
Präsentationen	présentations
verdauen	digérer
Staub	poussière
Wiki	wiki
ersetzt	remplacé
Radar	radar
Verluste	pertes
Kampf	combat
Reduzierung	réduire
gestoppt	arrêté
Besetzung	Occupation
eng	étroitement
Strahlung	radiation
Könige	rois
Schießen	tournage
Ohr	oreille
Flaggen	drapeaux
Bäcker	boulanger
konservativ	conservateur
Schock	choc
Wirksamkeit	efficacité
Krawatte	attacher
Dach	toit
zeigen	démontrer
Atmosphäre	atmosphère
Kuss	baiser
Tier	bête
ra	ra
betrieben	exploité
Experiment	expérience
Ziele	cibles
Einkäufe	achats
Föderation	fédération
Pizza	Pizza
eingeladen	invité
Zuordnung	affectation
modern	mod
Abfragen	requêtes
Abwesenheit	absence
Anbieter	vendeurs
Yoga	yoga
dient	sert
Überraschung	surprise
Lampe	lampe
Witze	blagues
Beratung	conseils
Palast	palais
zufrieden	satisfait
Gewinnt	victoires
Warenhaus	entrepôt
soll	supposé
gewöhnliche	ordinaire
Geist	fantôme
Verstoß	violation
Boss	patron
Stolz	fierté
Erwartungen	attentes
Unabhängigkeit	indépendance
wissend	connaissance
Reporter	journaliste
Stoffwechsel	métabolisme
Champion	champion
persönlich	personnellement
reichlich	beaucoup
Solo	solo
Kehle	gorge
Reichtum	richesse
Vakuum	vide
Tanzen	dansant
erkenne	reconnaître
schreibt	écrit
Piazza	place
Suche	quête
veröffentlichen	publier
Abschirmung	dépistage
trans	trans
Pionier	pionnier
Vergessene	oublié
Akrobat	acrobate
Platten	plaques
Aufsätze	essais
Verhalten	comportement
erzählen	récit
ziemlich	équitablement
intelligent	intelligent
Modi	modes
Verpflichtung	obligation
Hafen	port
Reisende	voyageur
Segment	segment
Feind	ennemi
Puzzle	puzzle
Brunnen	puits
beschränkt	limité
Republikaner	républicain
Geheimnisse	secrets
Syndrom	syndrome
Teilnahme	présence
Elfmeter	peine
Trommel	tambour
ermöglicht	permet
Baumeister	constructeur
Aussicht	vue
Flut	inonder
Leichtigkeit	facilité
Argumente	arguments
Arena	arène
Abenteuer	aventures
Schüler	élèves
Ankündigung	annonce
Ergebnis	résultat
schätzen	apprécier
ergänzt	étendu
gewachsen	mûr
schön	charmant
Zentren	centres
Klausel	clause
Lächeln	sourire
Länder	terres
Truppen	troupes
bewaffnet	armé
Kiefer	pin
Kühlung	refroidissement
Golf	golfe
LKW	camions
Mechanismen	mécanismes
Scheidung	divorce
Tradition	tradition
Pillen	pilules
Tiger	tigre
Leute	gens
Sensor	capteur
ausgesetzt	exposé
Jagd	chasse
Engel	anges
Stellvertreter	adjoint
thailändisch	thaïlandais
Emissionen	émissions
Ärzte	médecins
Beschwerde	plainte
Szenen	scènes
Experimente	expériences
Auftrieb	renforcer
Führung	gouvernance
Mühle	moulin
Gegründet	fondé
chronisch	chronique
Höhle	tanière
Finger	doigt
hält	garde
Pfund	livre
Lokalisieren	Localiser
pl	PL
trainiert	qualifié
Umsetzung	exécution
Brot	pain
Motoren	moteurs
zäh	dure
Vorfall	incident
Dynamik	dynamique
Lüge	mensonge
Konversation	conversation
verringern	diminution
Anbetung	culte
Fähigkeit	aptitude
ak	Alaska
Präzision	précision
Schadenersatz	dégâts
Reserve	réserves
lösen	résoudre
Minderheit	minorité
vielfältig	diverse
Zutaten	Ingrédients
Ah	ah
Töne	tons
Rehabilitation	réhabilitation
Sicht	vue
Lehm	argile
schwach	faible
geteilt	divisé
Rezeption	accueil
weise	sage
Chancen	chances
Seminare	séminaires
Folgen	conséquences
Entscheidungsträger	décideurs
Erdkunde	géographie
Integrität	intégrité
Erbe	héritage
zufrieden	heureux
Achtung	danger
Vitamin	vitamine
verarbeitet	traité
Phrase	phrase
erziehen	élevage
Auswirkungen	implications
Funktionalität	fonctionnalité
Paradies	paradis
hybrid	hybride
liest	lit
emotional	émotif
Ruhm	gloire
ja	ja
geographisch	géographique
überschreiten	dépasser
Stange	barre
Seide	soie
Babys	bébés
Bi	bi
romantisch	romantique
aufgedeckt	révélé
Spezialisten	spécialistes
Generator	Générateur
Suspension	suspension
traurig	triste
Korrektur	correction
Wolf	Loup
langsam	lentement
Ergänzung	supplément
Teile	portions
Säugling	bébé
Branchen	secteurs
Flüssigkeit	fluide
Begründung	terrains
Mahlzeit	repas
ta	ta
Maschinen	machinerie
Gleichung	équation
Körbe	paniers
Wahrscheinlichkeit	probabilité
Abmessungen	dimension
studierte	étudié
Gewinne	bénéfices
Teufel	diable
Gras	herbe
illustriert	illustré
Kirsche	Cerise
kontinental	continental
Leistung	réussite
Einschränkungen	limites
Beerdigung	funérailles
Kapitel	chapitres
Passagier	passager
praktisch	pratique
Mars	Mars
Größe	taille
Ei	Oeuf
Signale	signaux
Orientierung	orientation
Diebstahl	vol
Kindheit	enfance
Symbole	symboles
lat	lat
Meta	méta
Analog	analogique
Talent	Talent
datiert	daté
Weisheit	sagesse
Grenze	frontière
Elite	élite
gi	gi
glaubt	croit
Gedichte	poèmes
Zuständigkeit	juridiction
Roboter	robot
Anzeige	visualisation
Zeuge	témoin
ausgestattet	équipé
Stufen	étapes
sur	sur
erworben	acquis
beurteilen	évaluer
waschen	lavage
Eingang	entrée
Erklärung	déclaration
verlieren	perdant
Versuche	tentatives
edel	noble
Automatisierung	automatisation
Auswirkungen	impacts
Umdrehung	tour
Vorteile	avantages
Ritter	Chevalier
Ziele	objectifs
Erweiterungen	extensions
Einsprüche	appels
Krankheit	maladie
ho	ho
Alternativen	alternatives
Sch	sh
Seife	savon
Marmelade	confiture
ungewöhnlich	inhabituel
antwortete	répondu
Zerstörung	destruction
Migration	migration
Störung	désordre
konventionell	conventionnel
tragen	portant
Achse	axe
gesucht	recherché
Gene	gènes
Median	médian
Scanner	scanner
hierin	ici
lebhaft	Animé
Einstellung	ajustement
Held	héros
Behandlungen	traitements
Haltung	attitude
Teppich	tapis
Linsen	lentilles
besucht	assisté
Schwierigkeit	difficulté
Punk	punk
Koalition	coalition
Einschreibung	inscription
Herzog	Duc
Tempo	rythme
Produzenten	producteurs
Bogen	arc
Schnittstellen	interfaces
Atlas	atlas
Überwachung	observation
Folter	torture
gelöscht	supprimé
Mantel	manteau
Wiederherstellung	restauration
Bequemlichkeit	commodité
Rückkehr	retour
Opposition	opposition
Container	récipient
Beklagte	défendeur
Supervisor	superviseur
Korps	corps
Schauspieler	acteurs
Leber	foie
haftbar	assujetti
Petition	pétition
Antenne	antenne
gepflückt	choisi
Glauben	croyance
Tötung	meurtre
Schulter	épaule
Dekor	décor
Ion	ion
Durchmesser	diamètre
Podcast	Podcast
Wechselwirkungen	interactions
Sänger	chanteur
Herold	héraut
Altern	vieillissement
Intervention	intervention
Plugin	brancher
Attraktion	attraction
Tauchen	plongée
Änderung	modification
annehmen	supposer
Schilf	roseau
betreffen	impliquer
mäßig	modérer
Mäuse	souris
verstanden	compris
schnell	rapidement
Verbot	interdire
Sicherheit	assurance
Ereignis	événement
weit	vaste
Mühlen	moulins
Gliederung	contour
erhält	reçoit
Jeans	jeans
Zusammenstellung	compilation
ungerade	impair
sigma	Sigma
GR	gr
attraktiv	attrayant
Gelegenheit	occasion
Aufnahmen	enregistrements
Opfer	victime
Forderungen	demandes
Vorsichtig	prudent
Strahl	faisceau
Gartenarbeit	jardinage
Verbindlichkeiten	obligations
ankommen	arrivée
Orchester	orchestre
Lizenz	Licence
einstellbar	Ajustable
Zuweisung	allocation
Aufsatz	essai
gezeigt	démontré
Dialog	dialogue
Lager	camps
erklärt	déclaré
Spur	trace
geschlossen	fermer
Packungen	paquets
ge	ge
Installation	pose
Schalter	interrupteurs
freiwillig	volontaire
du	tu
sehr	très
ng	ng
häufig	communément
pe	pe
Fotograf	photographe
Schrei	cri
Quant	quantum
konstruiert	construit
Ergänzungen	additions
erforderlich	exigeant
Pfeil	flèche
Engagement	engagement
Rau	rugueux
seltsam	bizarre
Löwe	Lion
Hochzeiten	mariages
Sauerstoff	oxygène
Schlucht	canyon
Meter	mètres
nur	seulement
Kalender	calendriers
Anordnung	arrangement
Schlussfolgerungen	conclusions
Literaturverzeichnis	bibliographie
Zeiger	aiguille
Kompatibilität	compatibilité
strecken	étendue
Genehmigungen	permis
Kooperative	coopérative
Ernährung	alimentation
Gemeinde	canton
Ranglisten	classements
Messung	mesure
Gurt	sangle
Menge	foule
Transfers	transferts
olympisch	olympique
Transformation	transformation
dir	dir
Zoll	douane
Administratoren	administrateurs
Persönlichkeit	personnalité
Haken	crochet
Roulette	roulette
Ablehnen	déclin
Kabel	corde
Wolke	nuage
erleichtern	faciliter
val	val
erklärt	explique
Vorgehen	procéder
Gefühle	sentiments
Messer	couteau
adoptieren	adopter
verweigert	dénié
Spende	don
äußere	extérieur
Ernte	surgir
Flüsse	rivières
Knoten	nœuds
zitiert	cité
Nabe	centre
gezielt	ciblée
erkannte	réalisé
Gründer	fondateur
Dekade	décennie
Streit	contestation
müde	fatigué
negativ	négatif
Auszug	extrait
entladen	décharge
Getränke	boissons
As	as
Stimmen	voix
Kletterei	escalade
Tonnen	tonnes
Parfüm	parfum
gefährlich	dangereux
wiederherstellen	restaurer
Stapel	empiler
Methodik	méthodologie
Ruf	réputation
Demokraten	démocrates
aufhängen	pendre
Kurve	courbe
Schöpfer	créateur
Bernstein	ambre
Museen	musées
Verschlüsselung	codage
Tracker	traqueur
Variation	variation
Passage	passage
übertragen	transféré
Kofferraum	tronc
Foto	photographier
Wellen	vagues
Kamel	chameau
Verteiler	distributeur
chi	chi
Versammlung	rassemblement
Projektion	projection
mathematisch	mathématique
logisch	logique
Soße	sauce
Ruhm	célébrité
spezialisiert	spécialisé
Unternehmen	sociétés
Kritik	critique
Automobil	voiture
Jury	juges
Bemerkungen	remarques
detektiert	détecté
Gemälde	peintures
ging	marché
entstehen	découlant
Populationen	populations
ängstlich	peur
akustisch	acoustique
Kassette	cassette
Indikator	indicateur
jpg	jpg
Fehler	erreur
beseitigen	éliminer
Mineral	minéral
Rubin	rubis
Perlen	perles
Vermögen	fortune
Segeltuch	Toile
Schwelle	seuil
Gemeinde	paroisse
Bildschirme	écrans
Friedhof	cimetière
Stadion	stade
Erkundung	exploration
min	minutes
Stengel	tige
Astronomie	astronomie
Wettbewerbe	concours
Grippe	grippe
Kostüm	costume
Fahrräder	vélos
Bischof	évêque
zog	tiré
Mais	blé
Kompression	compression
Festlegung	établissement
Farmer	agriculteur
Zinn	étain
Sklave	esclave
sofort	immédiatement
Coaching	encadrement
geprüft	examiné
Codierung	codage
Einreichungen	soumissions
Helden	héros
gemalt	peint
Porträt	portrait
Terrorist	terroriste
ethisch	éthique
Träger	transporteurs
Mobilität	mobilité
Kampf	lutte
Regelungen	régimes
Leiden	Souffrance
neutral	neutre
Fischer	pêcheur
Ratte	rat
Speere	lances
Beitritt	joindre
Überschrift	titre
künstlich	artificiel
Lager	palier
spektakulär	spectaculaire
Welten	mondes
schuldig	coupable
Aktivierung	Activation
Oase	havre
Tablette	tablette
Jury	jury
DOS	dos
Schwanz	queue
Charme	charme
heftig	violent
möglicherweise	potentiellement
Ranch	ranch
Einschränkungen	contraintes
Kreuzung	traversée
inklusive	compris
Hütte	chalet
betrunken	ivre
beträchtlich	considérable
Verbrechen	crimes
aufgelöst	résolu
Byte	octet
Nase	nez
Geäst	branches
Ausländer	extraterrestre
Prozessoren	processeurs
Pleite	cassé
Komplexität	complexité
ständig	constamment
Entschlossenheit	résoudre
Gebiete	territoires
These	thèse
Scheiben	disques
häufig	fréquent
Decke	plafond
Pixel	pixels
gen	gen
Diamanten	diamants
Flotte	flotte
Bündel	bouquet
theoretisch	théorique
Verweisung	référence
Verlassen	quitter
Protokolle	protocoles
Lunge	poumon
Ersatz	remplacer
brillant	brillant
ti	ti
Gel	gel
gesprochen	parlé
Omega	oméga
bewertet	évalué
blieb	séjourné
sieht	voit
Beendigung	Résiliation
schaute	regardé
Haushalte	ménages
einlösen	racheter
Korn	grain
Regime	régime
Stier	taureau
architektonisch	architectural
abweichen	différer
Bewegungen	mouvements
Reparaturen	réparations
Atem	souffle
Komfort	équipements
virtuell	virtuellement
Markt	marché
Kerze	bougie
hängend	pendaison
farbig	coloré
Geschichte	conte
früher	anciennement
Beamer	projecteur
gelegen	situé
sucht	cherche
streng	strictement
psychologisch	psychologique
Vitamine	vitamines
elegant	élégant
Gewinne	gains
Erneuerung	renouvellement
Genealogie	généalogie
als	réputée
Wertung	points
Ausgaben	dépense
Kritik	critiques
Algorithmen	algorithmes
Hacker	pirate
Salon	salon
Turbo	turbo
heilen	guérir
ni	ni
denkt	pense
Vorschlag	suggestion
Soldat	soldat
Bombe	bombe
Schaden	nuire
Intervall	intervalle
Spiegel	miroirs
untersuchen	enquêter
deine	tes
Platten	panneaux
wiederholt	répété
Angriff	agression
Hirsch	cerf
Zunge	langue
Bowling	bowling
tri	tri
Affe	singe
Anteil	proportion
Rock	jupe
Analysen	analyses
Zeichnungen	dessins
Bedeutung	importance
Szenario	scénario
Ihr	vous
Arabisch	arabe
Spur	jauge
Schutz	protéger
konfrontiert	face
Auflösung	résolution
produziert	produit
intensiv	intensif
Ketten	Chaînes
sechste	sixième
engagieren	engager
Schaltung	commutation
Korrespondenz	correspondance
Importe	importations
Aufsicht	surveillance
Ausgaben	dépenses
Trennung	séparation
Zeugnis	témoignage
vermuten	suspect
verpflichtend	obligatoire
Grenzen	limites
Feier	fête
Filter	filtration
Ehepartner	époux
exotisch	exotique
Zuschauer	téléspectateur
reichend	atteindre
Lachen	rire
chirurgisch	chirurgical
zerstören	détruire
Zitat	citation
yo	yo
Lokal	locaux
bewährt	prouvé
beleidigend	offensive
Kaiserliche	impérial
Dutzend	douzaine
Einsatz	déploiement
Stoff	tissu
Lotus	lotus
Lachs	Saumon
Ladung	cargaison
Direktive	directif
Kamerad	camarade
Butter	beurre
Pfeffer	poivre
Waffe	arme
Belastung	charge
Bänder	bandes
Zonen	zones
Insel	île
schlank	svelte
Ahorn	érable
Lebensmittelgeschäft	épicerie
Regierungs	gouvernant
Depot	dépôt
alt	alt
Kuchen	tarte
Mischung	mélange
Emission	émission
ersichtlich	apparent
Lehr	éducatif
Berechtigungen	autorisations
Toilette	toilette
Platz	classé
Routen	routes
Montage	montage
gebunden	lié
ausgewogen	équilibré
verspätet	différé
Tal	vallée
Berechnung	calcul
Villen	villas
Gelegenheiten	occasions
Gleichungen	équations
Öl	huiles
September	septembre
außergewöhnlich	exceptionnel
Angst	anxiété
räumlich	spatial
Befragten	répondants
Überlegungen	considérations
zahlt	paie
sonnig	ensoleillé
liefert	livre
je	je
Halskette	Collier
zusammengesetzt	composite
lang	lang
Theater	théâtres
Entwerfen	conception
Hoffnungen	espoirs
Beurteilungen	évaluations
Diagramm	diagramme
Schuhwerk	chaussure
sg	sg
Völker	peuples
Sieger	Victor
Lizenzen	licences
Bereiche	gammes
Paare	paires
Empfindlichkeit	sensibilité
Erhaltung	préservation
isoliert	isolé
Interim	intérimaire
unterstützt	assisté
göttlich	Divin
genehmigen	approuver
Verbindung	composé
Intensität	intensité
technologisch	technologique
Abtreibung	Avortement
Dialog	dialogue
Veranstaltungsorte	lieux
sprengen	explosion
Adressierung	adressage
Pole	pôle
Schild	bouclier
Membran	membrane
verzweifelt	désespéré
Mütter	mères
Demonstration	manifestation
Regierungs	gouvernemental
hergestellt	fabriqué
Kerzen	bougies
Variationen	variations
Mütter	mamans
heilig	sacré
Sucht	dépendance
Chrom	chrome
verweigert	refusé
Bremse	frein
Außen	extérieur
Gruß	salutation
Ökologie	écologie
Tal	glen
Arbeitslosigkeit	chômage
erzielter	marqué
Erweiterung	renforcement
Klon	cloner
Geschwindigkeit	rapidité
Lambda	lambda
zusammengesetzt	composé
Tränen	larmes
Oase	oasis
Taxi	taxi
Fa	FA
Gesellschaften	sociétés
Silizium	silicium
identisch	identique
Petroleum	pétrole
konkurrieren	rivaliser
ist	ist
Liebhaber	amoureux
gehören	appartenir
Lippen	lèvres
begleiten	escorte
Teich	étang
Fähre	traversier
Hase	lapin
Beruf	métier
Damm	barrage
Physiologie	physiologie
Ausfuhr	exportations
Reifen	pneu
Teilnehmer	participant
Elektron	électron
Ladungen	charges
Heidekraut	bruyère
Motel	motel
Gewerkschaften	syndicats
Fiskus	Trésorerie
belegt	occupé
Waage	Balance
Belastung	souche
verhaftet	arrêté
Untersuchungen	enquêtes
gewonnen	gagné
Wäsche	blanchisserie
Erteilung	placement
einstellen	régler
bewertet	évalués
Verschlüsselung	chiffrement
Füllung	remplissage
auferlegte	imposé
Schweigen	silence
sowjetisch	soviétique
Besitz	possession
Vertrag	traité
Trainer	entraîneur
Organ	organe
Zitrone	citron
Dunkelheit	obscurité
Spanne	envergure
Scherz	blague
Verpackung	emballage
Satzung	loi
abgelehnt	rejeté
Schutz	abri
Kapelle	chapelle
Herstellung	fabrication
Lagen	couches
feiern	célébrer
Gerät	appareil
Mischung	mélange
Fahrer	cavalier
Radius	rayon
beeindruckend	impressionnant
Schaf	mouton
Architekt	architecte
Vorlesungen	conférences
Weine	vins
Tassen	tasses
Asche	cendre
Beiträger	contributeurs
Salat	salade
Verletzungen	violations
Temperaturen	températures
Wettbewerbe	compétitions
erhalten	préserver
Gedicht	poème
bleiben	rester
Ostern	Pâques
Theorien	théories
Repository	dépôt
Strom	ruisseaux
Landung	atterrissage
hingerichtet	réalisé
Verhandlungen	négociations
realistisch	réaliste
fragt	demande
Zusammenfassung	synopsis
Komponist	compositeur
Bohne	haricot
Schwert	épée
Modifikationen	modifications
Koralle	corail
Pixel	pixel
Wegen	chemins
Blase	bulle
por	por
erwerben	acquérir
Gegenteil	contraire
Tribun	tribune
Schiff	navire
Säuren	acides
Viren	virus
Aufkleber	autocollants
Reaktionen	réactions
Glauben	croyances
Kader	équipe
analysieren	analyser
Divisionen	divisions
schwimmen	nager
nano	nano
Konzerte	concerts
Männchen	mâles
behalten	conserver
Farben	couleurs
ausführen	exécuter
Tunnel	tunnel
Genre	genres
Patente	brevets
Weizen	blé
Chroniken	chroniques
Beschaffung	obtention
Biber	castor
Lesungen	lectures
Erweiterung	élargissement
Adler	aigles
Basen	bases
Angeklagte	accusé
Kampagnen	campagnes
Einheit	unité
definiert	définit
Instanzen	instances
einheimisch	indigène
begonnen	commencé
Pakete	paquets
Anker	ancre
Socken	chaussettes
auslösen	déclencheur
Cholesterin	cholestérol
Differential	différentiel
Oberflächen	surfaces
furchtbar	terrible
Router	routeurs
Uhren	horloges
Arthritis	arthrite
BIOS	bios
Weibchen	femelles
spiegelt	reflète
Besteuerung	Imposition
Fieber	fièvre
Küche	cuisine
sicherlich	sûrement
Praktiker	praticiens
Satz	théorème
Inflation	inflation
dich	te
Verbindungen	composés
Schlagzeug	tambours
vernünftig	raisonnablement
blank	nu
Radikale	radical
empfiehlt	recommande
Regelung	commander
Schatz	Trésor
Flamme	flamme
Grube	fosse
Mono	mono
Partikel	particules
schwimmend	flottant
Koordinate	coordonner
ausschließlich	exclusivement
Einschränkung	limitation
geschlagen	frappé
Illustration	illustration
Warnungen	avertissements
bauen	construction
Apps	applications
Anfragen	enquêtes
annektieren	annexe
Inspiration	inspiration
Fracht	fret
Finsternis	éclipse
wirkt	affecte
Prognosen	prévisions
entdecken	détecter
aktiv	activement
kompliziert	compliqué
verletzt	blessé
Ausdrücke	expressions
Tonne	tonne
Kurier	courrier
Hinweise	astuces
gif	gif
Konflikte	conflits
Getränk	boisson
Tribut	hommage
immun	immunitaire
Forstwirtschaft	sylviculture
Barrieren	barrières
kippen	pente
selten	rarement
Angebote	offres
Barriere	barrière
Fahrrad	vélo
Einrichtung	mobilier
entstehen	survenir
keltisch	celtique
Partikel	particule
Feuchtigkeit	humidité
Flaschen	bouteilles
dm	dm
Renaissance	Renaissance
Verordnung	ordonnance
Fotografen	photographes
Infektionen	infections
Schach	échecs
arbeitet	fonctionne
Feste	festivals
Möglichkeiten	possibilités
Ente	canard
Kanal	canal
Beitrag	contribuant
Kuh	vache
analytisch	analytique
Kostüme	costumes
streng	strict
Verkehr	circulation
Delikt	infraction
Annahme	supposition
Hobby	loisir
Versuche	essais
Erfindung	invention
Techniker	technicien
Führungskräfte	cadres
Anfragen	enquêtes
kognitiv	cognitif
erforschen	explorant
Trick	tour
Anfrage	enquête
Schließung	fermeture
Bauholz	bois
Volt	volt
heftig	intense
Unterstützer	partisans
Satzung	statuts
eingeschrieben	inscrits
Sensoren	capteurs
Schraube	vis
Minister	ministres
öffentlich	publiquement
litt	souffert
Aufnahme	admission
Schmetterling	papillon
Mechanik	mécanique
Header	têtes
Fehler	erreurs
numerisch	numérique
definieren	définissant
Zählen	compte
Betrachtung	réflexion
Einladung	invitation
Natrium	sodium
Hormon	hormone
Kinder	enfants
Backstein	brique
Griff	poignée
mittelalterlich	médiéval
Porzellan	porcelaine
gefangen	capturé
anständig	décent
Guss	fonderie
übersetzt	traduit
Donna	dona
Krieger	guerrier
Kabine	cabine
Scannen	balayage
Polo	polo
Kopieren	copier
Horn	klaxon
Journalismus	journalisme
Frosch	grenouille
Grammatik	grammaire
Absicht	intention
Reifen	pneus
unternommen	entreprise
Gefahr	danger
Folgen	épisodes
kreisförmig	circulaire
Zorn	colère
Abbildungen	illustrations
Chancen	chances
Glück	bonheur
bizarr	bizarre
ur	ur
Früchte	fruits
Kennzeichnung	identificateur
Band	ruban
Berechnungen	calculs
jpeg	jpeg
Anfang	Commencez
praktisch	pratique
Wechsel	échanger
befreit	exempter
Pflanzen	cultures
reduziert	réduit
durchgeführt	accompli
Geometrie	géométrie
Eindruck	impression
Gilde	guilde
Korrelation	corrélation
sim	sim
nervös	nerveux
Duft	fragrance
Replik	réplique
Stamm	tribu
Trades	métiers
hervorragend	superbe
loswerden	débarrasser
Dreieinigkeit	trinité
abgewickelt	manipulés
Legenden	légendes
Boom	boom
Ruhe	calme
Meister	champions
Etagen	étages
Auswahlen	sélections
Vergleichen	comparant
spricht	parle
beruflich	professionnel
Apotheken	pharmacies
ln	Dans
Rolle	rouleau
Stapel	lot
organisieren	organiser
geschätzt	apprécié
ändern	modifier
Kanten	bords
Vermischung	mélange
Griffe	poignées
Harmonie	harmonie
vornehm	distingué
Asthma	asthme
Annahmen	hypothèses
geregelt	réglementé
Dreieck	Triangle
ändern	modifier
erwartet	anticipé
orientalisch	Oriental
Belohnung	récompense
Wasserstoff	hydrogène
vergleichbar	comparable
befürworten	avocat
Verwechslung	confusion
Eingänge	contributions
Garantien	garanties
Genom	génome
Medaille	médaille
Trainer	entraîneurs
Schiffe	navires
Hafen	port
Öko	eco
verletzlich	vulnérable
ordnen	organiser
künstlerisch	artistique
Ehrungen	honneurs
reflektiert	reflété
einheitlich	unifié
Rasse	race
Detektor	détecteur
ignoriert	ignoré
präzise	précis
Auswertung	évaluer
Lippe	lèvre
versammeln	recueillir
Bildung	formant
Journalisten	journalistes
leicht	mince
indirekt	indirect
unter	parmi
Stiftungen	fondations
Horizont	horizon
nu	nu
tief	profondément
Verbindlichkeiten	passif
Preise	prix
verringert	diminué
beschreiben	décrivant
Optik	optique
verfolgen	poursuivre
Blitz	foudre
ou	OU
Zitate	citations
Inspektor	inspecteur
Schlange	serpent
Erinnerung	rappel
gesucht	cherché
Flachland	plaines
Einblicke	idées
Fähigkeiten	capacités
initiiert	initié
Karaoke	karaoké
Falle	piège
einsam	solitaire
ve	ve
beobachten	observer
Behälter	conteneurs
Einstellungen	attitudes
Beere	baie
Halsband	collier
integrieren	intégrer
Soziologie	sociologie
Exponate	expositions
stirbt	meurt
Terrasse	terrasse
Bakterien	bactéries
sollen	devrait
köstlich	délicieux
Traditionen	traditions
endlich	fini
sendet	envoie
dauerhaft	durable
verbündet	allié
Feuchtigkeit	humidité
verwandeln	transformer
Timer	minuteur
Tablets	comprimés
bekommen	obtenu
Erzieher	éducateurs
Gemüse	légume
Vers	verset
unabhängig	indépendamment
Konkurrenz	concurrents
Rakete	fusée
Ja	toujours
Kugel	balle
Türme	tours
Sichtweite	visibilité
Breite	latitude
Bewusstsein	conscience
Tumor	tumeur
hässlich	laid
Einlagen	dépôts
Herrin	maîtresse
Begegnung	rencontre
Watt	watts
vierzig	quarante
Röhren	tubes
versucht	tentative
Priester	prêtre
Analysten	analystes
Hammer	marteau
Invasion	invasion
Läufer	coureur
Reihen	lignes
verabreicht	administré
Begriff	notion
Rechtschreibung	orthographe
Arktis	Arctique
Belohnt	récompenses
unter	sous
stärken	renforcer
verteidigen	défendre
infrarot	infrarouge
siebte	septième
Bauch	ventre
aggressiv	agressif
Anzeigen	annonces
Quartier	quarts
gestohlen	volé
bestimmt	détermine
Skulptur	sculpture
Poly	poly
Ohren	oreilles
Faust	poing
Neo	néo
Motivation	motivation
Passagiere	passagers
konsequent	régulièrement
Überschuss	surplus
graben	creuser
Taxi	Taxi
Anerkennung	appréciation
om	om
Beschränkung	restriction
Gitarren	guitares
Wesen	essence
mächtig	puissant
Menschheit	humanité
Transkription	transcription
Komplikationen	complications
Wissenschaftler	savants
Galaxis	galaxie
Pflege	soins
Testament	testament
Dominant	dominant
Bauch	estomac
teilweise	partiellement
minimieren	minimiser
Reihen	rangs
Debüt	début
Generationen	générations
Turniere	tournois
verweigern	Nier
Anatomie	anatomie
Kopfhörer	écouteurs
Fraktion	fraction
Trio	trio
Vorgehen	instance
Würfel	cube
Defekte	défauts
Unsicherheit	incertitude
Nervenzusammenbruch	panne
geregelt	colonisé
Impfstoff	vaccin
Schicksal	sort
Buchungen	réservations
Republikaner	républicains
Dschungel	jungle
Zen	Zen
dis	dis
Prognose	prédiction
ökologisch	écologique
Oval	ovale
impliziert	implique
ser	ser
Bewertung	évaluation
Aussicht	perspective
geographisch	géographique
Spender	donneur
Spannung	tension
Müll	poubelle
Formen	formes
Stufe	étage
Graf	comte
Heimat	patrie
Meisterschaft	championnats
Rassen	races
Disko	disco
aus	aus
Veredelung	finition
Emotionen	émotions
ewig	éternel
Drehung	rotation
nam	nam
produktiv	productif
Boulevard	boulevard
Schwein	porc
metrisch	métrique
Strafen	pénalités
abwechslungsreicher	varié
grande	grande
Darstellerin	actrice
zuordnen	attribuer
unterbringen	accommoder
Tiger	tigres
Dörfer	villages
Schatten	ombre
Chor	Refrain
Rhythmus	rythme
Ziffer	chiffre
Symphonie	symphonie
plötzlich	soudain
Annehmen	acceptant
Schwimmbäder	piscines
lyrisch	lyrique
Isolierung	isolement
Geschwindigkeiten	vitesses
nachhaltig	soutenu
abgestimmt	appariés
ungefähr	approximatif
Seil	corde
rational	rationnel
Programmierer	programmeur
Kämpfer	combattants
vererbt	hérité
unvollständig	incomplet
Gesang	voix
Brunnen	Fontaine
legitim	légitime
Biographien	Biographies
Ermittler	enquêteur
Kläger	demandeur
sanft	doux
würdig	digne
Architekten	architectes
Heilige	saints
Unternehmer	entrepreneur
trägt	porte
Duo	duo
überhöht	excessif
spart	sauve
angesehen	considéré
Bewertung	évaluation
unerwartet	inattendu
Nebel	brouillard
charakteristisch	caractéristiques
Empfangshalle	hall
skizzierte	décrit
enorm	énorme
Karma	karma
bestehen	consister
Königinnen	reines
Wissenschaftler	universitaires
Stämme	tribus
Unterscheidung	distinction
Gefahren	dangers
Befreiung	exemption
Mieter	locataire
Nachhaltigkeit	durabilité
Tätowierung	tatouage
Algebra	algèbre
Schatten	ombres
dumm	idiot
frei	librement
mild	doux
Pelz	fourrure
leicht	facilement
Zugehörigkeit	affiliation
Zaun	clôture
unendlich	infini
Clan	clan
Revolutionär	révolutionnaire
Armbänder	bracelets
Abhilfe	remède
Atmung	respiration
kurz	brièvement
Dicke	épaisseur
grafische	graphique
Genius	génie
Diskussion	discuter
Kämpfer	combattant
sinnvoll	significatif
adaptiert	adapté
Ländereien	domaines
Teppich	couverture
Demokrat	démocrate
Bezirk	arrondissement
hält	maintient
ka	ka
beibehalten	retenu
Marmor	marbre
DM	dem
Meditation	méditation
Mikrofon	microphone
Vereinigung	combinant
Riesen	géants
organisieren	organisation
Memo	note
Schinken	jambon
gelöst	résolu
Tide	marée
Trennwand	cloison
unsichtbar	invisible
Konsolen	consoles
Magnet	aimant
Übersetzungen	traductions
Jaguar	jaguar
Ware	marchandise
Kilometer	kilomètres
Garantien	garanties
gotisch	gothique
Zylinder	cylindre
Hexe	sorcière
Bock	mâle
Feinde	ennemis
Beratung	Conseil
genießen	profiter
patrouillieren	patrouille
Geruch	odeur
Karneval	carnaval
grob	grossièrement
Aufkleber	autocollant
Versprechen	promesses
Riff	récif
Teilen	diviser
aufeinanderfolgenden	consécutif
bon	bon
Vorstellungen	représentations
chan	chan
Melodien	airs
mas	mas
Sätze	phrases
kai	kai
Halbinsel	péninsule
langweilig	ennuyeuse
dom	dom
Reden	discours
erreicht	atteint
Schema	schéma
Kataloge	catalogues
Ministerien	ministères
parlamentarisch	parlementaire
Präfix	préfixe
Savanne	savane
Fass	baril
Nerv	nerf
dans	Dans
Planeten	planètes
Defizit	déficit
erneuern	renouveler
gekoppelt	accouplé
Schaltungen	circuits
Textur	texture
bestätigen	reconnaître
Zelt	tente
identifiziert	identifie
Qualifikation	qualification
Schlösser	serrures
Miniatur	miniature
Euro	euros
Piraten	pirates
Antenne	aérien
Falke	faucon
Folge	conséquence
systematisch	systématique
wahrgenommen	perçue
Ursprünge	origines
gemietet	embauché
bilden	maquillage
ui	ui
Gewichte	poids
geologisch	géologique
dauerhaft	durable
böse	méchant
einleitet	introduit
geschoben	pressé
ro	ro
Steigung	pente
Dichter	poète
Verschwörung	conspiration
Theologie	théologie
Nägel	ongles
offensichtlich	évident
Fahrten	manèges
Epos	épique
Veranstalter	organisateur
Allergie	allergie
Sake	Saké
Kombinationen	combinaisons
vorangestellt	précédent
verdienen	mérite
Enzym	enzyme
Flugzeuge	Avions
Scheiben	disques
Verstärker	amplificateur
willkürlich	arbitraire
prominent	important
sans	sans
baut	construit
kontaktiert	contacté
Welle	arbre
lehnen	maigre
gelegentlich	occasionnel
Innovationen	innovations
Überprüfung	révision
Panik	panique
Staatsbürgerschaft	citoyenneté
Ausrede	excuse
Reformen	réformes
Zwiebel	oignon
Sandwich	sandwich
Alt	alto
Hierarchie	hiérarchie
verlassen	abandonné
Kreise	cercles
Beats	Beats
fröhlich	joyeux
Kult	culte
Strich	tiret
passiv	passif
geschätzt	estimé
Käfig	cage
Mut	courage
Elevation	élévation
Runde	tour
Nutzung	utilisation
Getränke	boissons
Klingeln	ping
unterhaltsam	divertissant
Voraussetzung	prérequis
Grenze	frontière
Flüchtlinge	réfugiés
Ritter	chevaliers
Hypothese	hypothèse
Medikamente	médicaments
geändert	modifié
Lehre	doctrine
szenisch	scénique
Erweiterungen	améliorations
Überschneidung	intersection
Nähen	couture
Sammler	collectionneurs
anerkannt	reconnu
Rage	rage
prix	prix
Astrologie	astrologie
Berater	conseillers
Pavillon	pavillon
Taktik	tactique
Zusatz	additionnel
talentiert	talentueux
Kissen	oreiller
Verbreitung	diffusion
Provinzen	provinces
stehlen	voler
Paket	parcelle
Vorfall	incidence
Ängste	craintes
vorhersagen	prédire
Geschmack	saveur
hungrig	affamé
metallisch	métallique
Interferenz	ingérence
Krieger	guerriers
atmosphärisch	atmosphérique
Heiligenschein	Halo
Eltern	parental
verwiesen	référencé
Streiks	grèves
Ameise	fourmi
Vorschlag	proposition
geeignet	apte
behandelt	traité
Händler	Commerçant
geworfen	jeté
Kriterium	critère
Abzeichen	badge
Zivilisation	civilisation
Heide	bruyère
enorm	énorme
führt	exécute
Reich	domaine
korrigiert	corrigée
Helm	casque
angetroffen	rencontré
Tsunami	tsunami
Gelehrte	savant
umgeben	entouré
Geologie	géologie
Kreaturen	créatures
gelöscht	dégagé
erreichen	accomplir
Ecken	coins
Vegetarier	végétarien
Hefe	Levure
pas	pas
sucht	enquête
Botschafter	ambassadeur
beschichtete	recouvert
Untergang	condamner
Routinen	routines
Wesen	êtres
Vertrauen	dépendance
Mythos	mythe
Bach	ruisseau
fu	fu
Phänomen	phénomène
Ensemble	ensemble
versicherte	assuré
bewusst	conscient
Akzent	accent
Ehefrauen	épouses
nutzen	utiliser
Versprechen	gage
Vampir	vampire
Dock	Dock
organisiert	organisé
Musiker	musicien
Begrenzung	limitant
restauriert	restauré
Hinweis	allusion
Rüstung	armure
Anmerkung	remarque
Dutzende	douzaines
variiert	varie
Argumentation	raisonnement
Wächter	gardes
Öffnungen	ouvertures
Ersetzung	remplaçant
Forscher	chercheur
Räte	conseils
Berufe	professions
anerkannt	reconnu
Schweinefleisch	porc
zu	zu
Gleichgewicht	équilibre
Rohre	pipes
Hütten	chalets
verschmelzen	fusionner
Privileg	privilège
entwickelt	développe
Chassis	châssis
Einschätzung	estimation
Scheune	Grange
Frost	gel
Institute	instituts
Schimmel	moule
Freifrau	dame
Yacht	yacht
bevorzugt	préfère
Bohrung	forage
Kraut	herbe
Bruch	violation
Wal	baleine
Reisende	voyageur
Mittel	crédits
vermutlich	soupçonné
Tomaten	tomates
Lehrer	instructeurs
Schwung	élan
Flosse	ailette
Pastor	pasteur
Schlamm	boue
Smaragd	émeraude
wächst	pousse
Traktat	tract
ul	ul
Ballett	ballet
Journalist	journaliste
Religionen	religions
Knoblauch	Ail
scheinen	éclat
Explosion	explosion
Slip	slips
Unterschriften	signatures
Ozon	ozone
Disziplinen	disciplines
casa	casa
Gespräche	conversations
Radios	radios
Tarif	tarif
vereinfachte	simplifié
Muskeln	muscles
schnell	rapide
Vagina	vagin
Champagner	Champagne
Abweichung	déviation
Samba	samba
beschäftigen	employer
Pinguin	manchot
magisch	magique
Einflüsse	influences
Inspektionen	inspections
Bewässerung	irrigation
Wunder	miracle
hydraulisch	hydraulique
Penetration	pénétration
Wunde	blessure
Schöne	belle
rosa	rosa
Überzeugung	conviction
faul	paresseux
Qualitäten	qualités
Väter	ancêtres
Lade	charge
wichtig	important
zierlich	menue
Gerät	appareil
Terrain	terrain
Erläuterung	expliquant
Streifen	bandes
Nominierung	nomination
empirisch	empirique
Wurm	ver
Abhängigkeit	dépendance
diskret	discret
Anfänger	débutant
Deckel	couvercle
Sexualität	sexualité
Saphir	saphir
Privilegien	privilèges
spezialisiert	spécialisation
Markierung	marquage
Sheriff	shérif
abgelehnt	diminué
Spion	espions
Motorräder	motocyclettes
wählen	élire
Autobahnen	autoroutes
konzentrieren	concentrer
intim	intime
Moleküle	molécules
Runde	tours
Kühlschrank	réfrigérateur
Intervalle	intervalles
Sätze	Phrases
Holocaust	holocauste
Flieger	prospectus
Erbsen	pois
Dosierung	dosage
Unterschied	variance
Navigator	navigateur
Nadel	aiguille
Bad	thermes
Bremsen	freins
og	og
ko	ko
besitzt	propriétaire
Schicksal	destin
Landschaften	paysages
Berechnung	calcul
Heu	foins
Heil	salut
Vorhersagen	prévisions
Lern	apprenants
Zeichen	jeton
Zink	zinc
Opfern	sacrifice
Sucher	demandeurs
Guru	gourou
geeignet	adapté
numerisch	numérique
Anthropologie	anthropologie
Kaiser	empereur
grad	grad
Gürtel	ceintures
Schwarze	noirs
gebildet	cultivé
stolz	fièrement
Notwendigkeit	nécessité
Kurven	courbes
Touren	tournée
Scheitel	sommet
Tomate	tomate
Reisen	voyages
blass	pâle
Funktion	fonctionnement
Wirtschaft	économies
unternehmen	entreprendre
erklären	déclarer
Ventile	vannes
Lücken	lacunes
Erfolge	réalisations
reißen	larme
lehrt	enseigne
Null	néant
Fremder	étranger
Nest	nid
Gericht	tribunal
ausgeschlossen	gouverné
Pensionen	pensions
Gebete	prières
Polizist	flic
Jugendliche	adolescent
Nominierungen	nominations
Banane	banane
einleitend	préliminaire
Reservoir	réservoir
Auftreten	occurrence
Idol	idole
blutig	sanglant
erinnern	rappeler
reizend	charmant
Zahn	dent
respektierte	respecté
Aufenthalte	séjours
Affäre	affaire
beschränken	restreindre
Minen	mines
Porträts	portraits
interpretiert	interprété
Auswertungen	évaluations
Beseitigung	élimination
Meter	mètres
hypothetisch	hypothétique
Hubschrauber	hélicoptère
Bleistift	crayon
Künstler	interprète
Provisionen	commissions
Kugel	sphère
Moos	mousse
Verhältnisse	rapports
Eintracht	concorde
graduierte	graduée
unterstützt	approuvé
überraschend	surprenant
Lanze	lance
Leiter	échelle
Kork	Liège
Senatoren	sénateurs
Blutung	saignement
Charakterisierung	caractérisation
Wahrscheinlichkeit	probabilité
Bahnen	voies
Grundlage	fondamentaux
Kontamination	contamination
Kuppel	dôme
segnen	bénir
Verhandlung	négociation
Kamm	crête
Gegner	adversaires
Triumph	triomphe
nominiert	nommé
Schweißen	soudage
Orgasmus	orgasme
Legierung	alliage
Stellplätze	parcelles
sanft	doucement
Sperrung	verrouillage
umstritten	controversé
Unentschieden	dessine
Kühlschrank	frigo
Klingen	lames
Schlaufen	boucles
Schwall	poussée
Trauma	traumatisme
Inserat	publicité
Defensive	défensive
verboten	interdit
Vanille	vanille
Programmierer	programmeurs
überwacht	suivi
Installationen	installations
Seelen	âmes
motiviert	motivé
Dumm	stupide
hohl	creux
Gewölbe	voûte
Rille	rainure
Offenbarung	révélation
Verfolgung	poursuite
Delegation	délégation
Drähte	fils
Wörterbücher	dictionnaires
Transparenz	transparence
Orbit	orbite
Währungen	devises
Niger	Niger
Positionierung	placement
Kolonie	colonie
Kanone	canon
Zirkus	cirque
gefördert	promu
Forelle	truite
Leistung	exploit
vorübergehend	temporairement
gekocht	cuit
übertragen	transmettre
Frequenzen	fréquences
Reflexionen	réflexions
Hunger	faim
Gemeinde	municipalité
Detektiv	détective
Zement	ciment
erleben	expérience
Kamin	cheminée
Billigung	approbation
Textilien	textiles
Rakete	missile
Psychiatrie	psychiatrie
Assists	aide
Rechnungsprüfer	Auditeur
Geige	violon
Prophet	prophète
Oxid	oxyde
ausgezeichnet	magnifique
sofort	rapidement
Anpassung	adaptation
schädlich	nocif
sexuell	sexuellement
Gehege	enceinte
Glucose	glucose
Norm	norme
Wiedergabe	lecture
Schildkröte	tortue
Entfernungen	distances
Absorption	absorption
Schätze	trésors
Fossil	fossile
schlecht	mal
Kommunist	communiste
Unternehmer	entrepreneurs
Roboter	robots
Foul	faute
Biodiversität	biodiversité
Aufregung	excitation
verbal	verbal
Meere	mers
mysteriös	mystérieux
Neuheit	nouveauté
Fliesen	carrelage
Bibliothekar	bibliothécaire
schaltet	commuté
ru	ru
Pose	pose
Gramm	grammes
Therapeut	thérapeute
Budget	budgets
Ziege	chèvre
machen	rendre
Segel	voile
Kommissare	commissaires
dicht	dense
mutig	courageux
Spedition	expéditeur
furchtbar	terrible
Flugzeug	avion
Organismen	organismes
Fernrohr	télescope
Asbest	amiante
Förderung	avancement
Weide	saule
Bewerbungen	CV
existierte	existait
Generatoren	générateurs
erzeugt	génère
Kartoffeln	patates
gründlich	approfondi
Rezeptoren	récepteurs
Optimum	optimum
Kreatur	créature
einsam	seul
subtil	subtil
Streifen	rayures
Firmware	firmware
Schäfer	berger
Wiege	berceau
Kanzler	chancelier
Mehl	farine
Kontroverse	controverse
legendär	légendaire
Chor	chorale
Vermeidung	évitant
schön	magnifiquement
erwartet	attend
Springen	sauteur
Stoffe	textile
Polymer	polymère
Hygiene	hygiène
Tugend	vertu
Chirurgen	chirurgiens
Mandat	mandat
Korpus	corpus
Terminologie	terminologie
Gentleman	gentilhomme
verurteilt	condamné
Jet	jets
Indizes	indices
qui	Qui
bedrohlich	menaçant
Aktivisten	militants
Häftling	prisonnier
ermutigt	encourage
gebaut	assemblé
Terminals	terminaux
roh	brut
Untersucht	examine
Wikinger	viking
Aufräumen	nettoyer
bedingt	conditionnel
angegriffen	attaqué
kommt	arrive
Übersetzer	traducteur
Automobil	automobiles
Traktor	tracteur
Kontinent	continent
Tarife	tarifs
Längengrad	longitude
hoffte	espéré
Einfügung	insertion
Zwang	contrainte
Stärkung	renforcement
wünschen	souhaitant
Isolierung	isolation
Verletzung	infraction
gebogen	courbé
subjektiv	subjectif
Monster	monstres
Asyl	asile
Anteil	pieu
Cocktail	cocktail
Sorten	variétés
Gift	poison
dominiert	dominé
teuer	cher
Derivate	dérivés
verhindert	prévient
Gewehr	fusil
Rassismus	racisme
interpretieren	interpréter
Übereinstimmung	accord
bescheiden	modeste
Spieler	joueurs
Sortierung	tri
Liaison	liaison
Glühbirnen	bulbes
Touristen	touristes
Verhaltensweisen	comportements
klären	clarifier
Taille	taille
zugeschrieben	attribué
Eule	hibou
Kristalle	cristaux
überschreitet	dépasse
komplementär	complémentaire
Kämpfe	batailles
bitter	amer
Memorandum	mémorandum
Drachen	dragons
Lärm	vacarme
unglaublich	incroyablement
Delegierte	délégués
psychiatrisch	psychiatrique
Jugendliche	adolescents
Hof	Cour
Präsidenten	présidents
abfahren	partir
ausdrücklich	expressément
Lilie	lis
Aufsicht	surveillance
Harz	résine
Alliierte	alliés
konserviert	conservé
gekreuzt	franchi
aufsteigend	Ascendant
nominal	nominal
zerfallen	pourriture
Quarz	quartz
Register	registres
achte	huitième
autorisiert	autorisé
verbessert	améliore
Befürworter	défenseurs
Phänomene	phénomènes
Neigung	inclinaison
Granit	granit
Volk	masses
Athlet	athlète
Franc	franc
Ähnlichkeit	similarité
Leck	fuite
Berater	conseiller
Broschüre	brochure
erwartet	attendant
Umsatz	rotation
Urin	urine
Handtuch	serviette
Ingwer	gingembre
Chromosom	chromosome
als	als
Fliegen	mouches
Kompetenz	compétence
Weinen	pleurs
Amateure	amateurs
Kran	grue
Untersuchung	enquête
faul	pourri
Gewohnheit	habitude
Ehre	honneur
schützt	protège
Iris	iris
verwaltet	gère
Erosion	érosion
Zimmermann	Charpentier
Khan	khan
unzureichend	insuffisant
Formulierung	formulation
klug	intelligent
Herren	seigneurs
angenehm	agréable
Halbmond	croissant
sechzig	soixante
konzentriert	concentré
unterscheiden	distinguer
ei	ei
Projektionen	projections
Funke	étincelle
Sicherung	fixation
Weg	sentier
Detektoren	détecteurs
Spitze	pointe
Zutat	ingrédient
Vorhang	rideau
offenbart	divulgués
taktisch	tactique
Piloten	pilotes
Expedition	expédition
operativ	opératoire
Humor	humour
mol	mol
Impressum	imprimer
Unterstützung	assistant
Defekt	défaut
schlecht	pauvrement
Göttin	déesse
Beobachter	observateurs
Magneten	aimants
Formeln	formules
geräumig	spacieux
argumentiert	soutient
Böden	sols
Organe	organes
det	det
Loyalität	fidélité
treu	fidèle
Delikt	infraction
Lithium	lithium
Sprung	saut
Gründung	fondation
Schwan	cygne
Pflanzung	plantation
Bündnis	engagement
Archäologie	archéologie
Matrose	marin
Sorgen	soins
Heiligtum	sanctuaire
Statue	statue
Zitat	citation
Majors	majors
Manipulation	manipulation
Glocken	cloches
Toxizität	toxicité
Sender	émetteur
Nachbarschaften	quartiers
Trophäe	trophée
Emotion	émotion
Sehenswürdigkeiten	spectacles
Uniformen	uniformes
verwundet	blessés
Derivat	dérivé
Belegung	occupation
Dosen	doses
erziehen	éduquer
Vorurteil	préjudice
Techniker	techniciens
wahrscheinlich	probable
Ausgabe	émission
Dekoration	décoration
Angehörige	ressortissants
Trojaner	troyen
Assistenten	assistants
Berater	conseiller
erlassen	adopté
instabil	instable
gedrängt	pressé
reflektierenden	reflétant
Gewinnung	gagnant
endgültig	définitive
gereist	voyagé
anpassen	adapter
Beitritt	accession
Regler	régulateur
Brennstoffe	carburants
Soja	soja
ordentlich	soigné
Benennung	appellation
Stern	arrière
gearbeitete	conçu
Dummkopf	idiot
besteht	composé
Aliens	extraterrestres
Änderungen	modifications
Rabe	corbeau
Wohnung	habitation
symbolisch	symbolique
Winkel	angles
Drücke	pressions
Venus	Vénus
Flammen	flammes
Primitive	primitif
Strumpf	stockage
Ökosystem	écosystème
Hallen	salles
Einfachheit	simplicité
Dämon	démon
begrüßt	accueilli
Notation	notation
Tante	tante
Krähe	corbeau
semantisch	sémantique
abgesetzt	abandonnées
entscheidet	décide
Globalisierung	mondialisation
Esel	ânes
Kompass	boussole
gewachsen	évolué
Infanterie	infanterie
berühmt	renommé
Gang	couloir
philosophisch	philosophique
Rechtfertigung	justification
unbesetzt	vacant
Festsetzung	fixation
Gramm	gramme
versteckt	cache
Farbstoff	colorant
Alphabet	alphabet
gereinigt	nettoyé
geehrt	honoré
optisch	optique
Telefone	téléphones
Tagebücher	agendas
Trauer	douleur
Schweiß	transpiration
Delphin	dauphin
Wunder	merveilles
Belüftung	ventilation
Masken	masques
Büste	buste
Gasse	ruelle
Bahnen	voies
Telegraph	télégraphe
Monument	monument
formal	officiellement
Tau	rosée
zurückgezogen	retiré
Debatten	débats
Identitäten	identités
Mangel	carence
Sattel	selle
Malaria	paludisme
treu	fidèle
Tendenz	tendance
verwendet	utilisé
ein	ein
Fernglas	jumelles
einleiten	lancer
rein	purement
lebendig	vif
Behauptungen	allégations
entspricht	correspond
Daemon	démon
gefeiert	célèbre
Jäger	chasseurs
handelten	agi
Koeffizient	coefficient
Schädel	crâne
Fortsetzung	continuation
Diener	serviteur
Falke	faucon
gemeinsam	conjointement
vermieden	éviter
Erklärungen	explications
erneuert	renouvelé
Kritiker	critique
Sediment	sédiment
Quadrate	carrés
Lieferwagen	fourgonnettes
Kegel	cône
überlebt	survécu
Häufigkeit	prévalence
Fragment	fragment
verpflichtet	engage
Kobra	cobra
warf	jeta
hoc	hoc
Darsteller	interprètes
Dessert	dessert
Dissertation	thèse
neunte	neuvième
Begeisterung	enthousiasme
Feierlichkeiten	célébrations
Gouverneure	gouverneurs
Atome	atomes
Gewebe	tissus
Rampe	rampe
schön	bien
della	della
Vorherrschaft	domination
Akkorde	accords
Beeinträchtigung	détérioration
Molekül	molécule
