von	di
zu	a
im	in
zum	per
ist	è
auf	sopra
Das	quella
durch	di
Dies	Questo
mit	con
ich	io
Sie	tu
es	esso
oder	o
Sein	essere
sind	siamo
beim	a
alle	tutti
haben	avere
Neu	nuovo
wir	noi
werden	volere
Zuhause	casa
uns	noi
Über	di
ob	Se
Seite	pagina
meine	mio
hat	ha
Suche	ricerca
frei	gratuito
aber	ma
unser	nostro
ein	uno
andere	altro
machen	fare
Information	informazione
Zeit	tempo
er	lui
welche	quale
ihr	loro
Nachrichten	notizia
benutzen	uso
Dort	Là
sehen	vedere
damit	così
Wer	chi
Netz	web
ebenfalls	anche
bekommen	ottenere
pm	pm
Aussicht	vista
c	c
e	e
zuerst	primo
gewesen	stato
würde	voluto
wurden	erano
s	S
mögen	piace
x	X
als	di
finden	trova
Preis	prezzo
zurück	indietro
oben	superiore
Menschen	persone
hätten	aveva
Liste	elenco
Name	nome
gerade	appena
Jahr	anno
Tag	giorno
in	in
zwei	Due
Gesundheit	Salute
n	n
Re	ri
benutzt	Usato
gehen	partire
b	B
letzte	ultimo
machen	rendere
Sie	loro
sollte	dovrebbero
Produkt	Prodotto
System	sistema
Post	inviare
ihr	sua
Stadt	città
t	t
Politik	politica
Nummer	numero
Unterstützung	supporto
Botschaft	Messaggio
nach	dopo
dann	poi
Januar	gennaio
gut	bene
d	d
woher	dove
Info	Informazioni
Rechte	diritti
Bücher	libri
hoch	alto
Schule	scuola
m	m
jeder	ogni
Links	link
sie	lei
Jahre	anni
Auftrag	ordine
sehr	molto
Buch	libro
Artikel	elementi
Unternehmen	azienda
r	r
lesen	leggere
Gruppe	gruppo
Sex	sesso
viele	molti
Benutzer	utente
de	de
einstellen	impostato
Allgemeines	generale
Forschung	ricerca
Universität	Università
Januar	gennaio
Post	posta
voll	pieno
Bewertungen	recensioni
Programm	programma
kennt	conoscere
Spiele	Giochi
Weg	modo
Tage	giorni
p	p
Teil	parte
könnte	poteva
groß	grande
vereinigt	unito
echt	vero
f	f
International	internazionale
Center	centro
Reise	viaggio
Bemerkungen	Commenti
gemacht	fatto
Entwicklung	sviluppo
Bericht	rapporto
Mitglied	membro
Einzelheiten	dettagli
Linie	linea
Bedingungen	condizioni
Vor	prima
Hotels	alberghi
tat	fatto
senden	inviare
Recht	destra
Art	genere
lokal	Locale
jene	quelli
Ergebnisse	risultati
Büro	ufficio
National	nazionale
Auto	auto
Design	design
nehmen	prendere
Gesendet	postato
Adresse	indirizzo
Gemeinschaft	Comunità
innerhalb	entro
Zustände	stati
wollen	volere
Telefon	Telefono
DVD	DVD
Gegenstand	soggetto
zwischen	fra
Forum	Forum
Familie	famiglia
l	l
lange	lungo
w	w
Show	mostrare
O	o
sogar	anche
schwarz	nero
Besondere	speciale
Index	indice
Sein	essere
Frau	donne
viel	tanto
Schild	cartello
Datei	file
Verknüpfung	collegamento
öffnen	Aperto
Süd	Sud
Fall	Astuccio
Projekt	progetto
Seiten	pagine
Ausführung	versione
Sektion	sezione
besitzen	proprio
Haus	Casa
Sicherheit	sicurezza
G	g
Bezirk	contea
amerikanisch	americano
Foto	foto
Spiel	gioco
Mitglieder	membri
Leistung	energia
Netzwerk	Rete
Computer	computer
Systeme	sistemi
drei	tre
Ort	posto
Ende	fine
h	h
ihm	lui
pro	per
Zugriff	accesso
denken	pensare
Norden	nord
Ressourcen	risorse
Strom	attuale
groß	grande
Medien	media
Recht	legge
Steuerung	controllo
Wasser	acqua
Geschichte	storia
Größe	dimensione
persönlich	personale
führen	guida
Geschäft	negozio
Verzeichnis	elenco
Veränderung	modificare
Weiß	bianca
Text	testo
klein	piccolo
Wertung	valutazione
Bewertung	Vota
Regierung	governo
Kinder	bambini
Rückkehr	ritorno
Studenten	studenti
v	v
Konto	account
mal	volte
Niveau	livello
Digital	digitale
Profil	profilo
Bisherige	precedente
bilden	modulo
Veranstaltungen	eventi
Liebe	amore
alt	vecchio
John	John
Main	principale
Anruf	chiamata
Bild	Immagine
Abteilung	Dipartimento
Titel	titolo
nicht	non
k	K
y	y
Versicherung	assicurazione
soll	deve
Eigentum	proprietà
Klasse	classe
CD	CD
Qualität	qualità
jeden	ogni
Auflistung	listato
Inhalt	soddisfare
Land	nazione
wenig	piccolo
Werkzeuge	utensili
niedrig	Basso
Antworten	rispondere
Kunde	cliente
Dezember	dicembre
vergleichen	confrontare
Filme	film
Hochschule	Università
Wert	valore
Artikel	articolo
Mann	uomo
Arbeitsplätze	lavori
j	j
Lebensmittel	cibo
Autor	autore
anders	diverso
u	u
lernen	imparare
Verkauf	saldi
drucken	stampare
Kurs	corso
Job	lavoro
Zimmer	camera
Stock	azione
Ausbildung	formazione
auch	pure
Kredit	credito
Punkt	punto
Wissenschaft	scienza
Männer	uomini
Kategorien	categorie
Westen	ovest
aussehen	Guarda
Englisch	Inglese
Mannschaft	squadra
Gut	tenuta
Box	scatola
Bedingungen	condizioni
Fotos	fotografie
Fröhlich	gay
Faden	filo
Kategorie	categoria
Hinweis	Nota
Leben	vivere
groß	grande
Galerie	galleria
Tabelle	tavolo
jedoch	però
Juni	giugno
Oktober	ottobre
November	novembre
Markt	mercato
Bibliothek	biblioteca
Aktion	azione
Anfang	inizio
Serie	serie
Eigenschaften	Caratteristiche
Luft	aria
Industrie	industria
planen	Piano
Mensch	umano
Ja	sì
zweite	secondo
heiß	caldo
Kosten	costo
Film	film
Foren	forum
März	marzo
la	la
September	settembre
sagen	dire
gehen	andando
medizinisch	medico
Freund	amico
Dezember	dicembre
Server	server
Anwendung	applicazione
Mitarbeiter	personale
abspielen	giocare
Probleme	problemi
April	aprile
Benutzer	utenti
Straße	strada
Thema	argomento
gegen	contro
bekam	avuto
Blog	blog
Party	festa
Zahlung	pagamento
Ausrüstung	attrezzatura
Lassen	permettere
Programme	programmi
legal	legale
kürzlich	recente
Park	parco
Handlung	atto
Problem	problema
rot	rosso
geben	dare
Erinnerung	memoria
Performance	prestazione
Sozial	sociale
q	q
Geschichte	storia
verkaufen	vendere
Optionen	opzioni
Erfahrung	Esperienza
Schlüssel	chiave
Karosserie	corpo
jung	giovane
wichtig	importante
Feld	campo
wenige	pochi
Osten	est
Single	singolo
ii	ii
Alter	età
Verein	club
Beispiel	esempio
Mädchen	ragazze
z	z
Straße	strada
Geschenk	regalo
Frage	domanda
ca	circa
hart	difficile
Zahlen	pagare
vier	quattro
Poker	poker
Problem	problema
Angebot	gamma
Gebäude	costruzione
Verkäufer	venditore
Gericht	Tribunale
Februar	febbraio
Ergebnis	risultato
Licht	leggero
schreiben	Scrivi
Krieg	guerra
Angebot	offrire
Blau	blu
Gruppen	gruppi
al	al
einfach	facile
gegeben	dato
anfordern	richiesta
Fax	fax
China	Cina
Herstellung	fabbricazione
Bild	immagine
Bedürfnisse	esigenze
möglich	possibile
Monat	mese
Haupt	maggiore
Star	stella
Zukunft	futuro
Raum	spazio
Ausschuss	Comitato
Hand	mano
Sonne	sole
Karten	carte
London	Londra
Treffen	incontro
werden	diventare
Kind	bambino
behalten	conservare
Porno	porno
Aktie	Condividere
ähnlich	simile
Garten	giardino
Schulen	scuole
Million	milione
hinzugefügt	aggiunto
Referenz	riferimento
Firmen	aziende
Baby	bambino
Lernen	apprendimento
Energie	energia
Lauf	correre
Lieferung	consegna
Beliebt	popolare
Begriff	termine
Film	film
Geschichten	storie
stellen	mettere
Tagebuch	rivista
Berichte	rapporti
co	co
Versuchen	provare
Bilder	immagini
beachten	Avviso
Gott	Dio
Original	originale
Kopf	capo
Radio	Radio
Zelle	cellula
Rat	consiglio
enthält	include
Spur	traccia
Diskussion	discussione
Archiv	archivio
Andere	altri
Zustimmung	accordo
Format	formato
Gesellschaft	società
Monate	mesi
Sicherheit	sicurezza
Freunde	amici
sicher	sicuro
Auflage	edizione
Mitteilungen	messaggi
Marketing	marketing
sagen	raccontare
Verband	associazione
bietet	fornisce
Spaß	divertimento
bereits	già
Grün	verde
Studien	studi
schließen	vicino
verbreitet	Comune
Spezifisch	specifica
mehrere	parecchi
Leben	vita
Sammlung	collezione
namens	chiamato
kurz	corto
Kunst	arti
Menge	lotto
Fragen	Chiedere
begrenzt	limitato
Lösungen	soluzioni
Direktor	direttore
Strand	spiaggia
Vergangenheit	passato
natürlich	naturale
Elektronik	elettronica
auf	su
Zeitraum	periodo
Planung	pianificazione
sagt	dice
offiziell	ufficiale
beschädigen	mar
erledigt	fatto
technisch	tecnico
Fenster	finestra
Profi	professionista
Region	regione
Insel	isola
Aufzeichnung	disco
Direkte	diretto
Konferenz	conferenza
Aufzeichnungen	record
st	st
Kreis	quartiere
Kalender	calendario
Kosten	costi
Stil	stile
Erklärung	dichiarazione
Meilen	miglia
Ressource	risorsa
Anwendungen	applicazioni
Dokument	documento
Wort	parola
Werk	lavori
Material	Materiale
Rechnung	conto
geschrieben	scritto
Regeln	regole
Finale	finale
Ding	cosa
Center	centro
Anforderungen	requisiti
WAHR	VERO
Protokoll	minuti
sonst	altro
Kennzeichen	marchio
Rock	roccia
Schlecht	cattivo
Individuell	individuale
Plus	più
Auto	auto
Abdeckung	copertina
bearbeiten	modificare
zusammen	insieme
Videos	video
schnell	veloce
Funktion	funzione
Tatsache	fatto
bekommen	ottenere
global	globale
Technik	Tech
Treffen	incontrare
weit	lontano
wirtschaftlich	economico
en	it
Spieler	giocatore
Projekte	progetti
Menge	quantità
Uhr	orologio
inbegriffen	incluso
Gefühl	sentire
Bank	banca
Risiko	rischio
Angebote	offerte
verschiedene	vario
Wörter	parole
Produktion	produzione
kommerziell	commerciale
Gewicht	peso
Herz	cuore
Behandlung	trattamento
Punkte	punti
Wissen	conoscenza
Zeitschrift	rivista
Error	errore
Kamera	telecamera
Mädchen	ragazza
Konstruktion	costruzione
Spielzeuge	giocattoli
Eingetragen	registrato
Domain	dominio
Methoden	metodi
Kapitel	capitolo
Schutz	protezione
Politik	politiche
breit	largo
Schönheit	bellezza
Manager	manager
Indien	India
Position	posizione
genommen	prese
Sortieren	ordinare
Inserate	annunci
bekannt	conosciuto
Hälfte	metà
Fälle	casi
Schritt	passo
Ingenieurwesen	ingegneria
einfach	semplice
schnell	Presto
Lizenz	licenza
See	lago
ganze	totale
jährlich	annuale
veröffentlicht	pubblicato
Kirche	Chiesa
Methode	metodo
aktiv	attivo
Antwort	risposta
Zahl	figura
Materialien	materiale
genug	abbastanza
entworfen	progettato
unter	tra
Tod	Morte
Verlust	perdita
Gesicht	viso
Marke	marca
Rabatt	sconto
Auswirkungen	effetti
erstellt	creato
Normen	norme
Bit	po
politisch	politico
Königreich	regno
Base	base
tun	fare
Darlehen	prestiti
Schuhe	scarpe
Eintrag	iscrizione
bleibe	restare
Aufträge	ordini
Verfügbarkeit	disponibilità
Zusammenfassung	sommario
Wende	turno
Wachstum	crescita
Agentur	agenzia
König	re
europäisch	europeo
Aktivität	attività
Kopieren	copia
Western	occidentale
Macht	vigore
Beschäftigung	occupazione
Bucht	baia
Fluss	fiume
Kommission	commissione
Paket	pacchetto
gesehen	visto
Spieler	Giocatori
Motor	motore
Hafen	porta
Album	album
regional	regionale
halt	Stop
gestartet	iniziato
Verwaltung	amministrazione
Bar	bar
Institut	istituto
Ansichten	visualizzazioni
doppelt	Doppio
Hund	cane
bald	presto
Linien	Linee
elektronisch	elettronico
Leistungen	benefici
erforderlich	necessaria
Drucker	stampante
Bedingung	condizione
Wirksam	efficace
glauben	credere
Organisation	organizzazione
bewirken	effetto
Verstand	mente
Auswahl	selezione
Kasino	casinò
pdf	PDF
Tour	giro
Kreuz	attraversare
Hoffnung	speranza
Konzern	società
Wunsch	desiderio
Lösung	soluzione
reifen	maturo
Rolle	ruolo
Wochen	settimane
sicher	certo
niedriger	inferiore
notwendig	necessario
Union	unione
mon	mon
com	com
besonders	particolare
fein	bene
Stunde	ora
Gas	gas
Kompetenzen	abilità
sechs	sei
Buchse	cespuglio
Inseln	isole
Rat	consigli
Werdegang	carriera
Entscheidung	decisione
verlassen	partire
Vor	pre
enorm	enorme
Frau	donna
Anlagen	strutture
bieten	offerta
Mitte	mezzo
Kabel	cavo
Chancen	opportunità
Einnahme	presa
Werte	valori
Aufteilung	divisione
Kommen	venuta
Objekt	oggetto
lesbisch	lesbica
angemessen	adeguata
Maschine	macchina
Logo	logo
Länge	lunghezza
nett	simpatico
Ergebnis	Punto
Statistiken	statistica
Klient	cliente
Probe	campione
Investition	investimento
geschickt	inviato
gezeigt	mostrato
Weihnachten	Natale
Kultur	cultura
Blitz	veloce
Frau	Signorina
Wahl	scelta
Kurse	corsi
Verbraucher	consumatore
Hallo	Ciao
fremd	straniero
Künstler	artista
Möbel	mobilia
Kanal	canale
Brief	lettera
Modus	modalità
Telefone	telefoni
Ideen	idee
Struktur	struttura
Grad	grado
Vertrag	contrarre
Super	super
männlich	maschio
Angelegenheit	importa
fast	quasi
gelegen	collocato
mehrere	multiplo
Verteilung	distribuzione
Editor	editore
Gasthaus	Locanda
industriell	industriale
Potenzial	potenziale
Lied	canzone
los	los
fallen	autunno
Idee	idea
Räume	camere
Kommunikations	comunicazioni
Sieg	vincere
primär	primario
Krebs	cancro
Zahlen	numeri
Grund	ragionare
Werkzeug	strumento
Frühling	primavera
Stiftung	fondazione
Antworten	risposta
Stimme	voce
Zeitplan	programma
Unterlagen	documenti
Zweck	scopo
Feature	caratteristica
Bett	letto
kommt	viene
Polizei	polizia
unabhängig	indipendente
Ansatz	approccio
braun	Marrone
physikalisch	fisico
Hügel	collina
Karten	mappe
halt	tenere
Bewertungen	giudizi
glücklich	contento
Schmied	fabbro
entwickelt	sviluppato
danken	grazie
sicher	sicuro
einzigartig	unico
Umfrage	sondaggio
vor	precedente
Telefon	telefono
Sport	sport
bereit	pronto
Tier	animale
Quellen	fonti
Population	popolazione
pa	papà
regulär	regolare
sichern	sicuro
Geschäftstätigkeit	operazioni
einfach	semplicemente
Beweis	prova
Bahnhof	stazione
verstehen	capire
Möglichkeit	opzione
Tal	valle
wahrscheinlich	probabilmente
Meer	mare
Publikationen	pubblicazioni
verbessern	Migliorare
Verbindung	connessione
Herausgeber	editore
Halle	sala
Anti	anti
Netzwerke	reti
Erde	terra
Eltern	genitori
Auswirkung	urto
Transfer	trasferimento
Einführung	introduzione
Küche	cucina
stark	forte
Hochzeit	nozze
Eigenschaften	proprietà
Krankenhaus	ospedale
Boden	terra
Schiff	nave
Unterkunft	alloggio
Krankheit	malattia
Ausgezeichnet	eccellente
perfekt	perfezionare
Haar	capelli
Gelegenheit	opportunità
Ausrüstung	kit
klassisch	classico
Basis	base
Befehl	comando
Städte	città
ausdrücken	esprimere
vergeben	premio
Entfernung	distanza
Baum	albero
Bewertung	valutazione
Mauer	parete
beteiligt	coinvolti
el	EL
extra	extra
insbesondere	particolarmente
Budget	bilancio
Führungen	guide
Erfolg	successo
maximal	massimo
ma	mamma
Betrieb	operazione
bestehende	esistente
ganz	abbastanza
ausgewählt	selezionato
Junge	ragazzo
Restaurants	ristoranti
schön	bellissimo
Warnung	avvertimento
Standorte	posizioni
Pferd	cavallo
Abstimmung	votazione
Blumen	fiori
Sterne	stelle
Listen	liste
Inhaber	proprietario
Tiere	animali
Wege	modi
Sohn	figlio
Bereitstellen	fornitura
Regel	regola
Gehäuse	alloggiamento
nimmt	prende
bringen	portare
Katalog	Catalogare
max	max
Mutter	madre
Behörde	autorità
erzählte	detto
Programm	programma
beigetreten	Iscritto
Eingang	ingresso
Strategie	strategia
Füße	piedi
Agent	agente
gültig	valido
modern	moderno
Senior	anziano
sexy	sexy
Lehren	insegnamento
Tür	porta
großartig	grande
Versuch	prova
Einheiten	unità
cool	freddo
normal	normale
Unternehmen	impresa
Schiffe	navi
ganz	intero
positiv	positivo
Fitness	fitness
Chinesisch	Cinese
Meinung	opinione
Fußball	calcio
abstrakt	astratto
Ausgabe	produzione
Mittel	fondi
Herr	Sig
wahrscheinlich	probabile
entwickeln	sviluppare
Künstler	artisti
Alternative	alternativa
Verantwortung	responsabilità
Java	Giava
Gast	ospite
Veröffentlichung	pubblicazione
bestehen	passaggio
Verhältnis	relazioni
Vertrauen	fiducia
Transporter	furgone
enthält	contiene
Mehr	Multi
Republik	repubblica
Gebühren	tasse
Komponenten	componenti
Ferien	vacanza
Jahrhundert	secolo
akademisch	accademico
Hilfe	assistenza
abgeschlossen	completato
Haut	pelle
Grafik	grafica
indisch	indiano
Ring	squillare
Klasse	grado
Berg	montagna
Organisationen	organizzazioni
Filter	filtro
Platte	pannello
Fußboden	pavimento
Kauf	acquisto
Spiel	incontro
vorgeschlagen	proposto
benötigen	richiedere
Jungen	ragazzi
Morgen	mattina
erlaubt	consente
Eiweiß	proteina
Pflanze	pianta
berichtet	segnalati
schlagen	colpire
Millimeter	mm
Schwimmbad	piscina
Mini	mini
Politik	politica
Partner	compagno
Autoren	autori
Bretter	tavole
Fisch	pesce
Mitgliedschaft	membri
Mission	missione
Auge	occhio
Schnur	stringa
Sinn	senso
geändert	modificata
freigegeben	rilasciato
Bühne	palcoscenico
intern	interno
geboren	Nato
ausführlich	dettagliato
japanisch	giapponese
Rennen	gara
genehmigt	approvato
Ziel	bersaglio
außer	tranne
Charakter	carattere
Instandhaltung	Manutenzione
Fähigkeit	capacità
ed	Ed
vergewaltigen	stupro
Batterie	batteria
Jugend	gioventù
Druck	pressione
eingereicht	presentata
Schuld	debito
Mittel	medio
Fernsehen	televisione
interessiert	interessato
Ader	nucleo
Unterbrechung	rompere
Zwecke	scopi
Sets	imposta
tanzen	danza
Holz	legna
definiert	definito
Papiere	documenti
Auszeichnungen	premi
Gebühr	tassa
Studio	studio
Leser	lettore
Gerät	dispositivo
etabliert	stabilito
Antworten	risposte
Miete	affitto
las	las
dunkel	buio
extern	esterno
Apfel	Mela
le	Le
Anleitung	Istruzioni
Mindest	min
angeboten	offerta
Theorie	teoria
Löschen	rimuovere
Hilfe	aiuto
visuell	visivo
Gastgeber	ospite
Vielfalt	varietà
Lehrer	insegnanti
Handbuch	Manuale
Block	bloccare
Fächer	soggetti
Mittel	agenti
Reparatur	riparazione
Messe	giusto
stehlen	acciaio
Verstehen	comprensione
Lieder	canzoni
Fest	fisso
falsch	sbagliato
Anfang	inizio
Hände	mani
az	az
Paris	Parigi
wird	prende
Sektor	settore
Kapazität	capacità
un	un
Fett	Grasso
Vater	padre
elektrisch	elettrico
sah	sega
Instrumente	strumenti
Offizier	ufficiale
Treiber	autista
Unternehmen	aziende
tot	morto
unbekannte	sconosciuto
Restaurant	ristorante
Mike	Mike
Ausflug	viaggio
mi	mi
Arm	povero
Beziehung	relazione
Arbeitskräfte	lavoratori
Frieden	pace
traditionell	tradizionale
zeigt	mostrando
kreativ	creativo
Küste	costa
Vorteil	vantaggio
Finanzierung	finanziamento
Geräte	dispositivi
Herr	signore
gewähren	concedere
Unter	sub
Fiktion	finzione
Uhren	orologi
Karriere	carriere
geht	va
LED	guidato
Museum	Museo
Ventilator	fan
Transport	trasporto
interessant	interessante
Blogs	blog
Auswertung	valutazione
ehemalige	ex
Zone	zona
Komplex	complesso
th	esimo
Katze	gatto
sterben	morire
vorgeführt	presentata
eben	piatto
fließen	flusso
Agenturen	agenzie
Literatur	letteratura
Elternteil	genitore
Rahmen	ambientazione
DR	dr
Rahmen	scala
Wirtschaft	economia
hilfreich	utile
monatlich	mensile
kritisch	critico
Rahmen	telaio
Musical	musicale
Definition	definizione
Sekretär	segretario
Pfad	sentiero
Chef	capo
gibt	dà
Pakete	Pacchetti
Detail	dettaglio
Gesetze	legislazione
geändert	cambiato
Start	inizio
königlich	reale
reinigen	pulito
Kerl	tipo
Titel	titoli
relevant	pertinente
Gerechtigkeit	giustizia
verbinden	Collegare
Tasse	tazza
Korb	cestino
angewandt	applicato
wöchentlich	settimanalmente
vol	vol
Installation	installazione
pp	pp
Beachtung	Attenzione
vorrücken	avanzare
überspringen	Salta
Diät	dieta
Armee	esercito
Ausrüstung	Ingranaggio
Unterschied	differenza
dürfen	permesso
richtig	corretta
Nation	nazione
Verkauf	vendita
viele	molte
Stück	pezzo
Blatt	foglio
Feste	azienda
Sieben	Sette
Elemente	elementi
Spezies	specie
springen	saltare
Zellen	cellule
Modul	modulo
Urlaubsort	ricorrere
Zertifikat	certificato
Minister	ministro
Bewegung	movimento
Mode	moda
Richtungen	indicazioni
Besucher	visitatori
Dokumentation	documentazione
Handel	commercio
Wald	foresta
Anrufe	chiamate
Berichterstattung	copertura
Paar	coppia
Angabe	dando
Chance	opportunità
Vision	visione
Ball	palla
Ende	fine
Kunden	clienti
Aktionen	Azioni
diskutieren	discutere
Tor	obbiettivo
erfolgreich	riuscito
verkauft	venduto
Wind	vento
Gemeinden	comunità
klinisch	clinico
Lage	situazione
Märkte	mercati
Verlagswesen	editoriale
erscheinen	apparire
Entwicklung	sviluppando
Leben	vite
bestimmen	determinare
Temperatur	temperatura
Ankündigungen	annunci
geduldig	paziente
tatsächlich	effettivo
historisch	storico
Stein	pietra
Bob	peso
Handel	commercio
Personen	persone
schwer	difficile
wissenschaftlich	scientifico
Satellit	satellitare
Tests	test
Dorf	villaggio
Konten	conti
Amateur	dilettante
Ex	ex
getroffen	incontrato
Schmerzen	dolore
Faktoren	fattori
Kaffee	caffè
Käufer	acquirente
Poster	manifesto
Kante	bordo
funktional	funzionale
Wurzel	radice
fi	fi
geschlossen	chiuso
Ferien	vacanze
Rosa	rosa
Balance	equilibrio
Überwachung	monitoraggio
Antworten	risposte
Schuss	tiro
Initiale	iniziale
Etikette	etichetta
Sekunde	secondo
Kanon	canone
Liga	lega
Abfall	rifiuto
Minute	minuto
Bus	autobus
Anbieter	fornitore
Wörterbuch	dizionario
Buchhaltung	contabilità
Herstellung	produzione
Abschnitte	sezioni
Stuhl	sedia
Anstrengung	sforzo
Phase	fase
Fantasie	fantasia
po	Po
va	va
Professor	Professore
Installieren	installare
Hemd	camicia
Kleider	abbigliamento
Fuß	piede
Brust	Seno
Techniken	tecniche
Dollar	dollari
Religion	religione
Genehmigung	autorizzazione
wild	selvaggio
Generation	generazione
Fräulein	Perdere
chemisch	chimico
Arzt	medico
Aufgabe	compito
reduzieren	ridurre
gebracht	portato
Übung	esercizio
Fehler	insetto
Garantie	garanzia
Führer	capo
se	SE
Prozesse	processi
weich	morbido
Treffen	incontri
Sekunden	secondi
Flug	volo
Kongress	congresso
Treibstoff	carburante
gehen	camminare
hergestellt	prodotta
Heilige	santo
Streit	discussione
Wettbewerb	concorrenza
Drogen	farmaci
Joint	comune
Prämie	premio
frisch	fresco
Figuren	personaggi
Rechtsanwalt	procuratore
di	di
Faktor	fattore
tausende	migliaia
km	km
Strom	ruscello
Wohnungen	appartamenti
pflücken	raccogliere
Hören	udito
östlich	orientale
Therapie	terapia
Einträge	inserimenti
unterzeichnet	firmato
administrativ	amministrativo
ernst	grave
Grenze	limite
Schritte	passaggi
Geschäfte	negozi
Knechtschaft	servitù
del	del
Anstrengungen	sforzi
informiert	informato
ga	ga
Gedanken	pensieri
Bach	torrente
ft	ft
Menge	quantità
wesentlich	essenziale
Touren	tour
Belastung	caricare
sofort	subito
Maschinen	macchine
vorgesehen	designato
schwer	pesante
bedeckt	coperto
Wiederherstellung	recupero
integriert	integrato
Aufbau	configurazione
Schwanz	cazzo
Händler	mercante
umfassend	globale
Experte	esperto
schützen	proteggere
solide	solido
Präsentation	presentazione
wurde	divenne
Orange	arancia
Beachtung	conformità
Thema	tema
Reich	ricco
Kampagne	campagna
vs	vs
Gitarre	chitarra
finden	scoperta
Beispiele	esempi
Geist	spirito
ar	ar
Ansprüche	reclami
Annahme	accettazione
Strategien	strategie
mo	momento
Angelegenheiten	affari
beabsichtigt	destinato
sa	sa
Tore	obiettivi
mieten	assumere
Wahl	elezione
vorschlagen	suggerire
Ast	ramo
Dienen	servire
Mitgliedsorganisationen	affiliati
montieren	montare
Latein	latino
Multimedia	multimedia
verwalten	gestire
Ecke	angolo
Rang	rango
Element	elemento
Geburt	nascita
Virus	virus
interaktiv	interattivo
Anfragen	richieste
trennen	separato
Quartal	trimestre
Verfahren	procedura
Führung	comando
definieren	definire
religiös	religioso
Fakten	fatti
Frühstück	colazione
Säule	colonna
Glauben	fede
Kette	catena
identifizieren	identificare
Avenue	viale
fehlt	mancante
Empfehlungen	raccomandazioni
gerührt	mosso
erreichen	raggiungere
Vergleich	confronto
Moment	momento
verlängert	esteso
Sequenz	sequenza
Zoll	pollice
Attacke	attacco
Zentren	centri
Öffnung	apertura
Labor	laboratorio
Reservieren	Riserva
Gamma	gamma
produzieren	produrre
Wahrheit	verità
Zähler	contatore
Fehler	fallimento
folgt	segue
Dollar	dollaro
Lager	campo
die	des
Filme	cinema
Brücke	ponte
füllen	riempire
Bewegung	movimento
Drucken	stampa
Entwurf	bozza
Diagramm	grafico
gespielt	giocato
Kontakte	contatti
Leser	lettori
Clubs	club
wa	wa
Abenteuer	avventura
Opfer	offerta
profitieren	profitto
Führung	capi
Poster	manifesti
Institutionen	istituzioni
Assistent	assistente
Variable	variabile
dj	dj
Parken	parcheggio
gestern	ieri
entschlossen	determinato
Werkstatt	laboratorio
Weg	andato
Codes	codici
Arten	tipi
Erweiterung	estensione
Aussagen	dichiarazioni
vollständig	completamente
Mannschaften	squadre
Fort	forte
cm	centimetro
Senat	senato
komisch	divertente
Gen	gene
gedreht	trasformato
Scheibe	disco
Muster	modello
Boot	barca
Theater	Teatro
Hersteller	produttori
Sponsor	sponsor
klassisch	classico
Symbol	icona
Garantie	garanzia
gewidmet	dedito
Richtung	direzione
Basketball	pallacanestro
Objekte	oggetti
löschen	Elimina
Abend	sera
Versammlung	montaggio
nuklear	nucleare
Maus	topo
Signal	segnale
Verbrecher	penale
ausgegeben	rilasciato
mächtig	potente
Traum	sognare
FALSCH	FALSE
da	da
Besetzung	lanciare
Blume	fiore
Personal	personale
bestanden	passato
geliefert	fornito
Stürze	cascate
Seele	anima
fördern	promuovere
angegeben	dichiarato
Statistiken	statistiche
Profis	professionisti
erscheint	appare
tragen	trasportare
Flagge	bandiera
Abdeckungen	coperture
em	em
Vorteil	vantaggio
Hallo	Ciao
Design	disegni
pflegen	mantenere
Tourismus	turismo
Priorität	priorità
Erwachsene	adulti
Grafik	grafico
Atom	atomo
Zahlungen	pagamenti
Bindung	rilegatura
kurz	breve
beendet	conclusa
gewinnt	vincente
anonym	anonimo
Skript	copione
serviert	servito
will	vuole
bereit	preparato
Leere	vuoto
Etikett	etichetta
Interview	colloquio
mischen	mescolare
Rahmen	struttura
Scheibe	disco
Eingerichtet	installato
Königin	Regina
Kredite	crediti
deutlich	chiaramente
Fix	fissare
Griff	maniglia
Süss	dolce
Kriterien	criteri
assoziieren	socio
ne	NE
Verhalten	comportamento
vergrößern	Ingrandire
Strahl	raggio
Einnahmen	reddito
messen	misurare
Stimmen	voti
du	du
Pflicht	dovere
Diskussionen	discussioni
Bär	orso
gewinnen	guadagno
Festival	Festival
Labor	laboratorio
Ozean	oceano
Flüge	voli
Fachwelt	esperti
Zeichen	segni
Tiefe	profondità
Zug	treno
trocken	asciutto
erkunden	Esplorare
Spa	terme
Konzept	concetto
fast	quasi
Handhabung	maneggio
Ursprung	origine
Milliarde	miliardo
Intelligenz	intelligenza
gekauft	comprato
con	contro
Nationen	nazioni
Route	itinerario
gebrochen	rotto
Schlacht	battaglia
sprechen	parlare
Protokoll	protocollo
Abfrage	domanda
Partnerschaft	associazione
Ausdruck	espressione
es	es
Rede	discorso
Draht	filo
Vorschläge	suggerimenti
Ersatz	sostituzione
Band	nastro
strategisch	strategico
Richter	giudice
Acid	acido
Bytes	byte
Cent	centesimo
gezwungen	costretto
kompatibel	compatibile
Wohnung	appartamento
Null	nullo
Null	zero
Redner	altoparlante
Beratung	consulenza
Konstrukteur	progettista
pr	pr
Ehe	matrimonio
rollen	rotolo
Banken	banche
fr	fr
Teilnehmer	partecipanti
Geheimnis	segreto
Negativ	negativo
Favoriten	preferiti
Theater	Teatro
Federung	molle
var	var
ausführen	eseguire
Übersetzung	traduzione
Schätzungen	stime
Verletzung	ferita
Ministerium	ministero
Treiber	driver
Anwalt	avvocato
Figuren	figure
geschützt	protetta
Vorschlag	proposta
teilen	compartecipazione
Portal	portale
Beta	beta
gratis	gratis
zu	verso
leicht	leggermente
helfen	assistere
Verhalten	condotta
enthalten	contenuta
Gesetzgebung	legislazione
Berufung	chiamata
Parameter	parametri
Profile	profili
Angelegenheiten	questioni
Häuser	case
Steuerung	controlli
kombiniert	combinato
letzte	finale
Vertreter	rappresentante
geringer	minore
Abteilungen	dipartimenti
Bewohner	residenti
angezeigt	visualizzati
Mama	mamma
reduziert	ridotto
Selten	raro
durchgeführt	eseguita
extrem	estremo
Proben	campioni
Riegel	barre
Prognose	previsione
entfernt	rimosso
Zyklus	ciclo
enthalten	contenere
Richtigkeit	precisione
Schlaf	dormire
mg	mg
Vogel	uccello
Apotheke	farmacia
Schaffung	creazione
statisch	statico
Jäger	cacciatore
Adressen	indirizzi
Dame	signora
Kristall	cristallo
berühmt	famoso
Schriftsteller	scrittore
Vorsitzende	presidente
Getränk	bere
Akademie	accademia
dynamisch	dinamico
Essen	mangiare
permanent	permanente
Reinigung	pulizia
bildet	costituisce
Mappe	portafoglio
praktisch	pratico
geliefert	consegnato
Infrastruktur	infrastruttura
Farbe	colore
Verkäufer	venditore
Philosophie	filosofia
Verordnung	regolamento
Offiziere	ufficiali
Ziel	scopo
Gebote	offerte
Ernährung	nutrizione
Aufzeichnung	registrazione
Junior	junior
les	les
Kap	mantellina
Ringe	anelli
Spitze	mancia
wunderbar	meraviglioso
Fahrkarte	biglietto
angekündigt	annunciato
vermuten	indovina
wem	chi
Fußball	calcio
Mathematik	matematica
einführen	importare
Entsendung	spedizione
Gegenwart	presenza
automatisch	automatico
Besichtigung	visualizzazione
gepflegt	mantenuto
CH	ch
Dan	dan
Hunde	cani
Direktoren	registi
Aspekte	aspetti
voraus	avanti
Mond	Luna
Beteiligung	partecipazione
planen	schema
Fliege	volare
Weise	maniera
Matrix	matrice
Kombination	combinazione
Änderung	emendamento
Stärke	forza
Truthahn	tacchino
Bibliotheken	librerie
richtig	corretto
Grad	gradi
Unternehmen	aziende
Delta	delta
Angst	paura
suche	cerca
Zoll	pollici
Konvention	convenzione
Anteile	azioni
Schulleiter	principale
Komfort	comfort
Farben	colori
Kriege	guerre
Bestellung	ordinazione
gehalten	tenuto
Alpha	alfa
Beschwerde	appello
Kreuzfahrt	crociera
Bonus	indennità
Hallo	Hey
Gebäude	edifici
Angebote	Speciali
schlagen	battere
Batterien	batterie
wird	diventa
fährt	unità
Waffen	braccia
Tee	tè
verbessert	migliorata
leisten	raggiungere
Positionen	posizioni
Kleid	vestito
Abonnement	sottoscrizione
Händler	commerciante
zeitgenössisch	contemporaneo
Himmel	cielo
Rom	rom
getragen	trasportato
Exposition	esposizione
verbergen	nascondere
Unterschrift	firma
Müller	mugnaio
Bereitstellung	fornitura
Kleider	Abiti
Rahmen	montatura
bestimmt	certamente
Zeitung	giornale
Spielzeug	giocattolo
Schicht	strato
gedruckt	stampato
langsam	lento
Entfernung	rimozione
Haftung	responsabilità
Drucker	stampanti
Hinzufügen	aggiungendo
Stelle	individuare
verbringen	trascorrere
Fabrik	fabbrica
Innere	interno
wachsen	crescere
optisch	ottico
Beförderung	promozione
relativ	parente
tolle	Stupefacente
Punkt	punto
Identität	identità
Umwandlung	conversione
Gefühl	sensazione
versteckt	nascosto
angemessen	ragionevole
Revision	revisione
beeinflussen	influenza
Verhältnis	rapporto
Bedeutung	importanza
Regen	pioggia
Planet	pianeta
Kopien	copie
erlauben	permesso
Sehen	vedendo
Beweis	prova
Bass	basso
Rezept	prescrizione
leer	vuoto
Beispiel	esempio
Loch	buco
Reiten	cavalcata
Büro	ufficio
Erhaltung	conservazione
Paar	paio
Ideal	ideale
Brille	Specifiche
verzeichnet	registrato
Don	don
Stücke	pezzi
fertig	finito
Parks	parchi
Rechtsanwälte	avvocati
Stress	stress
Sahne	crema
ss	ss
läuft	piste
entdecken	scoprire
ap	ap
Muster	modelli
Hügel	colline
nm	nm
Berater	consulente
bewusst	consapevole
gestalten	forma
Evolution	Evoluzione
Zertifikate	certificati
Ziele	obiettivi
Stationen	stazioni
empfohlen	suggerito
op	operazione
Überreste	resti
Firmen	aziende
Euro	Euro
Operator	operatore
Strukturen	strutture
generisch	generico
Enzyklopädie	enciclopedia
Verwendung	uso
Tinte	inchiostro
gemischt	misto
Volkszählung	censimento
Rad	ruota
Lieferanten	fornitori
kompakt	compatto
Poesie	poesia
Beleuchtung	luci
Verfolgung	puntamento
Engel	angelo
Vorbereitung	preparazione
Versuch	tentativo
Empfang	ricevente
Streichhölzer	fiammiferi
Übereinstimmung	conformità
Breite	larghezza
Motoren	motori
vergessen	dimenticare
Feld	schieramento
diskutiert	discusso
genau	preciso
Klima	clima
griechisch	greco
Anweisung	istruzione
Verwaltung	gestione
roh	crudo
Unterschiede	differenze
erklären	spiegare
Gründen	stabilire
ausgedrückt	espresso
Umfang	estensione
Scharf	acuto
ben	Ben
Absatz	paragrafo
töten	uccidere
Mathematik	matematica
Vergütung	compensazione
Export	esportare
Manager	manager
Module	moduli
geführt	condotto
Versionen	versioni
weiß	conosce
beschreiben	descrivere
Bürger	cittadini
Erbe	eredità
Ärger	guaio
Trainer	allenatore
landwirtschaftlich	agricolo
erweitern	espandere
Publikum	pubblico
zugewiesen	assegnato
Sammlungen	collezioni
Ewigkeit	evo
Spezialist	specialista
Koch	cucinare
beeinflussen	influenzare
Jungfrau	vergine
erfahren	esperto
Ermittlung	indagine
angehoben	sollevato
Hut	cappello
Institution	istituzione
gerichtet	dirette
betroffen	influenzato
Fahrrad	bicicletta
total	totalmente
Teller	piatto
Kosten	spese
zeigen	indicare
blond	bionda
Verfahren	procedimento
Favorit	preferito
Eigenschaften	caratteristiche
der	der
verlieren	perdere
organisch	biologico
suchen	ricercare
Erfahrungen	esperienze
Alben	album
Verträge	contratti
Gäste	ospiti
Gastgeber	ospitato
Krankheiten	malattie
über	circa
äquivalent	equivalente
Chemie	chimica
Kits	kit
Logik	logica
Prinz	Principe
Kreis	cerchio
Boden	suolo
Psychologie	psicologia
nass	bagnato
Umstände	condizioni
Investor	investitore
elementar	elementare
Sponsoren	sponsor
Fuchs	Volpe
unbegrenzt	illimitato
reagieren	rispondere
Größen	dimensioni
einfach	pianura
Ausfahrt	Uscita
Arm	braccio
Schlüssel	chiavi
Welle	onda
heilig	santo
Handlungen	atti
Beratung	guida
Weg	pista
Symbol	simbolo
Autobahn	autostrada
beobachtete	osservata
Dean	decano
Konfiguration	impostare
Umfrage	sondaggio
Arten	stili
gefüllt	pieno
Bindung	legame
Kanäle	canali
Blinddarm	appendice
Schokolade	cioccolato
Portion	porzione
Umfang	scopo
Lieferant	fornitore
Kabel	cavi
Baumwolle	cotone
Anforderung	Requisiti
getötet	ucciso
Rand	confine
alt	antico
Debatte	discussione
Vertreter	rappresentanti
beginnt	inizia
Schwangerschaft	gravidanza
Sehenswürdigkeiten	attrazioni
gelernt	imparato
Transaktionen	transazioni
Forscher	esploratore
historisch	storico
Mann	marito
autorisiert	autorizzato
verrückt	pazzo
bevorstehende	imminente
Konzert	concerto
Partituren	punteggi
Wirksamkeit	efficienza
Komödie	commedia
angenommen	adottato
effizient	efficiente
linear	lineare
Engagement	impegno
Spezialität	specialità
Bären	orsi
hüpfen	luppolo
Träger	vettore
Konstante	costante
Visa	Visa
Mund	bocca
Meter	metro
verbunden	connesso
Interviews	interviste
Konzepte	concetti
Gewehr	pistola
reflektieren	riflettere
rein	puro
Hölle	inferno
Obst	frutta
beginnt	inizia
qualifiziert	qualificato
Reform	riforma
Linse	lente
behandelt	trattati
Entdeckung	scoperta
zeichnen	disegnare
klassifiziert	classificato
annehmen	assumere
Allianz	alleanza
bestätigen	Confermare
Ingenieur	ingegnere
konsistent	coerente
ersetzen	sostituire
Spielraum	autorizzazione
Konverter	convertitore
Organisation	organizzazione
Baby	bambino
Schecks	controlli
erreicht	raggiunto
Werden	diventando
Zielsetzung	obbiettivo
angezeigt	indicato
Zucker	zucchero
Crew	equipaggio
Beine	gambe
Stock	bastone
Beziehung	relazione
aktiviert	abilitato
Genre	genere
Freiwillige	volontario
Rückseite	posteriore
demokratisch	democratico
verbessern	accrescere
genau	esatto
gebunden	limite
Parameter	parametro
Prozessor	processore
Knoten	nodo
formal	formale
Sturm	tempesta
Mikro	micro
Hochschulen	collegi
Meile	miglio
Herausforderungen	sfide
Redakteure	redattori
höchste	supremo
Brüder	fratelli
Anerkennung	riconoscimento
ref	arbitro
schätzen	stima
Kind	ragazzo
Inspektion	ispezione
Verbraucher	consumatori
Grenzen	limiti
Gebiet	territorio
Bewaffnung	Armi
verzögern	ritardo
Pilot	pilota
Beiträge	contributi
kontinuierlich	continuo
Initiative	iniziativa
Roman	romanzo
Ausführung	esecuzione
Behinderung	invalidità
Ultra	ultra
Gewinner	vincitore
Folge	episodio
Töpfer	vasaio
Gericht	piatto
Theaterstücke	giochi
Bekanntmachung	bollettino
ia	ia
ändern	modificare
wirklich	veramente
Universum	universo
Kandidat	candidato
Slot	fessura
hervorragend	eccezionale
Ha	ah
geplant	pianificato
Hütte	casetta
Spiegel	specchio
Turnier	torneo
Berücksichtigung	considerazione
Sitzungen	sessioni
Kern	nocciolo
Käufer	acquirenti
Zeitschriften	riviste
grau	grigio
Katalog	Catalogare
berechnet	carico
breit	ampio
und	und
gewählt	scelto
Demo	dimostrazione
Hass	odiare
Terminal	terminale
Verlag	editori
Nächte	notti
Flüssigkeit	liquido
Reis	riso
Reservierung	prenotazione
Lebensmittel	Alimenti
bewachen	guardia
Einsparung	Salvataggio
Reich	impero
neu	recentemente
erziehen	aumentare
illegal	illegale
Erweiterung	espansione
Premier	premier
Morgen	Domani
Milch	latte
Theater	Dramma
Besuch	visitare
Wettbewerb	concorso
gesammelt	raccolto
Bands	bande
geeignet	adatto
absolut	assolutamente
Prüfung	revisione
Kammer	Camera
Guinea	Guinea
Ergebnisse	risultati
iso	iso
typisch	tipico
Summe	somma
Hähnchen	pollo
vorübergehend	temporaneo
besuchen	assistere
Dusche	doccia
Versendung	invio
ausreichend	sufficiente
Schale	conchiglia
Provinz	Provincia
katholisch	cattolico
Gouverneur	governatore
Bier	birra
Beitrag	contributo
Formel	formula
Verfassung	costituzione
Verpackung	confezione
zuverlässig	affidabile
Zweifel	dubbio
verdienen	guadagnare
Perioden	periodi
Anschläge	attacchi
Waren	merce
Symptome	sintomi
Denkmal	memoriale
Zwilling	gemello
einfügen	inserire
Tor	porta
Zeichnung	disegno
Kandidaten	candidati
bestellt	ordinato
biologisch	biologico
Kampf	combattente
Übergang	transizione
Vorlieben	preferenze
Spion	spiare
Romantik	romanza
Instrument	strumento
Teilt	Diviso
Themen	temi
Befugnisse	potenze
Himmel	Paradiso
Bits	bit
schwanger	incinta
Einstufung	classificazione
konzentriert	focalizzata
Arzt	medico
fragen	chiede
Blöcke	blocchi
lo	Lo
geistig	spirituale
Diabetes	diabete
ml	ml
Verschiebung	cambio
sitzen	sedersi
Körper	corpi
Fotos	fotografie
Schneiden	taglio
Schriftsteller	scrittori
flexibel	flessibile
liebte	amato
Favoriten	preferiti
Kartierung	Mappatura
zahlreich	numerose
verhältnismäßig	relativamente
repräsentiert	rappresenta
überlegen	superiore
bevorzugt	preferito
Gerettet	salvato
intellektuelle	intellettuale
gewährt	concesso
Kohlenstoff	carbonio
gemütlich	confortevole
magnetisch	magnetico
Interaktion	interazione
Hören	ascoltando
Krise	crisi
Ausblick	prospettiva
massiv	massiccio
hell	luminosa
gebildet	formato
Klavier	pianoforte
Echo	eco
Revolution	rivoluzione
Displays	visualizza
Plasma	plasma
Verdienste	guadagni
Geheimnis	mistero
Landschaft	paesaggio
mechanisch	meccanico
Reise	viaggio
Banner	bandiera
Feige	Figura
Grafschaften	contee
Erwerb	acquisizione
anerkannt	riconosciuto
Träume	sogni
Benachrichtigung	notifica
kg	kg
lehren	insegnare
schnell	rapido
ziehen	Tirare
ut	ut
Seminar	seminario
Investitionen	investimenti
Räder	ruote
angeben	specificare
empfindlich	sensibile
Vorlagen	modelli
Formate	formati
hält	detiene
Router	router
Beton	calcestruzzo
si	SI
Mappe	cartella
Fertigstellung	completamento
Impuls	impulso
Technik	tecnica
Wählen	voto
Justiz	tribunali
umgewandelt	convertito
Metro	Metro
Jahrestag	anniversario
Verbesserungen	miglioramenti
Streifen	striscia
Spezifikation	specificazione
Unfall	incidente
Kerbe	tacca
zugänglich	accessibile
Bewohner	residente
Handlung	tracciare
typisch	tipicamente
Darstellung	rappresentazione
Pumpe	pompa
existiert	esiste
Vereinbarungen	accordi
Konferenzen	conferenze
Verbrauch	consumo
eng	stretto
Bedrohung	minaccia
Umfragen	sondaggi
Sitzung	seduta
Berater	consulente
Regler	controllore
Ausschüsse	comitati
Penis	pene
Schloss	castello
Gardens	giardini
Etiketten	etichette
bereit	disposto
bio	bio
Schauspielkunst	recitazione
Köpfe	teste
Prüfung	esame
Residenz	residenza
Dichte	densità
hundert	centinaio
seltsam	strano
nachhaltig	sostenibile
statistisch	statistico
erwähnen	citare
Innovation	innovazione
grau	grigio
parallel	parallelo
arbeiten	operare
Banknoten	fatture
stabil	stabile
Definitionen	definizioni
von	von
Ärzte	medici
Lektion	lezione
Kino	cinema
Wahlen	elezioni
Reaktion	reazione
leer	vuoto
verbessert	migliorata
berechtigt	intitolato
schwer	grave
generieren	creare
Zeitungen	giornali
Krankenhäuser	ospedali
vi	VI
Humor	umorismo
alt	anziano
Monitore	monitor
Ausnahme	eccezione
Dauer	durata
Masse	massa
Besuche	visite
Fähigkeiten	capacità
Empfehlung	raccomandazione
Sünde	peccato
organisiert	organizzato
ba	ba
para	parà
Annahme	adozione
Verbesserung	miglioramento
teuer	costoso
Büffel	bufalo
Organisationen	organizzazioni
Ebene	aereo
Programme	programmi
Mechanismus	meccanismo
ee	EE
markiert	segnato
Gefahren	guidato
Flasche	bottiglia
innovativ	innovativo
Massage	massaggio
Fazit	conclusione
Schließen	chiusura
tausend	mille
Legende	leggenda
Villa	villa
Knochen	osso
Säulen	colonne
Störungen	disturbi
Zusammenarbeit	collaborazione
Entdeckung	rivelazione
innere	interno
Formation	formazione
med	med
Ingenieure	ingegneri
Entität	entità
Kreuzfahrten	crociere
Tor	cancello
römisch	romano
Aufgaben	doveri
erotisch	erotico
Ton	tono
Ethik	etica
Drachen	Drago
beschäftigt	occupato
Kapitän	Capitano
bringt	porta
Heizung	riscaldamento
Bein	gamba
Hals	collo
Flügel	ala
Skripte	script
ABC	abc
ernannt	designato
Behandlung	rapporti
verpflichten	commettere
Schiene	rotaia
Reisen	viaggi
Spalt	divario
Seiten	lati
Tube	tubo
dazugehörigen	corrispondente
Beschreibungen	descrizioni
Gürtel	cintura
Jacke	giacca
Animation	animazione
Orakel	oracolo
er	er
Produktionen	produzioni
Luftfahrt	aviazione
stolz	orgoglioso
Katastrophe	disastro
Konsole	consolle
Befehle	comandi
jr	jr
Telekommunikation	telecomunicazioni
Lehrer	istruttore
Riese	gigante
erreicht	raggiunto
Verletzungen	lesioni
Ansätze	approcci
gewöhnlich	solito
Briefmarken	francobolli
Winkel	angolo
rauben	rapinare
Designer	progettisti
Freiheit	libertà
Epoche	era
Konvertieren	convertire
Möglichkeit	possibilità
Analytiker	analista
gefährlich	pericoloso
Zuverlässigkeit	affidabilità
beziehungsweise	rispettivamente
Freiwillige	volontari
abgeleiteten	derivato
Vergnügen	piacere
Ehre	onore
orientiert	orientata
Adler	aquila
Gebet	preghiera
Workshops	workshop
Hurrikan	uragano
ruhig	silenzioso
Hersteller	produttore
repräsentiert	rappresentato
Verantwortlichkeiten	responsabilità
Käse	formaggio
vorsichtig	accuratamente
Produktivität	produttività
Krone	corona
Par	par
Diagnose	diagnosi
Hersteller	creatore
Riss	crepa
Prinzip	principio
Picks	picconi
Gang	banda
Fetisch	feticcio
Aussehen	aspetto
Rauch	Fumo
Filter	filtri
inkorporiert	incorporato
Kunst	mestiere
Gefährte	compagno
blind	cieco
Salon	sala
wütend	pazzo
Algorithmus	algoritmo
stark	fortemente
Cafe	bar
ken	comprensione
Proteine	proteine
su	su
familiär	familiare
fähig	capace
Eintritt	ammissione
Schuh	scarpa
gewählt	eletto
Tragen	portando
Terrorismus	terrorismo
Freude	gioia
Ausgaben	edizioni
ethnisch	etnico
Parlament	parlamento
Darsteller	attore
Funde	reperti
Dichtung	foca
Situationen	situazioni
fünfte	quinto
Bürger	cittadino
vertikal	verticale
Korrekturen	correzioni
beschreibt	descrive
Behinderungen	disabilità
Substanz	sostanza
verboten	proibito
Rohr	tubo
Soldaten	soldati
Wächter	custode
Vorlesung	conferenza
Simulation	simulazione
Layout	disposizione
Initiativen	iniziative
krank	malato
Konzentration	concentrazione
legen	posare
Deutung	interpretazione
dreckig	sporco
unterrichtet	insegnato
Arbeitnehmer	lavoratore
Optimierung	ottimizzazione
Tempel	tempio
Substanzen	sostanze
beweisen	dimostrare
entdeckt	scoperto
Flügel	Ali
genetisch	genetico
Beschränkungen	restrizioni
dünn	magro
Ausstellung	esposizione
Grat	cresta
Modem	modem
bringen	portando
krank	malato
bewerten	valutare
tropisch	tropicale
sammeln	raccogliere
Vektor	vettore
bestimmt	decisamente
Drehung	svolta
Existenz	esistenza
Kommentar	commento
Entwicklungen	sviluppi
Einwanderung	immigrazione
Reiseziele	destinazioni
gegenseitig	reciproco
Syntax	sintassi
li	Li
Attribut	attributo
Gefängnis	prigione
Fertigkeit	abilità
Stühle	sedie
Umgebung	circostante
Berge	montagne
Popularität	popolarità
Anfrage	inchiesta
geprüft	verificato
Ausstellungsstück	mostra
werfen	gettare
Trend	tendenza
Katzen	gatti
Wüste	deserto
ya	ya
Koordinator	coordinatore
Quecksilber	mercurio
Verbrennung	ardente
Flucht	fuga
Empfänger	ricevitore
progressiv	progressivo
Boote	Barche
Meisterschaft	campionato
Arkade	portico
unmöglich	impossibile
erzählt	dice
offensichtlich	evidente
Depression	depressione
Graph	grafico
Abdeckung	copertura
Platin	platino
Beurteilung	giudizio
Gespräche	trattativa
Einreichung	limatura
fördern	adottivo
ausgezeichnet	premiato
Versuche	prove
Meister	maestri
Patrone	cartuccia
Erläuterung	spiegazione
org	org
Betrug	frode
Elektrizität	elettricità
Spektrum	spettro
Ankunft	arrivo
Keramik	ceramica
Betonung	enfasi
genial	eccezionale
Bestätigt	confermato
zählt	conta
Absturz	schianto
Aufzug	sollevamento
inter	Inter
Höhen	altezza
Schatten	ombra
Ausgabe	spese
wagen	avventurarsi
Klinik	clinica
Heilung	guarigione
Prinzessin	Principessa
Eingeben	entrare
Paket	pacchetto
Studios	studios
Beteiligung	coinvolgimento
Papa	papà
Tasten	pulsanti
Platzierung	posizionamento
Beobachtungen	osservazioni
Gewinner	vincitori
Straßen	strade
anschließend	successivo
Garten	cortile
Bekanntgabe	rivelazione
Einrichtung	istituzione
Erinnerungen	ricordi
te	TE
schafft	crea
Gesichter	facce
Tourist	turista
Mord	omicidio
angemessene	adeguato
Senator	senatore
Präsentationen	presentazioni
verdauen	digerire
Staub	polvere
Wiki	wiki
ersetzt	sostituito
Radar	radar
Verluste	perdite
Kampf	combattere
Reduzierung	riducendo
gestoppt	fermato
Besetzung	occupazione
eng	strettamente
Strahlung	radiazione
Könige	re
Schießen	tiro
Ohr	orecchio
Flaggen	bandiere
Bäcker	panettiere
konservativ	prudente
Schock	shock
Wirksamkeit	efficacia
Krawatte	cravatta
Dach	tetto
zeigen	dimostrare
Atmosphäre	atmosfera
Kuss	bacio
Tier	bestia
ra	RA
betrieben	operato
Experiment	sperimentare
Ziele	obiettivi
Einkäufe	acquisti
Föderation	federazione
Pizza	Pizza
eingeladen	invitato
Zuordnung	assegnazione
modern	mod
Abfragen	interrogazioni
Abwesenheit	assenza
Anbieter	fornitori
Yoga	yoga
dient	servi
Überraschung	sorpresa
Lampe	lampada
Witze	scherzi
Beratung	consulenza
Palast	palazzo
zufrieden	soddisfatto
Gewinnt	vittorie
Warenhaus	magazzino
soll	ipotetico
gewöhnliche	ordinario
Geist	fantasma
Verstoß	violazione
Boss	capo
Stolz	orgoglio
Erwartungen	aspettative
Unabhängigkeit	indipendenza
wissend	sapendo
Reporter	reporter
Stoffwechsel	metabolismo
Champion	campione
persönlich	personalmente
reichlich	abbondanza
Solo	assolo
Kehle	gola
Reichtum	ricchezza
Vakuum	vuoto
Tanzen	danza
erkenne	riconoscere
schreibt	scrive
Piazza	plaza
Suche	ricerca
veröffentlichen	pubblicare
Abschirmung	selezione
trans	trans
Pionier	pioniere
Vergessene	dimenticato
Akrobat	acrobata
Platten	piatti
Aufsätze	saggi
Verhalten	comportamento
erzählen	raccontare
ziemlich	abbastanza
intelligent	intelligente
Modi	modalità
Verpflichtung	obbligo
Hafen	porto
Reisende	viaggiatore
Segment	segmento
Feind	nemico
Puzzle	puzzle
Brunnen	pozzi
beschränkt	limitato
Republikaner	repubblicano
Geheimnisse	segreti
Syndrom	sindrome
Teilnahme	partecipazione
Elfmeter	pena
Trommel	tamburo
ermöglicht	Abilita
Baumeister	costruttore
Aussicht	vista
Flut	alluvione
Leichtigkeit	alleviare
Argumente	argomenti
Arena	arena
Abenteuer	avventure
Schüler	allievi
Ankündigung	annuncio
Ergebnis	risultato
schätzen	apprezzare
ergänzt	allargato
gewachsen	cresciuto
schön	bello
Zentren	centri
Klausel	clausola
Lächeln	Sorriso
Länder	terre
Truppen	truppe
bewaffnet	armato
Kiefer	pino
Kühlung	raffreddamento
Golf	golfo
LKW	camion
Mechanismen	meccanismi
Scheidung	divorzio
Tradition	tradizione
Pillen	pillole
Tiger	tigre
Leute	gente
Sensor	sensore
ausgesetzt	esposto
Jagd	caccia
Engel	angeli
Stellvertreter	vice
thailändisch	tailandese
Emissionen	emissioni
Ärzte	medici
Beschwerde	denuncia
Szenen	scene
Experimente	esperimenti
Auftrieb	Incremento
Führung	governo
Mühle	mulino
Gegründet	fondato
chronisch	cronico
Höhle	tana
Finger	dito
hält	mantiene
Pfund	libbra
Lokalisieren	individuare
pl	pl
trainiert	allenato
Umsetzung	attuazione
Brot	pane
Motoren	motori
zäh	difficile
Vorfall	incidente
Dynamik	dinamica
Lüge	menzogna
Konversation	conversazione
verringern	diminuire
Anbetung	culto
Fähigkeit	capacità
ak	ak
Präzision	precisione
Schadenersatz	danni
Reserve	riserve
lösen	risolvere
Minderheit	minoranza
vielfältig	diverso
Zutaten	ingredienti
Ah	ah
Töne	toni
Rehabilitation	reinserimento
Sicht	vista
Lehm	argilla
schwach	debole
geteilt	diviso
Rezeption	ricezione
weise	saggio
Chancen	probabilità
Seminare	seminari
Folgen	conseguenze
Entscheidungsträger	maker
Erdkunde	geografia
Integrität	integrità
Erbe	eredità
zufrieden	contento
Achtung	Pericolo
Vitamin	vitamina
verarbeitet	trasformati
Phrase	frase
erziehen	raccolta
Auswirkungen	implicazioni
Funktionalität	funzionalità
Paradies	Paradiso
hybrid	ibrido
liest	legge
emotional	emotivo
Ruhm	gloria
ja	ja
geographisch	geografico
überschreiten	superare
Stange	asta
Seide	seta
Babys	bambini
Bi	bi
romantisch	romantico
aufgedeckt	rivelato
Spezialisten	specialisti
Generator	Generatore
Suspension	sospensione
traurig	triste
Korrektur	correzione
Wolf	lupo
langsam	lentamente
Ergänzung	supplemento
Teile	porzioni
Säugling	infantile
Branchen	settori
Flüssigkeit	fluido
Begründung	motivo
Mahlzeit	pasto
ta	ta
Maschinen	macchinario
Gleichung	equazione
Körbe	cesti
Wahrscheinlichkeit	probabilità
Abmessungen	dimensione
studierte	studiato
Gewinne	profitti
Teufel	diavolo
Gras	erba
illustriert	illustrato
Kirsche	ciliegia
kontinental	continentale
Leistung	realizzazione
Einschränkungen	limitazioni
Beerdigung	funerale
Kapitel	capitoli
Passagier	passeggeri
praktisch	conveniente
Mars	Marte
Größe	dimensioni
Ei	uovo
Signale	segnali
Orientierung	orientamento
Diebstahl	furto
Kindheit	infanzia
Symbole	simboli
lat	lat
Meta	meta
Analog	analogico
Talent	talento
datiert	datato
Weisheit	saggezza
Grenze	confine
Elite	elite
gi	gi
glaubt	crede
Gedichte	poesie
Zuständigkeit	Giurisdizione
Roboter	robot
Anzeige	visualizzazione
Zeuge	testimone
ausgestattet	fornito
Stufen	stadi
sur	sur
erworben	acquisita
beurteilen	valutare
waschen	lavaggio
Eingang	Ingresso
Erklärung	dichiarazione
verlieren	perdere
Versuche	tentativi
edel	nobile
Automatisierung	automazione
Auswirkungen	impatti
Umdrehung	rev
Vorteile	vantaggi
Ritter	cavaliere
Ziele	obiettivi
Erweiterungen	estensioni
Einsprüche	appelli
Krankheit	malattia
ho	Ho
Alternativen	alternative
Sch	sh
Seife	sapone
Marmelade	marmellata
ungewöhnlich	insolito
antwortete	risponde
Zerstörung	distruzione
Migration	migrazione
Störung	disturbo
konventionell	convenzionale
tragen	indossare
Achse	asse
gesucht	ricercato
Gene	geni
Median	mediano
Scanner	scanner
hierin	qui
lebhaft	animato
Einstellung	registrazione
Held	eroe
Behandlungen	trattamenti
Haltung	atteggiamento
Teppich	tappeto
Linsen	lenti
besucht	frequentato
Schwierigkeit	difficoltà
Punk	punk
Koalition	coalizione
Einschreibung	iscrizione
Herzog	duca
Tempo	ritmo
Produzenten	produttori
Bogen	arco
Schnittstellen	interfacce
Atlas	atlante
Überwachung	osservazione
Folter	tortura
gelöscht	cancellato
Mantel	cappotto
Wiederherstellung	restauro
Bequemlichkeit	convenienza
Rückkehr	ritorno
Opposition	opposizione
Container	contenitore
Beklagte	imputato
Supervisor	supervisore
Korps	corpo
Schauspieler	attori
Leber	fegato
haftbar	responsabile
Petition	petizione
Antenne	antenna
gepflückt	raccolto
Glauben	credenza
Tötung	uccisione
Schulter	spalla
Dekor	arredamento
Ion	ione
Durchmesser	diametro
Podcast	Podcast
Wechselwirkungen	interazioni
Sänger	cantante
Herold	araldo
Altern	invecchiamento
Intervention	intervento
Plugin	collegare
Attraktion	attrazione
Tauchen	immersione
Änderung	modifica
annehmen	supporre
Schilf	canna
betreffen	coinvolgere
mäßig	moderare
Mäuse	topi
verstanden	inteso
schnell	rapidamente
Verbot	bandire
Sicherheit	garanzia
Ereignis	avvenimento
weit	vasto
Mühlen	mulini
Gliederung	contorno
erhält	riceve
Jeans	jeans
Zusammenstellung	compilazione
ungerade	dispari
sigma	sigma
GR	gr
attraktiv	attraente
Gelegenheit	occasione
Aufnahmen	registrazioni
Opfer	vittima
Forderungen	richieste
Vorsichtig	attento
Strahl	fascio
Gartenarbeit	giardinaggio
Verbindlichkeiten	obblighi
ankommen	arrivo
Orchester	orchestra
Lizenz	licenza
einstellbar	regolabile
Zuweisung	assegnazione
Aufsatz	tema
gezeigt	dimostrato
Dialog	dialogo
Lager	campi
erklärt	dichiarato
Spur	traccia
geschlossen	chiuso
Packungen	confezioni
ge	ge
Installation	installazione
Schalter	interruttori
freiwillig	volontario
du	tu
sehr	molto
ng	ng
häufig	comunemente
pe	pe
Fotograf	fotografo
Schrei	piangere
Quant	quantistico
konstruiert	costruito
Ergänzungen	aggiunte
erforderlich	richiedendo
Pfeil	freccia
Engagement	Fidanzamento
Rau	ruvido
seltsam	strano
Löwe	Leone
Hochzeiten	matrimoni
Sauerstoff	ossigeno
Schlucht	canyon
Meter	metri
nur	semplicemente
Kalender	calendari
Anordnung	preparativi
Schlussfolgerungen	conclusioni
Literaturverzeichnis	bibliografia
Zeiger	pointer
Kompatibilität	Compatibilità
strecken	allungare
Genehmigungen	permessi
Kooperative	cooperativa
Ernährung	alimentazione
Gemeinde	municipalità
Ranglisten	classifiche
Messung	misurazione
Gurt	cinghia
Menge	folla
Transfers	trasferimenti
olympisch	olimpico
Transformation	trasformazione
dir	dir
Zoll	dogana
Administratoren	amministratori
Persönlichkeit	personalità
Haken	gancio
Roulette	roulette
Ablehnen	declino
Kabel	cordone
Wolke	nube
erleichtern	facilitare
val	val
erklärt	spiega
Vorgehen	procedere
Gefühle	sentimenti
Messer	coltello
adoptieren	adottare
verweigert	negato
Spende	donazione
äußere	esterno
Ernte	raccolto
Flüsse	fiumi
Knoten	nodi
zitiert	citato
Nabe	mozzo
gezielt	mirata
erkannte	realizzato
Gründer	fondatore
Dekade	decennio
Streit	controversia
müde	stanco
negativ	avverso
Auszug	estratto
entladen	scarico
Getränke	bevande
As	asso
Stimmen	voci
Kletterei	arrampicata
Tonnen	tonnellate
Parfüm	profumo
gefährlich	pericoloso
wiederherstellen	ristabilire
Stapel	pila
Methodik	metodologia
Ruf	reputazione
Demokraten	democratici
aufhängen	appendere
Kurve	curva
Schöpfer	Creatore
Bernstein	ambra
Museen	musei
Verschlüsselung	codifica
Tracker	inseguitore
Variation	variazione
Passage	passaggio
übertragen	trasferito
Kofferraum	tronco
Foto	fotografia
Wellen	onde
Kamel	cammello
Verteiler	distributore
chi	chi
Versammlung	raduno
Projektion	proiezione
mathematisch	matematico
logisch	logico
Soße	salsa
Ruhm	fama
spezialisiert	specializzato
Unternehmen	aziende
Kritik	critica
Automobil	automobile
Jury	giudici
Bemerkungen	osservazioni
detektiert	rilevato
Gemälde	dipinti
ging	camminava
entstehen	derivante
Populationen	popolazioni
ängstlich	impaurito
akustisch	acustico
Kassette	cassetta
Indikator	indicatore
jpg	jpg
Fehler	sbaglio
beseitigen	eliminare
Mineral	minerale
Rubin	rubino
Perlen	perline
Vermögen	fortuna
Segeltuch	tela
Schwelle	soglia
Gemeinde	parrocchia
Bildschirme	schermi
Friedhof	cimitero
Stadion	stadio
Erkundung	esplorazione
min	min
Stengel	stelo
Astronomie	astronomia
Wettbewerbe	concorsi
Grippe	influenza
Kostüm	costume
Fahrräder	Bici
Bischof	vescovo
zog	tirato
Mais	Mais
Kompression	compressione
Festlegung	stabilire
Farmer	contadino
Zinn	lattina
Sklave	schiavo
sofort	immediatamente
Coaching	istruire
geprüft	esaminato
Codierung	codifica
Einreichungen	osservazioni
Helden	eroi
gemalt	dipinto
Porträt	ritratto
Terrorist	terrorista
ethisch	etico
Träger	vettori
Mobilität	mobilità
Kampf	lotta
Regelungen	schemi
Leiden	sofferenza
neutral	neutro
Fischer	pescatore
Ratte	ratto
Speere	lance
Beitritt	accoppiamento
Überschrift	intestazione
künstlich	artificiale
Lager	cuscinetto
spektakulär	spettacolare
Welten	mondi
schuldig	colpevole
Aktivierung	Attivazione
Oase	porto
Tablette	tavoletta
Jury	giuria
DOS	dos
Schwanz	coda
Charme	fascino
heftig	violento
möglicherweise	potenzialmente
Ranch	ranch
Einschränkungen	vincoli
Kreuzung	attraversamento
inklusive	inclusivo
Hütte	Cottage
betrunken	ubriaco
beträchtlich	considerevole
Verbrechen	crimini
aufgelöst	risoluto
Byte	byte
Nase	naso
Geäst	rami
Ausländer	alieno
Prozessoren	processori
Pleite	rotto
Komplexität	complessità
ständig	costantemente
Entschlossenheit	risolvere
Gebiete	territori
These	tesi
Scheiben	dischi
häufig	frequente
Decke	soffitto
Pixel	pixel
gen	gen
Diamanten	quadri
Flotte	flotta
Bündel	mazzo
theoretisch	teorico
Verweisung	rinvio
Verlassen	smettere
Protokolle	protocolli
Lunge	polmone
Ersatz	sostituire
brillant	brillante
ti	ti
Gel	gel
gesprochen	verbale
Omega	omega
bewertet	valutato
blieb	rimasto
sieht	vede
Beendigung	fine
schaute	guardato
Haushalte	famiglie
einlösen	riscattare
Korn	grano
Regime	regime
Stier	Toro
architektonisch	architettonico
abweichen	differire
Bewegungen	movimenti
Reparaturen	riparazione
Atem	respiro
Komfort	servizi
virtuell	potenzialmente
Markt	mercato
Kerze	candela
hängend	sospeso
farbig	colorato
Geschichte	racconto
früher	precedentemente
Beamer	proiettore
gelegen	situato
sucht	cerca
streng	rigorosamente
psychologisch	psicologico
Vitamine	vitamine
elegant	elegante
Gewinne	utile
Erneuerung	rinnovo
Genealogie	genealogia
als	ritenuto
Wertung	punteggio
Ausgaben	spesa
Kritik	critica
Algorithmen	algoritmi
Hacker	pirata
Salon	salone
Turbo	turbo
heilen	cura
ni	ni
denkt	pensa
Vorschlag	suggerimento
Soldat	soldato
Bombe	bomba
Schaden	danno
Intervall	intervallo
Spiegel	specchi
untersuchen	indagare
deine	tuo
Platten	pannelli
wiederholt	ripetuto
Angriff	assalto
Hirsch	cervo
Zunge	lingua
Bowling	bowling
tri	tri
Affe	scimmia
Anteil	proporzione
Rock	gonna
Analysen	analisi
Zeichnungen	disegni
Bedeutung	significato
Szenario	scenario
Ihr	voi
Arabisch	Arabo
Spur	valutare
Schutz	proteggere
konfrontiert	affrontato
Auflösung	soluzione
produziert	produce
intensiv	intensivo
Ketten	Catene
sechste	sesto
engagieren	impegnare
Schaltung	commutazione
Korrespondenz	corrispondenza
Importe	importazioni
Aufsicht	supervisione
Ausgaben	spese
Trennung	separazione
Zeugnis	testimonianza
vermuten	sospettare
verpflichtend	obbligatorio
Grenzen	confini
Feier	celebrazione
Filter	filtraggio
Ehepartner	Sposa
exotisch	esotico
Zuschauer	spettatore
reichend	raggiungendo
Lachen	ridere
chirurgisch	chirurgico
zerstören	distruggere
Zitat	citazione
yo	yo
Lokal	premesse
bewährt	dimostrato
beleidigend	offensivo
Kaiserliche	imperiale
Dutzend	dozzina
Einsatz	distribuzione
Stoff	stoffa
Lotus	loto
Lachs	salmone
Ladung	carico
Direktive	direttiva
Kamerad	compagno
Butter	burro
Pfeffer	Pepe
Waffe	arma
Belastung	fardello
Bänder	nastri
Zonen	zone
Insel	isola
schlank	sottile
Ahorn	acero
Lebensmittelgeschäft	drogheria
Regierungs	governo
Depot	deposito
alt	alt
Kuchen	torta
Mischung	miscela
Emission	emissione
ersichtlich	apparente
Lehr	didattico
Berechtigungen	permessi
Toilette	gabinetto
Platz	classificato
Routen	itinerari
Montage	montaggio
gebunden	legato
ausgewogen	equilibrato
verspätet	ritardato
Tal	vallata
Berechnung	calcolo
Villen	ville
Gelegenheiten	occasioni
Gleichungen	equazioni
Öl	oli
September	settembre
außergewöhnlich	eccezionale
Angst	ansia
räumlich	spaziale
Befragten	intervistati
Überlegungen	considerazioni
zahlt	paga
sonnig	soleggiato
liefert	fornisce
je	je
Halskette	collana
zusammengesetzt	composito
lang	Lang
Theater	teatri
Entwerfen	progettazione
Hoffnungen	speranze
Beurteilungen	valutazioni
Diagramm	diagramma
Schuhwerk	calzature
sg	sg
Völker	popoli
Sieger	vincitore
Lizenzen	licenze
Bereiche	intervalli
Paare	coppie
Empfindlichkeit	sensibilità
Erhaltung	conservazione
isoliert	isolato
Interim	provvisorio
unterstützt	assistito
göttlich	divine
genehmigen	approvare
Verbindung	composto
Intensität	intensità
technologisch	tecnologico
Abtreibung	aborto
Dialog	dialogo
Veranstaltungsorte	sedi
sprengen	esplosione
Adressierung	indirizzamento
Pole	polo
Schild	scudo
Membran	membrana
verzweifelt	disperato
Mütter	madri
Demonstration	dimostrazione
Regierungs	governo
hergestellt	manufatto
Kerzen	candele
Variationen	variazioni
Mütter	mamme
heilig	sacro
Sucht	dipendenza
Chrom	cromo
verweigert	rifiutato
Bremse	freno
Außen	esterno
Gruß	saluto
Ökologie	ecologia
Tal	valletta
Arbeitslosigkeit	disoccupazione
erzielter	segnato
Erweiterung	aumento
Klon	clone
Geschwindigkeit	velocità
Lambda	lambda
zusammengesetzt	composto
Tränen	lacrime
Oase	oasi
Taxi	taxi
Fa	fa
Gesellschaften	società
Silizium	silicio
identisch	identico
Petroleum	petrolio
konkurrieren	competere
ist	ist
Liebhaber	amante
gehören	appartenere
Lippen	labbra
begleiten	scorta
Teich	stagno
Fähre	traghetto
Hase	coniglio
Beruf	professione
Damm	diga
Physiologie	fisiologia
Ausfuhr	esportazioni
Reifen	pneumatico
Teilnehmer	partecipante
Elektron	elettrone
Ladungen	carichi
Heidekraut	erica
Motel	motel
Gewerkschaften	sindacati
Fiskus	tesoreria
belegt	occupato
Waage	bilancia
Belastung	sforzo
verhaftet	arrestato
Untersuchungen	indagini
gewonnen	guadagnato
Wäsche	lavanderia
Erteilung	collocazione
einstellen	regolare
bewertet	valutato
Verschlüsselung	crittografia
Füllung	Riempimento
auferlegte	imposto
Schweigen	silenzio
sowjetisch	sovietico
Besitz	possesso
Vertrag	trattato
Trainer	allenatore
Organ	organo
Zitrone	Limone
Dunkelheit	buio
Spanne	campata
Scherz	scherzo
Verpackung	Imballaggio
Satzung	statuto
abgelehnt	respinto
Schutz	riparo
Kapelle	cappella
Herstellung	produzione
Lagen	strati
feiern	celebrare
Gerät	apparecchio
Mischung	miscela
Fahrer	ciclista
Radius	raggio
beeindruckend	impressionante
Schaf	pecora
Architekt	architetto
Vorlesungen	lezioni
Weine	vini
Tassen	tazze
Asche	cenere
Beiträger	contributori
Salat	insalata
Verletzungen	violazioni
Temperaturen	temperature
Wettbewerbe	concorsi
erhalten	conserva
Gedicht	poesia
bleiben	stare
Ostern	Pasqua
Theorien	teorie
Repository	deposito
Strom	flussi
Landung	atterraggio
hingerichtet	eseguito
Verhandlungen	negoziati
realistisch	realistico
fragt	chiede
Zusammenfassung	sinossi
Komponist	compositore
Bohne	fagiolo
Schwert	spada
Modifikationen	modifiche
Koralle	corallo
Pixel	pixel
Wegen	percorsi
Blase	bolla
por	por
erwerben	acquisire
Gegenteil	contrario
Tribun	tribuna
Schiff	nave
Säuren	acidi
Viren	virus
Aufkleber	adesivi
Reaktionen	reazioni
Glauben	credenze
Kader	squadra
analysieren	analizzare
Divisionen	divisioni
schwimmen	nuotare
nano	nano
Konzerte	concerti
Männchen	maschi
behalten	conservare
Farben	colori
ausführen	eseguire
Tunnel	tunnel
Genre	generi
Patente	brevetti
Weizen	Grano
Chroniken	Cronache
Beschaffung	ottenendo
Biber	castoro
Lesungen	letture
Erweiterung	allargamento
Adler	Aquile
Basen	basi
Angeklagte	accusato
Kampagnen	campagne
Einheit	unità
definiert	definisce
Instanzen	casi
einheimisch	indigeno
begonnen	iniziato
Pakete	pacchetti
Anker	ancora
Socken	calzini
auslösen	grilletto
Cholesterin	colesterolo
Differential	differenziale
Oberflächen	superfici
furchtbar	terribile
Router	router
Uhren	orologi
Arthritis	artrite
BIOS	bios
Weibchen	femmine
spiegelt	riflette
Besteuerung	tassazione
Fieber	febbre
Küche	cucina
sicherlich	certamente
Praktiker	professionisti
Satz	teorema
Inflation	inflazione
dich	ti
Verbindungen	composti
Schlagzeug	batteria
vernünftig	ragionevolmente
blank	spoglio
Radikale	radicale
empfiehlt	raccomanda
Regelung	controllo
Schatz	Tesoro
Flamme	fiamma
Grube	fossa
Mono	mono
Partikel	particelle
schwimmend	galleggiante
Koordinate	coordinata
ausschließlich	esclusivamente
Einschränkung	limitazione
geschlagen	colpito
Illustration	illustrazione
Warnungen	avvertenze
bauen	costruire
Apps	applicazioni
Anfragen	indagini
annektieren	annesso
Inspiration	ispirazione
Fracht	nolo
Finsternis	eclisse
wirkt	colpisce
Prognosen	previsioni
entdecken	individuare
aktiv	attivamente
kompliziert	complicato
verletzt	ferito
Ausdrücke	espressioni
Tonne	tonnellata
Kurier	Corriere
Hinweise	suggerimenti
gif	gif
Konflikte	conflitti
Getränk	bevanda
Tribut	omaggio
immun	immune
Forstwirtschaft	silvicoltura
Barrieren	barriere
kippen	gergo
selten	raramente
Angebote	offerte
Barriere	barriera
Fahrrad	bicicletta
Einrichtung	arredamento
entstehen	sorgere
keltisch	celtico
Partikel	particella
Feuchtigkeit	umidità
Flaschen	bottiglie
dm	dm
Renaissance	Rinascimento
Verordnung	decreto
Fotografen	fotografi
Infektionen	infezioni
Schach	scacchi
arbeitet	opera
Feste	festival
Möglichkeiten	possibilità
Ente	anatra
Kanal	canale
Beitrag	contribuendo
Kuh	mucca
analytisch	analitico
Kostüme	costumi
streng	rigoroso
Verkehr	circolazione
Delikt	offesa
Annahme	assunzione
Hobby	passatempo
Versuche	cerca
Erfindung	invenzione
Techniker	tecnico
Führungskräfte	dirigenti
Anfragen	indagini
kognitiv	conoscitivo
erforschen	esplorando
Trick	trucco
Anfrage	inchiesta
Schließung	chiusura
Bauholz	legname
Volt	volt
heftig	intenso
Unterstützer	sostenitori
Satzung	statuti
eingeschrieben	iscritto
Sensoren	sensori
Schraube	vite
Minister	ministri
öffentlich	pubblicamente
litt	subito
Aufnahme	presa
Schmetterling	farfalla
Mechanik	meccanica
Header	intestazioni
Fehler	errori
numerisch	numerico
definieren	definizione
Zählen	conteggio
Betrachtung	riflessione
Einladung	invito
Natrium	sodio
Hormon	ormone
Kinder	bambini
Backstein	mattone
Griff	presa
mittelalterlich	medievale
Porzellan	porcellana
gefangen	catturato
anständig	decente
Guss	getto
übersetzt	tradotto
Donna	donna
Krieger	guerriero
Kabine	cabina
Scannen	lettura
Polo	polo
Kopieren	copiatura
Horn	corno
Journalismus	giornalismo
Frosch	rana
Grammatik	grammatica
Absicht	Intenzione
Reifen	pneumatici
unternommen	intrapreso
Gefahr	rischio
Folgen	Episodi
kreisförmig	circolare
Zorn	rabbia
Abbildungen	illustrazioni
Chancen	possibilità
Glück	felicità
bizarr	bizzarro
ur	ur
Früchte	frutta
Kennzeichnung	identificatore
Band	nastro
Berechnungen	calcoli
jpeg	jpeg
Anfang	avviare
praktisch	maneggevole
Wechsel	scambiare
befreit	esonerare
Pflanzen	colture
reduziert	riduce
durchgeführt	compiuto
Geometrie	geometria
Eindruck	impressione
Gilde	gilda
Korrelation	correlazione
sim	sim
nervös	nervoso
Duft	fragranza
Replik	replica
Stamm	tribù
Trades	compravendite
hervorragend	superbo
loswerden	liberare
Dreieinigkeit	Trinità
abgewickelt	maneggiato
Legenden	leggende
Boom	boom
Ruhe	calma
Meister	campioni
Etagen	piani
Auswahlen	Selezioni
Vergleichen	confrontando
spricht	parla
beruflich	professionale
Apotheken	farmacie
ln	ln
Rolle	rullo
Stapel	partita
organisieren	organizzare
geschätzt	gradito
ändern	alterare
Kanten	bordi
Vermischung	miscelazione
Griffe	maniglie
Harmonie	armonia
vornehm	distinto
Asthma	asma
Annahmen	assunzioni
geregelt	regolata
Dreieck	triangolo
ändern	emendare
erwartet	anticipato
orientalisch	orientale
Belohnung	ricompensa
Wasserstoff	idrogeno
vergleichbar	comparabile
befürworten	avvocato
Verwechslung	confusione
Eingänge	ingressi
Garantien	garanzie
Genom	genoma
Medaille	medaglia
Trainer	allenatori
Schiffe	vasi
Hafen	porto
Öko	eco
verletzlich	vulnerabile
ordnen	organizzare
künstlerisch	artistico
Ehrungen	onori
reflektiert	riflessa
einheitlich	unificato
Rasse	razza
Detektor	rivelatore
ignoriert	ignorato
präzise	preciso
Auswertung	valutare
Lippe	labbro
versammeln	raccogliere
Bildung	formatura
Journalisten	giornalisti
leicht	leggero
indirekt	indiretto
unter	tra
Stiftungen	fondazioni
Horizont	orizzonte
nu	nu
tief	profondamente
Verbindlichkeiten	passivo
Preise	premi
verringert	diminuita
beschreiben	descrivendo
Optik	ottica
verfolgen	perseguire
Blitz	fulmine
ou	ou
Zitate	citazioni
Inspektor	ispettore
Schlange	serpente
Erinnerung	promemoria
gesucht	cercato
Flachland	pianure
Einblicke	approfondimenti
Fähigkeiten	abilità
initiiert	avviato
Karaoke	karaoke
Falle	trappola
einsam	solitario
ve	ve
beobachten	osservare
Behälter	contenitori
Einstellungen	atteggiamenti
Beere	bacca
Halsband	collare
integrieren	integrare
Soziologie	sociologia
Exponate	mostre
stirbt	muore
Terrasse	terrazza
Bakterien	batteri
sollen	dovere
köstlich	delizioso
Traditionen	tradizioni
endlich	finito
sendet	invia
dauerhaft	durevole
verbündet	alleato
Feuchtigkeit	umidità
verwandeln	trasformare
Timer	Timer
Tablets	compresse
bekommen	ottenuto
Erzieher	educatori
Gemüse	verdura
Vers	versetto
unabhängig	indipendentemente
Konkurrenz	concorrenti
Rakete	razzo
Ja	sì
Kugel	proiettile
Türme	torri
Sichtweite	visibilità
Breite	latitudine
Bewusstsein	coscienza
Tumor	tumore
hässlich	brutta
Einlagen	depositi
Herrin	padrona
Begegnung	incontrare
Watt	watt
vierzig	quaranta
Röhren	tubi
versucht	tentata
Priester	sacerdote
Analysten	analisti
Hammer	martello
Invasion	invasione
Läufer	corridore
Reihen	righe
verabreicht	somministrati
Begriff	nozione
Rechtschreibung	ortografia
Arktis	artico
Belohnt	ricompense
unter	sotto
stärken	rafforzare
verteidigen	difendere
infrarot	infrarosso
siebte	settimo
Bauch	pancia
aggressiv	aggressivo
Anzeigen	annunci
Quartier	alloggio
gestohlen	rubare
bestimmt	determina
Skulptur	scultura
Poly	poli
Ohren	orecchie
Faust	pugno
Neo	neo
Motivation	motivazione
Passagiere	viaggiatori
konsequent	costantemente
Überschuss	surplus
graben	scavare
Taxi	Taxi
Anerkennung	apprezzamento
om	om
Beschränkung	restrizione
Gitarren	chitarre
Wesen	essenza
mächtig	potente
Menschheit	umanità
Transkription	trascrizione
Komplikationen	complicazioni
Wissenschaftler	studiosi
Galaxis	galassia
Pflege	cura
Testament	testamento
Dominant	dominante
Bauch	stomaco
teilweise	parzialmente
minimieren	minimizzare
Reihen	ranghi
Debüt	debutto
Generationen	generazioni
Turniere	tornei
verweigern	negare
Anatomie	anatomia
Kopfhörer	cuffie
Fraktion	frazione
Trio	trio
Vorgehen	procedere
Würfel	cubo
Defekte	difetti
Unsicherheit	incertezza
Nervenzusammenbruch	abbattersi
geregelt	sistemato
Impfstoff	vaccino
Schicksal	destino
Buchungen	prenotazioni
Republikaner	repubblicani
Dschungel	giungla
Zen	zen
dis	dis
Prognose	predizione
ökologisch	ecologico
Oval	ovale
impliziert	implica
ser	ser
Bewertung	valutazione
Aussicht	prospettiva
geographisch	geografico
Spender	donatore
Spannung	tensione
Müll	spazzatura
Formen	forme
Stufe	fila
Graf	conte
Heimat	patria
Meisterschaft	campionati
Rassen	razze
Disko	discoteca
aus	aus
Veredelung	finitura
Emotionen	emozioni
ewig	eterno
Drehung	rotazione
nam	nam
produktiv	produttivo
Boulevard	viale
Schwein	maiale
metrisch	metrico
Strafen	sanzioni
abwechslungsreicher	vario
grande	Grande
Darstellerin	attrice
zuordnen	assegnare
unterbringen	ospitare
Tiger	tigri
Dörfer	villaggi
Schatten	ombra
Chor	coro
Rhythmus	ritmo
Ziffer	cifra
Symphonie	sinfonia
plötzlich	improvviso
Annehmen	accettando
Schwimmbäder	piscine
lyrisch	lirica
Isolierung	isolamento
Geschwindigkeiten	velocità
nachhaltig	sostenuta
abgestimmt	abbinato
ungefähr	approssimativo
Seil	corda
rational	razionale
Programmierer	programmatore
Kämpfer	combattenti
vererbt	ereditato
unvollständig	incompleto
Gesang	vocals
Brunnen	Fontana
legitim	legittimo
Biographien	biografie
Ermittler	investigatore
Kläger	attore
sanft	dolce
würdig	degno
Architekten	architetti
Heilige	santi
Unternehmer	imprenditore
trägt	trasporta
Duo	duo
überhöht	eccessivo
spart	salva
angesehen	considerato
Bewertung	valutazione
unerwartet	inaspettato
Nebel	nebbia
charakteristisch	caratteristica
Empfangshalle	atrio
skizzierte	delineato
enorm	enorme
Karma	karma
bestehen	consistere
Königinnen	regine
Wissenschaftler	accademici
Stämme	tribù
Unterscheidung	distinzione
Gefahren	pericoli
Befreiung	esenzione
Mieter	inquilino
Nachhaltigkeit	sostenibilità
Tätowierung	tatuaggio
Algebra	algebra
Schatten	ombre
dumm	sciocco
frei	liberamente
mild	mite
Pelz	pelliccia
leicht	prontamente
Zugehörigkeit	affiliazione
Zaun	recinto
unendlich	infinito
Clan	clan
Revolutionär	rivoluzionario
Armbänder	bracciali
Abhilfe	rimedio
Atmung	respirazione
kurz	brevemente
Dicke	spessore
grafische	grafico
Genius	genio
Diskussion	discutere
Kämpfer	combattente
sinnvoll	significativo
adaptiert	adattato
Ländereien	proprietà
Teppich	tappeto
Demokrat	democratico
Bezirk	borgo
hält	mantiene
ka	ka
beibehalten	mantenuto
Marmor	marmo
DM	DEM
Meditation	meditazione
Mikrofon	microfono
Vereinigung	combinando
Riesen	giganti
organisieren	organizzazione
Memo	promemoria
Schinken	prosciutto
gelöst	risolto
Tide	marea
Trennwand	partizione
unsichtbar	invisibile
Konsolen	console
Magnet	magnete
Übersetzungen	traduzioni
Jaguar	giaguaro
Ware	merce
Kilometer	chilometri
Garantien	garanzie
gotisch	Gotico
Zylinder	cilindro
Hexe	strega
Bock	secchio
Feinde	nemici
Beratung	consulenza
genießen	godendo
patrouillieren	pattuglia
Geruch	odore
Karneval	carnevale
grob	approssimativamente
Aufkleber	etichetta
Versprechen	promesse
Riff	scogliera
Teilen	dividere
aufeinanderfolgenden	consecutivo
bon	bon
Vorstellungen	rappresentazioni
chan	chan
Melodien	Tunes
mas	mas
Sätze	frasi
kai	kai
Halbinsel	penisola
langweilig	noioso
dom	dom
Reden	discorsi
erreicht	raggiunge
Schema	schema
Kataloge	cataloghi
Ministerien	ministeri
parlamentarisch	parlamentare
Präfix	prefisso
Savanne	savana
Fass	barile
Nerv	nervo
dans	dans
Planeten	pianeti
Defizit	disavanzo
erneuern	rinnovare
gekoppelt	accoppiato
Schaltungen	circuiti
Textur	struttura
bestätigen	riconoscere
Zelt	tenda
identifiziert	identifica
Qualifikation	qualificazione
Schlösser	serrature
Miniatur	miniatura
Euro	euro
Piraten	pirati
Antenne	aereo
Falke	falco
Folge	conseguenza
systematisch	sistematico
wahrgenommen	percepito
Ursprünge	origini
gemietet	assunti
bilden	trucco
ui	ui
Gewichte	pesi
geologisch	geologica
dauerhaft	durevole
böse	malvagio
einleitet	introduce
geschoben	spinto
ro	ro
Steigung	pendenza
Dichter	poeta
Verschwörung	cospirazione
Theologie	teologia
Nägel	unghie
offensichtlich	evidente
Fahrten	cavalcate
Epos	epico
Veranstalter	organizzatore
Allergie	allergia
Sake	interesse
Kombinationen	combinazioni
vorangestellt	precedente
verdienen	merito
Enzym	enzima
Flugzeuge	aerei
Scheiben	dischi
Verstärker	amplificatore
willkürlich	arbitrario
prominent	prominente
sans	sans
baut	costruisce
kontaktiert	contattato
Welle	albero
lehnen	magro
gelegentlich	occasionale
Innovationen	innovazioni
Überprüfung	revisione
Panik	panico
Staatsbürgerschaft	cittadinanza
Ausrede	scusa
Reformen	riforme
Zwiebel	cipolla
Sandwich	Sandwich
Alt	contralto
Hierarchie	gerarchia
verlassen	abbandonato
Kreise	cerchi
Beats	battiti
fröhlich	allegro
Kult	culto
Strich	trattino
passiv	passivo
geschätzt	valutato
Käfig	gabbia
Mut	coraggio
Elevation	elevazione
Runde	giro
Nutzung	utilizzo
Getränke	bevande
Klingeln	ping
unterhaltsam	divertente
Voraussetzung	necessario
Grenze	frontiera
Flüchtlinge	rifugiati
Ritter	cavalieri
Hypothese	ipotesi
Medikamente	farmaci
geändert	alterato
Lehre	dottrina
szenisch	panoramico
Erweiterungen	miglioramenti
Überschneidung	intersezione
Nähen	cucire
Sammler	collettori
anerkannt	riconosciuto
Rage	rabbia
prix	prix
Astrologie	astrologia
Berater	consulenti
Pavillon	padiglione
Taktik	tattica
Zusatz	supplementare
talentiert	talentuoso
Kissen	cuscino
Verbreitung	diffusione
Provinzen	province
stehlen	rubare
Paket	pacco
Vorfall	incidenza
Ängste	paure
vorhersagen	predire
Geschmack	gusto
hungrig	Affamato
metallisch	metallico
Interferenz	interferenza
Krieger	guerrieri
atmosphärisch	atmosferico
Heiligenschein	alone
Eltern	parentale
verwiesen	riferimento
Streiks	attacchi
Ameise	formica
Vorschlag	proposizione
geeignet	adatto
behandelt	affrontato
Händler	commerciante
geworfen	gettato
Kriterium	criterio
Abzeichen	distintivo
Zivilisation	civiltà
Heide	brughiera
enorm	enorme
führt	esegue
Reich	regno
korrigiert	corretto
Helm	casco
angetroffen	incontrato
Tsunami	tsunami
Gelehrte	studioso
umgeben	circondato
Geologie	geologia
Kreaturen	creature
gelöscht	eliminato
erreichen	realizzare
Ecken	angoli
Vegetarier	vegetariano
Hefe	lievito
pas	pas
sucht	indagato
Botschafter	ambasciatore
beschichtete	rivestito
Untergang	destino
Routinen	routine
Wesen	esseri
Vertrauen	dipendenza
Mythos	mito
Bach	ruscello
fu	fu
Phänomen	fenomeno
Ensemble	insieme
versicherte	assicurato
bewusst	consapevole
Akzent	accento
Ehefrauen	mogli
nutzen	utilizzare
Versprechen	impegno
Vampir	vampiro
Dock	bacino
organisiert	organizzato
Musiker	musicista
Begrenzung	limitativo
restauriert	restaurato
Hinweis	suggerimento
Rüstung	armatura
Anmerkung	osservazione
Dutzende	dozzine
variiert	varia
Argumentation	ragionamento
Wächter	guardie
Öffnungen	aperture
Ersetzung	sostituzione
Forscher	ricercatore
Räte	consigli
Berufe	occupazioni
anerkannt	riconosciuto
Schweinefleisch	Maiale
zu	zu
Gleichgewicht	equilibrio
Rohre	tubi
Hütten	cottage
verschmelzen	fondersi
Privileg	privilegio
entwickelt	sviluppa
Chassis	telaio
Einschätzung	stima
Scheune	fienile
Frost	brina
Institute	istituti
Schimmel	muffa
Freifrau	dama
Yacht	yacht
bevorzugt	preferisce
Bohrung	perforazione
Kraut	erba
Bruch	violazione
Wal	balena
Reisende	viaggiatore
Mittel	stanziamenti
vermutlich	sospetto
Tomaten	pomodori
Lehrer	istruttori
Schwung	impulso
Flosse	pinna
Pastor	pastore
Schlamm	fango
Smaragd	Smeraldo
wächst	cresce
Traktat	tratto
ul	ul
Ballett	balletto
Journalist	giornalista
Religionen	religioni
Knoblauch	aglio
scheinen	brillare
Explosion	esplosione
Slip	slip
Unterschriften	firme
Ozon	ozono
Disziplinen	discipline
casa	Casa
Gespräche	conversazioni
Radios	radio
Tarif	tariffa
vereinfachte	semplificato
Muskeln	muscoli
schnell	veloce
Vagina	vagina
Champagner	Champagne
Abweichung	deviazione
Samba	samba
beschäftigen	impiegare
Pinguin	pinguino
magisch	magico
Einflüsse	influenze
Inspektionen	ispezioni
Bewässerung	irrigazione
Wunder	miracolo
hydraulisch	idraulico
Penetration	penetrazione
Wunde	ferita
Schöne	bella
rosa	rosa
Überzeugung	convinzione
faul	pigro
Qualitäten	qualità
Väter	padri
Lade	ricarica
wichtig	importante
zierlich	petite
Gerät	apparato
Terrain	terreno
Erläuterung	spiegando
Streifen	strisce
Nominierung	nomina
empirisch	empirico
Wurm	verme
Abhängigkeit	dipendenza
diskret	discreto
Anfänger	principiante
Deckel	coperchio
Sexualität	sessualità
Saphir	zaffiro
Privilegien	privilegi
spezialisiert	specializzata
Markierung	marcatura
Sheriff	sceriffo
abgelehnt	diminuito
Spion	spie
Motorräder	moto
wählen	eletto
Autobahnen	autostrade
konzentrieren	concentrarsi
intim	intimo
Moleküle	molecole
Runde	giri
Kühlschrank	frigorifero
Intervalle	intervalli
Sätze	frasi
Holocaust	olocausto
Flieger	aviatore
Erbsen	piselli
Dosierung	dosaggio
Unterschied	varianza
Navigator	navigatore
Nadel	ago
Bad	terme
Bremsen	Freni
og	og
ko	ko
besitzt	possiede
Schicksal	destino
Landschaften	paesaggi
Berechnung	calcolo
Heu	fieno
Heil	salvezza
Vorhersagen	predizioni
Lern	discenti
Zeichen	gettone
Zink	zinco
Opfern	sacrificio
Sucher	asilo
Guru	guru
geeignet	adatto
numerisch	numerico
Anthropologie	antropologia
Kaiser	imperatore
grad	grad
Gürtel	cinture
Schwarze	neri
gebildet	educato
stolz	orgoglio
Notwendigkeit	necessità
Kurven	curve
Touren	turismo
Scheitel	vertice
Tomate	pomodoro
Reisen	viaggi
blass	pallido
Funktion	funzionamento
Wirtschaft	economie
unternehmen	intraprendere
erklären	dichiarare
Ventile	valvole
Lücken	lacune
Erfolge	realizzazioni
reißen	lacrima
lehrt	insegna
Null	zero
Fremder	sconosciuto
Nest	nido
Gericht	tribunale
ausgeschlossen	governato
Pensionen	pensioni
Gebete	preghiere
Polizist	poliziotto
Jugendliche	adolescente
Nominierungen	nomination
Banane	Banana
einleitend	introduttivo
Reservoir	serbatoio
Auftreten	evento
Idol	idolo
blutig	sanguinoso
erinnern	ricordare
reizend	affascinante
Zahn	dente
respektierte	rispettata
Aufenthalte	soggiorni
Affäre	affare
beschränken	limitare
Minen	miniere
Porträts	ritratti
interpretiert	interpretato
Auswertungen	valutazioni
Beseitigung	eliminazione
Meter	metri
hypothetisch	ipotetico
Hubschrauber	elicottero
Bleistift	matita
Künstler	esecutore
Provisionen	commissioni
Kugel	sfera
Moos	muschio
Verhältnisse	rapporti
Eintracht	concordia
graduierte	laureato
unterstützt	omologati
überraschend	sorprendente
Lanze	lancia
Leiter	scala
Kork	sughero
Senatoren	senatori
Blutung	emorragia
Charakterisierung	caratterizzazione
Wahrscheinlichkeit	probabilità
Bahnen	corsie
Grundlage	fondamenti
Kontamination	contaminazione
Kuppel	cupola
segnen	benedire
Verhandlung	trattativa
Kamm	cresta
Gegner	avversari
Triumph	trionfo
nominiert	nominato
Schweißen	saldatura
Orgasmus	orgasmo
Legierung	lega
Stellplätze	trame
sanft	delicatamente
Sperrung	bloccaggio
umstritten	controverso
Unentschieden	disegna
Kühlschrank	frigo
Klingen	lame
Schlaufen	loop
Schwall	ondata
Trauma	trauma
Inserat	annuncio
Defensive	difensiva
verboten	proibito
Vanille	vaniglia
Programmierer	programmatori
überwacht	monitorati
Installationen	installazioni
Seelen	anime
motiviert	motivata
Dumm	muto
hohl	cavo
Gewölbe	volta
Rille	scanalatura
Offenbarung	rivelazione
Verfolgung	ricerca
Delegation	delegazione
Drähte	fili
Wörterbücher	dizionari
Transparenz	trasparenza
Orbit	orbita
Währungen	valute
Niger	Niger
Positionierung	posizionamento
Kolonie	colonia
Kanone	cannone
Zirkus	circo
gefördert	promossa
Forelle	trota
Leistung	impresa
vorübergehend	temporaneamente
gekocht	cucinato
übertragen	trasmettere
Frequenzen	frequenze
Reflexionen	riflessi
Hunger	fame
Gemeinde	comune
Detektiv	investigatore
Zement	cemento
erleben	sperimentare
Kamin	camino
Billigung	approvazione
Textilien	tessile
Rakete	missile
Psychiatrie	psichiatria
Assists	assist
Rechnungsprüfer	uditore
Geige	violino
Prophet	profeta
Oxid	ossido
ausgezeichnet	magnifico
sofort	prontamente
Anpassung	adattamento
schädlich	dannoso
sexuell	sessualmente
Gehege	allegato
Glucose	glucosio
Norm	norma
Wiedergabe	riproduzione
Schildkröte	tartaruga
Entfernungen	distanze
Absorption	assorbimento
Schätze	tesori
Fossil	fossile
schlecht	male
Kommunist	comunista
Unternehmer	imprenditori
Roboter	robot
Foul	fallo
Biodiversität	biodiversità
Aufregung	eccitazione
verbal	verbale
Meere	mari
mysteriös	misterioso
Neuheit	novità
Fliesen	piastrelle
Bibliothekar	bibliotecario
schaltet	commutata
ru	ru
Pose	posa
Gramm	grammi
Therapeut	terapista
Budget	budget
Ziege	capra
machen	rendere
Segel	vela
Kommissare	commissari
dicht	denso
mutig	coraggioso
Spedition	spedizione
furchtbar	terribile
Flugzeug	aereo
Organismen	organismi
Fernrohr	telescopio
Asbest	amianto
Förderung	avanzamento
Weide	salice
Bewerbungen	riprende
existierte	esistito
Generatoren	generatori
erzeugt	genera
Kartoffeln	patate
gründlich	completo
Rezeptoren	recettori
Optimum	ottimale
Kreatur	creatura
einsam	solitario
subtil	sottile
Streifen	strisce
Firmware	firmware
Schäfer	pastore
Wiege	culla
Kanzler	cancelliere
Mehl	Farina
Kontroverse	controversia
legendär	leggendario
Chor	coro
Vermeidung	evitando
schön	magnificamente
erwartet	aspetta
Springen	salto
Stoffe	tessuti
Polymer	polimero
Hygiene	igiene
Tugend	virtù
Chirurgen	chirurghi
Mandat	mandato
Korpus	corpo
Terminologie	terminologia
Gentleman	signore
verurteilt	condannato
Jet	getti
Indizes	indici
qui	qui
bedrohlich	minaccioso
Aktivisten	attivisti
Häftling	prigioniero
ermutigt	incoraggia
gebaut	assemblato
Terminals	terminali
roh	greggio
Untersucht	esamina
Wikinger	vichingo
Aufräumen	pulire
bedingt	condizionale
angegriffen	attaccato
kommt	arriva
Übersetzer	traduttore
Automobil	automobili
Traktor	trattore
Kontinent	continente
Tarife	tariffe
Längengrad	longitudine
hoffte	sperato
Einfügung	inserimento
Zwang	costrizione
Stärkung	potenziamento
wünschen	desiderando
Isolierung	isolamento
Verletzung	violazione
gebogen	piegato
subjektiv	soggettivo
Monster	mostri
Asyl	asilo
Anteil	palo
Cocktail	cocktail
Sorten	varietà
Gift	veleno
dominiert	dominato
teuer	costoso
Derivate	derivati
verhindert	impedisce
Gewehr	fucile
Rassismus	razzismo
interpretieren	interpretare
Übereinstimmung	accordo
bescheiden	modesto
Spieler	giocatori
Sortierung	ordinamento
Liaison	collegamento
Glühbirnen	bulbi
Touristen	turisti
Verhaltensweisen	comportamenti
klären	chiarire
Taille	vita
zugeschrieben	attribuito
Eule	gufo
Kristalle	cristalli
überschreitet	supera
komplementär	complementare
Kämpfe	battaglie
bitter	amaro
Memorandum	memorandum
Drachen	draghi
Lärm	frastuono
unglaublich	incredibilmente
Delegierte	delegati
psychiatrisch	psichiatrico
Jugendliche	adolescenti
Hof	cortile
Präsidenten	presidenti
abfahren	partire
ausdrücklich	espressamente
Lilie	giglio
Aufsicht	svista
Harz	resina
Alliierte	alleati
konserviert	conservato
gekreuzt	attraversato
aufsteigend	ascendente
nominal	nominale
zerfallen	decadimento
Quarz	quarzo
Register	registri
achte	ottavo
autorisiert	autorizzato
verbessert	migliora
Befürworter	sostenitori
Phänomene	fenomeni
Neigung	inclinazione
Granit	granito
Volk	masse
Athlet	atleta
Franc	franco
Ähnlichkeit	somiglianza
Leck	perdita
Berater	consigliere
Broschüre	opuscolo
erwartet	aspettandosi
Umsatz	turnover
Urin	urina
Handtuch	asciugamano
Ingwer	Zenzero
Chromosom	cromosoma
als	als
Fliegen	mosche
Kompetenz	competenza
Weinen	pianto
Amateure	dilettanti
Kran	gru
Untersuchung	indagare
faul	marcio
Gewohnheit	abitudine
Ehre	onore
schützt	protegge
Iris	iris
verwaltet	gestisce
Erosion	erosione
Zimmermann	falegname
Khan	caravanserraglio
unzureichend	insufficiente
Formulierung	formulazione
klug	intelligente
Herren	signori
angenehm	piacevole
Halbmond	mezzaluna
sechzig	sessanta
konzentriert	concentrato
unterscheiden	distinguere
ei	EI
Projektionen	proiezioni
Funke	scintilla
Sicherung	fissaggio
Weg	sentiero
Detektoren	rilevatori
Spitze	spuntone
Zutat	ingrediente
Vorhang	tenda
offenbart	divulgato
taktisch	tattico
Piloten	piloti
Expedition	spedizione
operativ	operativo
Humor	umorismo
mol	mol
Impressum	impronta
Unterstützung	assistere
Defekt	difetto
schlecht	male
Göttin	dea
Beobachter	osservatori
Magneten	magneti
Formeln	formule
geräumig	spazioso
argumentiert	sostiene
Böden	suoli
Organe	organi
det	det
Loyalität	lealtà
treu	fedele
Delikt	offesa
Lithium	litio
Sprung	salto
Gründung	fondazione
Schwan	cigno
Pflanzung	piantare
Bündnis	patto
Archäologie	archeologia
Matrose	marinaio
Sorgen	cure
Heiligtum	santuario
Statue	statua
Zitat	Quotazione
Majors	major
Manipulation	manipolazione
Glocken	campane
Toxizität	tossicità
Sender	trasmettitore
Nachbarschaften	quartieri
Trophäe	trofeo
Emotion	emozione
Sehenswürdigkeiten	viste
Uniformen	uniformi
verwundet	ferito
Derivat	derivato
Belegung	occupazione
Dosen	dosi
erziehen	educare
Vorurteil	pregiudizio
Techniker	tecnici
wahrscheinlich	probabile
Ausgabe	emissione
Dekoration	decorazione
Angehörige	cittadini
Trojaner	trojan
Assistenten	assistenti
Berater	consulente
erlassen	promulgato
instabil	instabile
gedrängt	sollecitato
reflektierenden	riflettendo
Gewinnung	guadagnando
endgültig	definitivo
gereist	viaggiato
anpassen	adattare
Beitritt	accessione
Regler	regolatore
Brennstoffe	combustibili
Soja	soia
ordentlich	pulito
Benennung	denominazione
Stern	poppa
gearbeitete	artigianale
Dummkopf	idiota
besteht	composto
Aliens	alieni
Änderungen	modifiche
Rabe	Corvo
Wohnung	dimora
symbolisch	simbolico
Winkel	angoli
Drücke	pressioni
Venus	Venere
Flammen	fiamme
Primitive	primitivo
Strumpf	calza
Ökosystem	ecosistema
Hallen	sale
Einfachheit	semplicità
Dämon	demone
begrüßt	accolto
Notation	notazione
Tante	zia
Krähe	corvo
semantisch	semantico
abgesetzt	interrotto
entscheidet	decide
Globalisierung	globalizzazione
Esel	asini
Kompass	bussola
gewachsen	evoluto
Infanterie	fanteria
berühmt	rinomato
Gang	corridoio
philosophisch	filosofico
Rechtfertigung	giustificazione
unbesetzt	vacante
Festsetzung	fissaggio
Gramm	grammo
versteckt	bastonatura
Farbstoff	colorante
Alphabet	alfabeto
gereinigt	puliti
geehrt	onorato
optisch	ottico
Telefone	telefoni
Tagebücher	diari
Trauer	dolore
Schweiß	sudore
Delphin	delfino
Wunder	meraviglie
Belüftung	ventilazione
Masken	maschere
Büste	busto
Gasse	vicolo
Bahnen	percorsi
Telegraph	telegrafo
Monument	monumento
formal	formalmente
Tau	rugiada
zurückgezogen	ritirato
Debatten	dibattiti
Identitäten	identità
Mangel	carenza
Sattel	sella
Malaria	malaria
treu	leale
Tendenz	tendenza
verwendet	utilizzato
ein	Ein
Fernglas	binocolo
einleiten	iniziato
rein	puramente
lebendig	vivido
Behauptungen	accuse
entspricht	corrisponde
Daemon	demone
gefeiert	celebre
Jäger	cacciatori
handelten	agito
Koeffizient	coefficiente
Schädel	cranio
Fortsetzung	continuazione
Diener	servitore
Falke	falco
gemeinsam	insieme
vermieden	evitato
Erklärungen	spiegazioni
erneuert	rinnovato
Kritiker	critico
Sediment	sedimento
Quadrate	piazze
Lieferwagen	furgoni
Kegel	cono
überlebt	sopravvissuto
Häufigkeit	prevalenza
Fragment	frammento
verpflichtet	impegna
Kobra	cobra
warf	gettò
hoc	hoc
Darsteller	interpreti
Dessert	dolce
Dissertation	dissertazione
neunte	nono
Begeisterung	entusiasmo
Feierlichkeiten	celebrazioni
Gouverneure	governatori
Atome	atomi
Gewebe	tessuti
Rampe	rampa
schön	piacevolmente
della	della
Vorherrschaft	dominio
Akkorde	accordi
Beeinträchtigung	menomazione
Molekül	molecola
