of	od
että	do
sisään	u
varten	za
on	je
päällä	na
että	da
mennessä	po
Tämä	ovaj
kanssa	s
minä	ja
sinä	vas
se	to
tai	ili
olla	biti
olemme	su
at	na
kaikki	svi
omistaa	imati
Uusi	novi
me	mi
tahtoa	htjeti
Koti	Dom
meille	nas
noin	oko
jos	ako
sivu	stranica
minun	moj
on	ima
Hae	traži
vapaa	besplatno
mutta	ali
meidän	naše
yksi	jedan
muut	drugo
tehdä	čini
tiedot	informacija
aika	vrijeme
hän	on
joka	koji
heidän	njihov
uutiset	vijesti
käyttää	koristiti
siellä	tamo
nähdä	vidjeti
niin	tako
Kuka	tko
verkko	mreža
myös	također
saada	dobiti
pm	pm
näkymä	pogled
C	c
e	e
ensimmäinen	prvi
ollut	bila
olisi	bi
olivat	su
s	a
Kuten	Kao
x	x
kuin	od
löytö	pronaći
hinta	cijena
takaisin	leđa
ylin	vrh
ihmiset	narod
oli	imala
lista	popis
nimi	Ime
vain	samo
vuosi	godina
päivä	dan
osaksi	u
kaksi	dva
terveys	zdravlje
n	n
re	ponovno
käytetty	koristi
mennä	ići
b	b
kestää	posljednji
tehdä	napraviti
niitä	ih
pitäisi	treba
tuote	proizvod
järjestelmä	sistem
lähettää	pošta
hänen	nju
kaupunki	Grad
T	t
politiikka	politika
määrä	broj
tuki	podrška
viesti	poruka
jälkeen	nakon
sitten	zatim
tammikuu	siječanj
hyvä	dobro
d	d
missä	gdje
tiedot	Informacije
oikeudet	prava
kirjat	knjige
korkea	visok
koulu	škola
m	m
kukin	svaki
linkit	linkovi
hän	ona
vuotta	godine
tilata	narudžba
erittäin	vrlo
kirja	knjiga
kohdetta	stavke
yhtiö	društvo
R	r
lukea	čitati
ryhmä	skupina
sukupuoli	seks
monet	mnogi
käyttäjä	korisnik
de	de
sarja	set
yleinen	general
tutkimus	istraživanje
yliopisto	sveučilište
tammikuu	siječanj
posti	pošta
koko	puni
arvostelut	recenzije
ohjelmoida	program
tietää	znati
pelit	igre
tapa	put
päivää	dana
p	p
osa	dio
voisi	mogao
loistava	Sjajno
yhdistynyt	ujedinjen
todellinen	stvaran
f	f
kansainvälinen	međunarodna
keskusta	centar
matkustaa	putovati
kommentit	komentari
tehty	napravljen
kehitys	razvoj
raportti	izvješće
jäsen	član
yksityiskohdat	detalji
linja	crta
ehdot	Pojmovi
ennen	prije
hotellit	hoteli
teki	učinio
lähettää	poslati
oikea	pravo
tyyppi	tip
paikallinen	lokalne
nuo	oni
tulokset	rezultati
toimisto	ured
kansallinen	nacionalna
auto	automobil
design	dizajn
ottaa	uzeti
lähetetty	objavljeno
osoite	adresa
Yhteisö	zajednica
sisällä	unutar
valtiot	Države
haluta	željeti
puhelin	telefon
DVD	DVD
aihe	predmet
välillä	između
foorumi	forum
perhe	obitelj
l	l
pitkä	dugo
w	w
show	pokazati
O	o
jopa	čak
musta	crno
erityinen	poseban
indeksi	indeks
ollessa	biće
naiset	žene
paljon	mnogo
merkki	znak
tiedosto	datoteka
linkki	veza
avata	otvoren
etelä	jug
tapaus	slučaj
projekti	projekt
sivut	stranica
versio	verzija
jakso	odjeljak
oma	vlastiti
talo	kuća
turvallisuus	sigurnosti
g	g
lääni	okrug
amerikkalainen	američki
kuva	foto
peli	igra
jäsenet	članovi
teho	vlast
verkko	mreža
tietokone	Računalo
järjestelmät	sustavi
kolme	tri
paikka	mjesto
pää	kraj
h	h
häntä	mu
kohti	po
pääsy	pristup
ajatella	razmišljati
pohjoinen	sjeverno
voimavarat	resursi
nykyinen	Trenutno
iso	velik
tiedotusvälineet	media
laki	zakon
ohjaus	kontrolirati
vesi	voda
historia	povijest
koko	veličina
henkilökohtainen	osobni
opas	vodič
myymälä	dućan
hakemisto	imenik
muuttaa	promijeniti
valkoinen	bijela
teksti	tekst
pieni	mali
luokitus	klijenata
nopeus	stopa
hallitus	vlada
lapset	djeca
palata	povratak
opiskelijoille	studenti
v	v
tili	račun
ajat	puta
taso	nivo
digitaalinen	digitalni
profiili	profil
Edellinen	prijašnji
muoto	oblik
Tapahtumat	događaji
rakkaus	ljubav
vanha	star
Johannes	Ivan
tärkein	glavni
puhelu	poziv
kuva	slika
osasto	odjel
otsikko	titula
ei	ne
K	k
y	y
vakuutus	osiguranje
on	treba
omaisuus	svojstvo
luokka	klasa
CD	CD
laatu	kvaliteta
joka	svaki
listaus	spisak
pitoisuus	sadržaj
maa	zemlja
vähän	malo
Työkalut	alat
matala	nizak
Vastaa	odgovor
asiakas	kupac
joulukuu	prosinac
vertailla	usporediti
elokuvat	filmovi
college	koledž
arvo	vrijednost
artikla	članak
mies	čovjek
työpaikkaa	poslovi
j	j
ruoka	hrana
kirjailija	Autor
eri	drugačiji
U	u
oppia	naučiti
myynti	prodaja
Tulosta	otisak
kurssi	tečaj
Job	posao
huone	soba
kalusto	zaliha
koulutus	trening
liian	isto
luotto	Kreditna
kohta	točka
tiede	znanost
miehet	muškarci
luokat	kategorije
länsi	Zapad
Katso	izgled
Englanti	Engleski
tiimi	tim
omaisuus	imanje
laatikko	kutija
olosuhteet	Uvjeti
Valokuvat	fotografije
homo	homoseksualac
lanka	nit
kategoria	kategorija
Huomautus	Bilješka
elää	uživo
suuri	veliki
galleria	galerija
pöytä	stol
kuitenkin	međutim
kesäkuu	lipanj
lokakuu	listopad
marraskuu	studeni
markkinoida	tržište
kirjasto	knjižnica
toiminta	akcijski
alkaa	početak
sarja	niz
ominaisuudet	značajke
ilma	zrak
ala	industrija
suunnitelma	plan
ihmisen	ljudski
Joo	Da
toinen	drugi
kuuma	vruće
kustannus	cijena
elokuva	film
foorumit	forumi
maaliskuu	ožujak
la	la
syyskuu	rujan
sanoa	reći
menossa	odlazak
lääketieteellinen	medicinski
ystävä	prijatelj
joulukuu	prosinca
palvelin	server
hakemus	primjena
henkilöstö	osoblje
pelata	igra
kysymykset	pitanja
huhtikuu	travanj
käyttäjät	Korisnici
katu	ulica
aihe	tema
vastaan	protiv
sai	dobio
blogi	blog
juhla	Zabava
maksu	plaćanje
laitteet	oprema
antaa	pustiti
ohjelmat	programi
oikeudellinen	pravni
viimeaikainen	nedavni
pysäköidä	park
toimia	čin
ongelma	problem
punainen	Crvena
antaa	dati
muisti	memorija
esitys	izvođenje
sosiaalinen	socijalni
q	q
tarina	priča
myydä	prodavati
vaihtoehtoja	opcije
kokea	iskustvo
avain	ključ
ruumis	tijelo
nuori	mladi
tärkeä	važno
ala	polje
harvat	nekoliko
itään	istočno
yksittäinen	singl
ii	ii
ikä	dob
klubi	klub
esimerkki	primjer
tytöt	djevojke
z	z
tie	cesta
lahja	dar
kysymys	pitanje
ca	ca
kova	teško
maksaa	platiti
neljä	četiri
pokeri	poker
ongelma	problem
alue	opseg
rakennus	zgrada
myyjä	prodavač
tuomioistuin	sud
helmikuu	veljača
tulos	proizlaziti
valo	svjetlo
kirjoittaa	pisati
sota	rat
tarjous	ponuda
sininen	plava
ryhmät	grupe
ai	al
helppo	lako
tietty	dan
pyyntö	zahtjev
faksi	faks
Kiina	Kina
tehdä	izrađivanje
kuva	slika
tarpeisiin	potrebe
mahdollinen	moguće
kuukausi	mjesec
suuri	glavni
tähti	zvijezda
tulevaisuus	budućnost
tila	prostor
komitea	odbor
käsi	ruka
aurinko	Sunce
kortit	kartice
Lontoo	London
tapaaminen	sastanak
tulla	postati
lapsi	dijete
pitää	zadržati
porno	pornografija
Jaa	udio
samankaltainen	sličan
puutarha	vrt
koulut	škola
miljoona	milijuna
lisättyä	dodano
viite	upućivanje
yritykset	tvrtke
vauva	dijete
oppiminen	učenje
energia	energija
juosta	trčanje
toimitus	dostava
suosittu	popularan
termi	termin
elokuva	film
tarinoita	priče
laittaa	staviti
päiväkirja	časopis
raporttien	izvještaji
co	ko
yrittää	probati
kuvien	slika
ilmoitus	obavijest
Jumala	bog
alkuperäinen	izvornik
pää	glava
radio	radio
solu	ćelija
neuvosto	vijeće
sisältää	uključuje
seurata	staza
keskustelu	rasprava
arkisto	arhiva
toiset	drugi
sopimus	sporazum
muoto	format
yhteiskunta	društvo
kuukaudet	mjeseci
turvallisuus	sigurnosni
ystävät	prijatelji
varma	Naravno
painos	izdanje
viestien	poruke
markkinointi	Marketing
kertoa	reći
yhdistys	asocijacija
tarjoaa	pruža
hauska	zabava
jo	već
vihreä	zelena
opinnot	studije
kiinni	Zatvoriti
yhteinen	uobičajen
erityinen	specifično
useat	nekoliko
elävä	život
kokoelma	kolekcija
nimeltään	zvao
lyhyt	kratak
arts	umjetnost
erä	mnogo
kysyä	pitati
rajallinen	ograničen
ratkaisut	rješenja
johtaja	direktor
ranta	plaža
menneisyys	prošlost
luonnollinen	prirodni
elektroniikka	elektronika
päälle	na
aika	razdoblje
suunnittelu	planiranje
sanoo	kaže
virallinen	službeno
maaliskuu	pokvariti
tehty	učinio
tekninen	tehnička
ikkuna	prozor
ammattilainen	profesionalac
alue	regija
saari	otoka
ennätys	snimiti
suoraan	direktno
konferenssi	konferencija
asiakirjat	ploče
st	st
piiri	okrug
kalenteri	kalendar
kustannukset	troškovi
tyyli	stil
selvitys	izjava
mailia	milja
resurssi	resurs
sovellukset	aplikacije
asiakirja	dokument
sana	riječ
teokset	djela
materiaali	materijal
laskuttaa	račun
kirjallinen	napisan
säännöt	pravila
lopullinen	konačni
asia	stvar
keskusta	centar
vaatimuksista	zahtjevi
TOTTA	PRAVI
minuutit	minuta
muu	drugo
merkki	ocjena
rock	stijena
huono	loše
yksilö	pojedinac
plus	plus
auto	auto
peite	pokriti
muokata	Uredi
yhdessä	zajedno
Videot	video
nopeasti	brzo
toiminto	funkcija
tosiasia	činjenica
saada	uzimajući
maailmanlaajuinen	globalno
teknologia	tech
tavata	sastati
pitkälle	daleko
taloudellinen	ekonomski
fi	hr
pelaaja	igrač
hankkeet	projekti
määrä	iznos
katsella	Gledati
Sisältää	uključen
tuntea	osjetiti
pankki	banka
riski	rizik
tarjoukset	Popularna
eri	raznovrstan
sanat	riječi
tuotanto	proizvodnja
kaupallinen	trgovački
paino	težina
sydän	srce
hoito	liječenje
pistettä	bodova
tuntemus	znanje
aikakauslehti	časopis
virhe	greška
kamera	fotoaparat
tyttö	djevojka
rakentaminen	izgradnja
lelut	igračke
kirjattu	zabilježen
verkkotunnuksen	domena
menetelmät	metode
luku	poglavlje
suojaus	zaštita
politiikkaa	politika
leveä	širok
kauneus	ljepota
johtaja	menadžer
Intia	Indija
asento	položaj
otettu	poduzete
järjestellä	vrsta
listat	oglasi
tunnettu	znan
puoli	pola
tapauksissa	slučajevi
vaihe	korak
tekniikka	inženjering
yksinkertainen	jednostavan
nopea	brz
lisenssi	licenca
järvi	jezero
koko	čitav
vuotuinen	godišnji
julkaistu	Objavljeno
kirkko	crkva
menetelmä	način
aktiivinen	aktivan
vastaus	odgovor
kuva	lik
tarvikkeet	materijali
tarpeeksi	dovoljno
suunnitellut	konstruiran
keskuudessa	među
kuolema	smrt
menetys	gubitak
kasvot	lice
brändi	marka
alennus	popust
tehosteet	efekti
luotu	stvorio
standardit	standardi
bitti	bit
poliittinen	politički
kuningaskunta	kraljevstvo
pohja	baza
tekemässä	rade
lainat	krediti
kengät	cipele
merkintä	ulaz
pysyä	boravak
tilaukset	narudžbe
saatavuus	dostupnost
yhteenveto	Sažetak
vuoro	skretanje
kasvu	rast
toimisto	agencija
kuningas	kralj
eurooppalainen	europska
aktiviteetti	aktivnost
kopio	kopirati
Läntinen	zapadni
pakottaa	sila
työllisyys	zapošljavanje
lahti	zaljev
joki	Rijeka
komissio	komisija
paketti	paket
nähdään	vidio
pelaajat	igrači
moottori	motor
portti	luka
albumi	album
alueellinen	Regionalni
Stop	Stop
aloitti	počeo
antaminen	uprava
baari	bar
instituutti	institut
näkymät	pregleda
kaksinkertainen	dvostruko
koira	pas
pian	uskoro
linjat	linije
elektroninen	elektronička
hyötyjä	prednosti
tarvittu	potreban
kirjoitin	printer
kunto	stanje
tehokas	djelotvoran
uskoa	vjerovati
organisaatio	organizacija
vaikutus	posljedica
mieli	um
valinta	izbor
kasino	kasino
PDF	pdf
kiertue	obilazak
ylittää	križ
toivoa	nada
yhtiö	korporacija
toive	želja
ratkaisu	riješenje
kypsä	zreo
rooli	uloga
viikkoa	tjedni
tietty	siguran
alempi	niži
välttämätön	potreban
liitto	unija
mon	mon
com	com
tietty	posebno
hieno	fino
tunnin	sat
kaasu	plin
taidot	vještine
kuusi	šest
Puska	grm
saaret	otoci
neuvot	savjet
ura	karijera
päätös	odluka
jättää	napustiti
pre	prije
valtava	ogroman
nainen	žena
laitteisto	postrojenja
tarjous	ponuda
keskimmäinen	srednji
kaapeli	kabel
mahdollisuudet	prilike
ottaen	uzimanje
arvot	vrijednosti
jako	podjela
tuleva	dolazak
esine	objekt
lesbo	lezbijka
sopiva	prikladan
kone	mašina
logo	logo
pituus	dužina
kiva	Lijepo
pisteet	postići
tilasto	statistika
asiakas	klijent
näyte	uzorak
investointi	ulaganje
lähetetty	poslao
esitetty	prikazan
joulu	Božić
kulttuuri	Kultura
salama	bljesak
neiti	ms
valinta	izbor
kurssit	tečajevi
kuluttaja	potrošač
Moi	bok
ulkomainen	strana
taiteilija	umjetnik
huonekalut	namještaj
kanava	kanal
kirje	pismo
tila	način
puhelimet	telefoni
ideoita	ideje
rakenne	struktura
aste	stupanj
sopimus	ugovor
Super	super
Uros	muški
asia	stvar
melkein	skoro
sijaitsevat	nalazi
moninkertainen	višekratnik
jakelu	distribucija
toimittaja	urednik
majatalo	gostionica
teollinen	industrijski
mahdollinen	potencijal
laulu	pjesma
los	los
pudota	pad
ajatus	ideja
Huoneet	sobe
viestintä	komunikacije
voittaa	pobijediti
ensisijainen	osnovni
syöpä	Rak
numerot	brojevi
syy	razlog
työkalu	alat
kevät	Proljeće
perusta	temelj
vastaus	odgovor
ääni	glas
ajoittaa	raspored
asiakirjat	dokumenti
tarkoitus	Svrha
ominaisuus	svojstvo
sänky	krevet
tulee	dolazi
Poliisi	policija
itsenäinen	samostalan
lähestyä	pristup
ruskea	smeđ
fyysinen	fizička
mäki	brdo
kartat	Karte
pitää	držati
luokitukset	ocjene
onnellinen	sretan
seppä	kovač
kehittyneillä	razvijen
kiittää	zahvaliti
turvallinen	sef
ainutlaatuinen	jedinstvena
tutkimus	pregled
ennen	prije
puhelin	telefon
Urheilu	sport
valmis	spreman
eläin	životinja
lähteet	izvori
väestö	populacija
pa	godišnje
säännöllinen	redovan
turvallinen	siguran
toiminnot	operacije
yksinkertaisesti	jednostavno
näyttö	dokaz
asema	stanica
ymmärtää	razumjeti
vaihtoehto	opcija
laakso	dolina
todennäköisesti	vjerojatno
meri	more
Julkaisut	publikacije
parantaa	poboljšati
yhteys	veza
kustantaja	izdavač
sali	dvorana
anti	anti
verkot	mreže
maa	Zemlja
vanhemmat	roditelji
vaikutus	udarac
siirtää	prijenos
esittely	Uvod
keittiö	kuhinja
vahva	jak
häät	vjenčanje
ominaisuudet	nekretnine
sairaala	bolnica
maa	tlo
alus	brod
majoitus	smještaj
tauti	bolest
erinomainen	izvrstan
täydellinen	savršen
hiukset	dlaka
tilaisuus	prilika
pakki	oprema
klassikko	klasik
perusta	osnova
komento	naredba
kaupungit	gradovi
ilmaista	izraziti
myöntää	dodijeliti
etäisyys	udaljenost
puu	drvo
arviointi	procjena
seinä	zid
osallistuva	umiješan
el	el
ylimääräinen	ekstra
erityisesti	posebno
talousarvio	budžet
oppaita	vodiči
menestys	uspjeh
enimmäismäärä	maksimum
äiti	majka
operaatio	operacija
nykyinen	postojanje
melko	dosta
valittu	odabran
poika	dječak
ravintolat	restorani
kaunis	lijep
Varoitus	upozorenje
sijainnit	lokacije
hevonen	konj
äänestys	glasanje
kukat	cvijeće
tähdet	zvijezde
luettelot	arena
omistaja	vlasnik
eläimet	životinje
tapoja	načine
poika	sin
tarjoaminen	pružanje
sääntö	Pravilo
kotelo	kućište
kestää	traje
tuoda	donijeti
luettelo	katalog
max	maksimum
äiti	majka
auktoriteetti	vlast
kertoi	rekao
ohjelmoida	program
liittyi	spojen
panos	ulazni
strategia	strategija
jalkaa	noge
agentti	agent
pätevä	vrijedi
moderni	moderan
vanhempi	stariji
seksikäs	seksi
opetus	nastava
ovi	vrata
suuri	veličanstven
oikeudenkäynti	suđenje
yksiköt	jedinice
viileä	svjež
normaali	normalan
yritys	poduzeće
laivat	brodovi
koko	čitav
positiivinen	pozitivan
kunto	sposobnost
Kiinalainen	kineski
lausunto	mišljenje
jalkapallo	nogomet
abstrakti	sažetak
ulostulo	izlaz
varat	fondovi
Herra	mr
todennäköisesti	Vjerojatno
kehittää	razviti
Taiteilijat	izvođači
vaihtoehto	alternativa
vastuu	odgovornost
Jaava	Java
vieras	gost
julkaisu	objavljivanje
kulkea	proći
suhteet	odnosi
luottamus	povjerenje
pakettiauto	kombi
sisältää	sadrži
multi	multi
tasavalta	republika
palkkiot	naknada
komponentit	komponente
loma	odmor
vuosisata	stoljeće
akateeminen	akademski
apu	pomoć
valmistunut	dovršen
iho	koža
grafiikka	grafika
intialainen	Indijanac
rengas	prsten
arvosana	razred
vuori	planina
organisaatioiden	organizacija
suodattaa	filtar
paneeli	ploča
lattia	kat
ostaminen	kupovina
ottelu	utakmica
ehdotettu	zaprosio
vaatia	zahtijevati
pojat	dječaci
aamu	jutro
sallii	omogućuje
proteiini	protein
kasvi	biljka
raportoitu	izvijestio
osuma	pogoditi
mm	mm
pool	bazen
mini	mini
politiikka	politika
kumppani	partner
kirjoittajat	autori
levyt	ploče
kalastaa	riba
jäsenyys	članstvo
tehtävä	misija
silmä	oko
jono	niz
tunne	osjećaj
muokattu	promijenjen
julkaisi	oslobođen
vaihe	faza
sisäinen	interni
syntynyt	rođen
yksityiskohtainen	detaljan
japanilainen	japanski
rotu	utrka
hyväksytty	odobren
kohde	cilj
paitsi	osim
merkki	lik
ylläpito	održavanje
kyky	sposobnost
toim	ed
raiskata	silovanje
akku	baterija
nuoret	mladež
paine	pritisak
toimitettu	podnijeti
velka	dug
keskikokoinen	srednji
televisio	televizija
kiinnostunut	zainteresiran
ydin	srž
tauko	pauza
tarkoituksiin	svrhe
setit	setovi
tanssi	ples
puu	drvo
määritellyt	definiran
paperit	novine
palkinnot	nagrade
maksu	pristojba
studio	studio
lukija	čitač
laite	uređaj
perusti	osnovan
vastauksia	odgovori
vuokrata	najam
las	las
tumma	mrak
ulkoinen	vanjski
omena	jabuka
le	le
ohjeet	instrukcije
min	min
tarjotaan	ponudio
teoria	teorija
poistaa	ukloniti
apu	pomoć
visuaalinen	vidni
isäntä	domaćin
lajike	raznolikost
opettajat	učitelji
manuaalinen	priručnik
lohko	blok
aiheita	teme
aineet	agenti
korjaus	popravak
oikeudenmukainen	pravedan
teräs	željezo
ymmärtäminen	razumijevanje
lauluja	Pjesme
kiinteä	fiksni
väärä	pogrešno
alku	početak
käsissä	ruke
az	AZ
Pariisi	Pariz
saa	dobiva
sektori	sektor
kapasiteetti	kapacitet
un	uN
rasva	mast
isä	otac
sähköinen	električni
näin	pila
välineet	instrumenti
upseeri	časnik
kuljettaja	vozač
yritykset	poduzeća
kuollut	mrtav
tuntematon	nepoznat
ravintola	restoran
mikrofoni	mikrofon
matka	putovanje
mi	mi
huono	siromašan
yhteys	odnos
työntekijöiden	radnici
rauha	mir
perinteinen	tradicionalan
osoittavat	pokazivanje
luova	kreativan
rannikko	obala
hyöty	korist
rahoitus	financiranje
laitteet	uređaji
herra	gospodar
myöntää	odobriti
sub	pod
kaunokirjallisuus	fikcija
kellot	satovi
uraa	karijere
menee	ide
led	vodio
museo	muzej
tuuletin	ventilator
kuljetus	prijevoz
mielenkiintoista	zanimljiv
blogit	blogovi
arviointi	procjena
entinen	prijašnji
vyöhyke	zona
monimutkainen	kompleks
th	th
kissa	mačka
kuolla	umrijeti
esittelyyn	predstavili
tasainen	ravan
virtaus	teći
virastojen	agencije
kirjallisuus	književnost
vanhempi	roditelj
asetus	postavljanje
DR	doktor
asteikko	ljestvica
talous	Ekonomija
hyödyllinen	koristan
kuukausittain	mjesečno
kriittinen	kritično
kehys	okvir
musikaali	mjuzikl
määritelmä	definicija
sihteeri	tajnica
polku	staza
päällikkö	glavni
antaa	daje
paketit	paketi
yksityiskohta	detalj
lait	zakoni
muutettu	promijenjen
alkaa	početi
kuninkaallinen	kraljevski
puhdas	čist
kaveri	momak
otsikot	naslovi
merkityksellinen	relevantan
oikeudenmukaisuus	pravda
kytkeä	Spojiti
kuppi	kupa
kori	košara
soveltava	primijenjen
viikoittain	tjedni
vol	vol
asennus	montaža
pp	str
huomio	pažnja
edetä	napredovati
hyppiä	preskočiti
ruokavalio	dijeta
armeija	vojska
vaihde	zupčanik
ero	razlika
sallittu	dopušteno
oikea	ispravan
kansakunta	narod
myynti	prodaja
paljon	mnogo
pala	komad
arkki	list
yritys	firma
seitsemän	sedam
elementtejä	elementi
laji	vrsta
hypätä	skok
solut	Stanice
moduuli	modul
lomakeskus	pribjeći
todistus	potvrda
ministeri	ministar
liike	pokret
muoti	moda
ohjeet	smjerovi
vierailijat	posjetitelji
dokumentointi	dokumentacija
kaupankäynti	trgovački
metsä	šuma
puhelut	pozivi
kattavuus	pokrivenost
pari	par
antaminen	davanje
mahdollisuus	prilika
näkemys	vizija
pallo	lopta
pääte	završni
asiakkaat	klijenti
toimet	akcije
keskustella	raspravljati
tavoite	cilj
onnistunut	uspješan
myyty	prodan
tuuli	vjetar
yhteisöt	zajednice
kliininen	klinički
tilanne	situacija
markkinat	tržišta
kustannustoiminta	objavljivanje
ilmestyä	pojaviti
kehittämällä	razvoju
elämää	život
määrittää	odrediti
lämpötila	temperatura
ilmoitukset	najave
potilas	pacijent
todellinen	stvaran
historiallinen	povijesni
kivi	kamen
Bob	bob
kaupankäynti	trgovina
henkilöt	osobe
vaikea	težak
tieteellinen	znanstvena
satelliitti	satelit
testit	testovi
kylä	selo
tilit	računi
amatööri	amater
entinen	ex
tavannut	sastali
kipu	bol
tekijät	čimbenici
kahvi	kava
ostaja	kupac
juliste	poster
reuna	rub
toiminnallinen	funkcionalna
juuri	korijen
fi	fi
suljettu	zatvoreno
juhlapäivät	Praznici
vaaleanpunainen	ružičasta
saldo	ravnoteža
seuranta	nadgledanje
vastaukset	odgovora
laukaus	šut
alkukirjain	početni
etiketti	označiti
sec	sek
kaanon	kanon
liiga	liga
jätteet	gubljenje
minuutti	minuta
bussi	autobus
toimittaja	usluga
sanakirja	rječnik
kirjanpito	računovodstvo
valmistus	proizvodnja
osiot	dijelovi
tuoli	stolica
ponnistus	napor
vaihe	faza
fantasia	fantazija
po	PO
va	va
professori	profesor
Asentaa	instalirati
paita	košulja
vaatteet	odjeća
jalka	noga
rinta	grudi
tekniikat	Tehnike
dollaria	dolara
uskonto	religija
lupa	dopuštenje
villi	divlji
sukupolvi	generacija
neiti	propustiti
kemiallinen	kemijski
lääkäri	liječnik
tehtävä	zadatak
vähentää	smanjiti
toi	donio
liikunta	vježba
vika	buba
takuu	jamčiti
johtaja	vođa
SE	sebi
prosessit	procesi
pehmeä	mekan
kokoukset	sastanci
sekuntia	sekundi
lento	let
kongressi	kongres
polttoaine	gorivo
kävellä	hodati
valmistettu	izrađen
pyhimys	svetac
Perustelu	argument
kilpailu	konkurencija
huumeita	lijekovi
yhteinen	zajednički
palkkio	premija
tuore	svježe
merkkiä	likovi
asianajaja	pravnik
di	di
tekijä	faktor
tuhansia	tisuća
km	km
virta	potok
huoneisto	apartmani
valita	odabrati
kuulo	sluh
itäinen	istočni
terapia	terapija
merkinnät	unosi
allekirjoitettu	potpisan
hallinnollinen	upravni
vakava	ozbiljan
raja	ograničiti
askeleet	koraci
kaupat	trgovine
orjuus	ropstvo
del	del
pyrkimyksiä	napori
ilmoitti	informiran
ga	gA
ajatuksia	misli
puro	potok
ft	ft
määrä	količina
olennainen	osnovni
matkat	ture
ladata	opterećenje
heti	odmah
koneet	strojevi
nimetty	određen
raskas	teško
katettu	pokriven
elpyminen	oporavak
integroitu	integriran
kokoonpano	konfiguracija
kukko	penis
kauppias	trgovac
kattava	opsežan
asiantuntija	stručnjak
suojella	zaštititi
vankka	solidan
esittely	prezentacija
tuli	postao
oranssi	narančasta
noudattaminen	usklađenost
teema	tema
rikas	bogat
kampanja	kampanja
vs	vs
kitara	gitara
havainto	nalaz
esimerkkejä	primjeri
henki	duh
ar	ar
vaatimukset	zahtjevi
hyväksyminen	prihvaćanje
strategiat	strategije
mo	mj
asioihin	poslovi
tarkoitettu	namijenjen
sa	sa
tavoitteet	ciljevi
vuokraus	najam
vaalit	izbor
ehdottaa	predložiti
haara	podružnica
palvella	poslužiti
Kumppanit	podružnice
asentaa	montiranje
Latina	latinski
multimedia	multimedijalni
hoitaa	upravljati
kulma	ugao
arvo	rang
elementti	element
syntymä	rođenja
virus	virus
interaktiivinen	interaktivni
pyynnöt	zahtjevi
erillinen	odvojen
neljännes	četvrtina
menettely	postupak
johto	rukovodstvo
määritellä	definirati
uskonnollinen	vjerski
tosiasiat	činjenicama
aamiainen	doručak
sarake	kolona
usko	vjera
ketju	lanac
tunnistaa	identificirati
katu	avenija
puuttuva	nedostaje
suosituksia	preporuke
siirretty	pomaknuto
saavuttaa	dohvatiti
vertailu	usporedba
hetki	trenutak
laajennettu	produžen
jakso	slijed
tuuma	palac
hyökkäys	napad
keskuksissa	centri
aukko	otvor
laboratorio	laboratorija
varata	rezerva
gamma	gama
tuottaa	proizvoditi
totuus	istina
laskuri	brojač
vika	neuspjeh
seuraa	slijedi
dollari	dolar
leiri	kamp
des	des
elokuvat	filmovi
silta	most
täyttää	ispuniti
liike	pokret
painaminen	tiskanje
luonnos	Nacrt
kartoittaa	grafikon
pelataan	igrao
yhteystiedot	kontakti
lukijoita	čitači
risti	klubovi
wa	wa
seikkailu	avantura
uhri	ponuda
voitto	dobit
johtajat	čelnici
Julisteet	plakati
laitokset	institucije
avustaja	asistent
muuttuja	varijabla
dj	dj
pysäköinti	parkiralište
eilen	jučer
määritetty	odlučan
työpaja	radionica
mennyt	otišao
koodit	kodovi
Erilaisia	vrste
laajentaminen	nastavak
lausuntoja	izjava
täysin	potpuno
joukkueet	timovi
linnake	tvrđava
cm	cm
senaatti	senat
hauska	smiješno
geeni	gen
kääntyi	okrenut
levy	disk
kuvio	uzorak
vene	čamac
teatteri	kazalište
valmistajat	proizvođači
sponsori	sponzor
klassinen	klasična
ikoni	ikona
takuu	garancija
omistautunut	posvećen
suunta	smjer
koripallo	košarka
esineet	objekti
poistaa	izbrisati
ilta	večer
kokoonpano	skupština
ydinaseiden	nuklearni
hiiri	miš
signaali	signal
rikollinen	kriminalac
annettu	izdaje
voimakas	snažan
unelma	san
VÄÄRÄ	NETOČNO
da	da
heittää	baciti
kukka	cvijet
henkilöstö	osoblje
läpäissyt	prošao
toimitetaan	isporučuje
Falls	Slapovi
sielu	duša
edistää	unaprijediti
totesi	navedeno
tilastot	statistika
ammattilaisten	profesionalci
näyttää	Čini
kuljettaa	nositi
lippu	zastava
kannet	korice
em	em
etu	prednost
Hei	zdravo
malleja	dizajna
ylläpitää	održavati
matkailu	turizam
prioriteetti	prioritet
aikuiset	odrasli
graafinen	grafički
atomi	atom
maksut	plaćanja
sitova	vezivanje
lyhyt	kratak
päättyi	završeno
voittoisa	osvajanjem
anonyymi	anoniman
käsikirjoitus	skripta
palveli	služio
haluaa	želi
valmis	pripremljen
mitätön	poništiti
tag	označiti
haastatella	intervju
sekoittaa	miješati
puitteet	okvir
levy	disk
asennetut	instaliran
kuningatar	kraljica
ov	krediti
selvästi	jasno
korjata	popraviti
kahva	rukovati
makea	slatko
kriteeri	kriteriji
kumppani	suradnik
NE	NE
käytös	ponašanje
suurentaa	uvećati
säde	zraka
tulot	prihod
mitata	mjera
ääntä	glasova
du	du
velvollisuus	dužnost
keskustelut	rasprave
karhu	snositi
saada	dobit
festivaali	festival
laboratorio	laboratorija
valtameri	ocean
lennot	letovi
asiantuntijat	stručnjaci
merkkejä	znakovi
syvyys	dubina
kouluttaa	vlak
kuiva	suho
tutkia	istražiti
kylpylä	banja
konsepti	koncept
lähes	skoro
käsittely	rukovanje
alkuperä	podrijetlo
miljardi	milijardi
älykkyys	inteligencija
ostettu	kupio
huijaus	protiv
kansakunnat	nacije
reitti	put
rikki	slomljen
taistelu	bitka
puhua	govoriti
protokolla	protokol
tiedustelu	pitanje
kumppanuus	partnerstvo
ilmaisu	izraz
es	es
puhe	govor
johdin	žica
ehdotukset	prijedlozi
korvaus	zamjena
nauha	traka
strateginen	strateški
tuomari	suditi
happo	kiselina
tavua	bajtova
sentti	cent
pakko	prisiljeni
yhteensopiva	kompatibilan
huoneisto	apartman
tyhjä	nula
nolla	nula
kaiutin	zvučnik
konsultointi	savjetodavni
suunnittelija	dizajner
PR	pr
avioliitto	brak
rulla	svitak
pankit	banke
FR	fr
osallistujaa	sudionici
salaisuus	tajna
negatiivinen	negativan
suosikit	favoriti
teatteri	kazalište
jouset	izvori
var	var
suorittaa	izvesti
käännös	prijevod
arvioiden	procjene
vahinko	ozljeda
ministeriö	ministarstvo
kuljettajat	vozači
lakimies	odvjetnik
luvut	figure
suojattu	zaštićen
ehdotus	prijedlog
jakaminen	dijeljenje
portaali	portal
beeta	beta
ilmaiseksi	besplatno
kohti	prema
hieman	malo
avustaa	pomoći
käytös	ponašanje
sisälsi	sadržane
lainsäädäntö	zakonodavstvo
kutsumus	zvanje
parametrit	parametri
profiilit	profili
asioissa	pitanja
talot	kuća
ohjaimet	kontrole
Yhdistetty	kombinirana
perimmäinen	ultimativno
edustaja	predstavnik
vähäinen	manji
osastot	odjeli
asukkaat	stanovnici
näyttöön	prikazati
äiti	mama
pelkistetty	smanjen
harvinainen	rijedak
suoritettu	izvedena
äärimmäinen	krajnost
näytteet	uzorci
baarit	barovi
ennuste	prognoza
poistettu	ukloniti
sykli	ciklus
sisältää	sadržati
tarkkuus	točnost
nukkua	spavati
mg	mg
lintu	ptica
apteekki	ljekarna
luominen	stvaranje
staattinen	statički
metsästäjä	Lovac
osoitteet	adrese
nainen	dama
kristalli	kristal
kuuluisa	poznat
kirjailija	pisac
puheenjohtaja	predsjednik
juoda	piće
akatemia	akademija
dynaaminen	dinamičan
syödä	jesti
pysyvä	trajan
puhdistus	čišćenje
muodostaa	tvori
salkku	portfelj
käytännöllinen	praktičan
toimitetaan	isporučena
infrastruktuuri	infrastruktura
väri	boja
myyjä	prodavač
filosofia	filozofija
säätö	regulacija
upseerit	službenici
tavoite	cilj
tarjouksia	ponude
ravitsemus	ishrana
äänite	snimanje
nuorempi	mlađi
les	les
viitta	rt
renkaat	prstenovi
kärki	Savjet
ihana	predivan
lippu	ulaznica
ilmoitti	najavio
arvaus	nagađati
ketä	kome
jalkapallo	nogomet
matematiikka	matematika
tuonti	uvoz
komennus	postavljanje
läsnäolo	prisutnost
Automaattinen	automatski
katselu	gledanja
säilyy	održavati
ch	CH
dan	Dan
koirat	psi
johtajat	direktori
näkökohdat	aspekti
eteenpäin	naprijed
kuu	mjesec
osallistumista	sudjelovanje
ohjelma	shema
lentää	letjeti
tapa	držanje
matriisi	matrica
yhdistelmä	kombinacija
muutos	amandman
vahvuus	snaga
Turkki	purica
kirjastot	knjižnice
asianmukainen	ispravan
astetta	stupnjeva
yrityksille	poduzeća
delta	delta
pelko	strah
etsiä	traži
tuumaa	inča
sopimus	konvencija
osakkeiden	dionice
pääasiallinen	glavni
mukavuus	udobnost
värit	boje
sodat	ratovi
tilaaminen	naručivanje
säilytetään	čuva
alfa	alfa
valitus	apel
risteily	krstarenje
bonus	bonus
Hei	ej
rakennukset	građevine
tarjoukset	specijalaca
lyödä	pobijediti
akut	baterije
tulee	postaje
asemat	diskovi
aseet	oružje
tee	čaj
parantunut	poboljšan
saavuttaa	postići
kannat	pozicije
pukeutua	haljina
tilaus	pretplata
jakaja	prodavač
nykyajan	suvremeni
taivas	nebo
rom	ROM
kuljettaa	prenosi
valotus	izlaganje
piilottaa	sakriti
allekirjoitus	potpis
mylläri	mlinar
säännös	opskrba
vaatteet	odjeća
kehyksiä	okviri
varmasti	sigurno
sanomalehti	novine
lelu	igračka
kerros	sloj
painettu	tiskan
hidas	usporiti
poistaminen	uklanjanje
vastuu	odgovornost
tulostimet	pisači
lisäämällä	dodajući
täplä	mjesto
viettää	potrošiti
tehdas	tvornica
sisusta	unutrašnjost
kasvaa	rasti
optinen	optički
edistäminen	promocija
suhteellinen	rođak
hämmästyttävä	nevjerojatan
piste	točka
identiteetti	identitet
muuntaminen	pretvaranje
tunne	osjećaj
kätketty	skriven
kohtuullinen	razuman
tarkistus	revizija
vaikutus	utjecaj
suhde	omjer
merkitys	važnost
sade	kiša
planeetta	planeta
kappaletta	kopije
lupa	dozvola
koska	vidim
todiste	dokaz
basso	bas
resepti	recept
tyhjä	prazan
ilmentymä	primjer
reikä	rupa
ratsastaa	vožnja
toimisto	zavod
säilyttäminen	konzervacija
pari	par
ihanteellinen	idealan
silmälasit	naočale
tallennettu	zabilježena
Don	Don
kappaletta	komada
päättynyt	gotov
puistot	parkovi
lakimiehet	odvjetnici
stressi	stres
kerma	krema
ss	ss
ajot	radi
löytää	otkriti
ap	ap
kuviot	obrasci
Hills	brda
nm	nm
neuvonantaja	savjetnik
tietoinen	svjestan
muoto	oblik
evoluutio	evolucija
todistukset	potvrde
tavoitteet	ciljevi
asemat	stanice
ehdotti	predložio
op	op
jäännökset	ostaci
yritykset	tvrtke
euro	euro
operaattori	operater
rakenteet	strukture
yleinen	opći
tietosanakirja	enciklopedija
käyttö	upotreba
muste	tinta
sekoitettu	mješovit
väestönlaskenta	popis
pyörä	kotač
toimittajat	dobavljači
kompakti	kompaktan
runous	poezija
valot	svjetla
seuranta	praćenje
enkeli	anđeo
valmistautuminen	priprema
yrittää	pokušaj
vastaanotetaan	primanje
Ottelut	šibice
mukaisesti	suglasnost
leveys	širina
moottorit	motori
unohtaa	zaboraviti
ryhmä	red
keskusteltiin	raspravljati
tarkka	točan
ilmasto	klima
kreikkalainen	grčki
ohje	instrukcija
hallinnassa	upravljanje
raaka	sirov
erot	Razlike
selittää	objasniti
perustaa	uspostaviti
ilmaisi	izrazio
laajuus	opseg
terävä	oštar
ben	Ben
kohta	stav
tappaa	ubiti
matematiikka	matematika
korvaus	kompenzacija
viedä	izvoz
johtajat	menadžeri
moduulit	moduli
suoritettu	provedena
versiot	verzije
tietää	zna
kuvata	opisati
kansalaiset	građani
perintö	nasljeđe
vaivata	nevolja
valmentaja	trener
maatalous	poljoprivredni
laajentaa	proširiti
yleisö	publika
osoitettu	dodijeljena
kokoelmat	zbirke
iät	dobi
asiantuntija	specijalista
kokki	kuhati
vaikuttaa	utjecati
Neitsyt	Djevica
kokenut	iskusan
tutkimus	istraga
nosti	uzdignut
hattu	šešir
instituutio	institucija
suunnattu	usmjerene
vaikuttaa	pogođeni
pyörä	bicikl
täysin	potpuno
levy	ploča
kulut	troškovi
osoittaa	naznačiti
vaalea	plavuša
menettely	postupak
suosikki	ljubimac
ominaisuudet	karakteristike
der	der
menettää	izgubiti
orgaaninen	organski
etsiä	tražiti
kokemukset	iskustva
albumit	albuma
sopimuksia	ugovori
vieraita	gosti
isännöi	domaćin
sairaudet	oboljenja
koskevat	o
vastaava	ekvivalent
kemia	kemija
sarjat	setove
logiikka	logika
prinssi	princ
ympyrä	krug
maaperä	tlo
psykologia	psihologija
märkä	mokar
olosuhteet	okolnosti
sijoittaja	investitor
perus	osnovni
sponsorit	sponzori
kettu	lisica
rajoittamaton	neograničen
vastata	odgovarati
koot	veličine
tavallinen	običan
poistuminen	Izlaz
käsivarsi	ruka
näppäimet	ključevi
Aalto	val
pyhä	svet
säädökset	djela
opastus	vođenje
polku	trag
symboli	simbol
valtatie	autocesta
havaitun	promatranom
dekaani	dekan
perustaa	postaviti
äänestys	anketa
tyylit	stilovi
täynnä	ispunjen
side	veza
kanavat	kanali
liite	dodatak
suklaa	čokolada
osa	dio
laajuus	djelokrug
toimittaja	dobavljač
kaapelit	kabeli
puuvilla	pamuk
vaatimus	zahtjev
surmattu	ubijen
reunus	granica
muinainen	antički
keskustelu	debata
edustajia	predstavnici
alkaa	počinje
raskaus	trudnoća
nähtävyydet	atrakcije
oppinut	naučeno
liiketoimet	transakcije
tutkimusmatkailija	istraživač
historiallinen	povijesni
aviomies	suprug
valtuutettu	odobren
hullu	lud
tuleva	Nadolazeći
konsertti	koncert
tulokset	rezultate
tehokkuus	efikasnost
komedia	komedija
hyväksyttiin	usvojen
tehokas	učinkovit
lineaarinen	linearan
sitoutuminen	opredjeljenje
erikoisuus	specijalitet
karhut	medvjedi
hypätä	hmelj
kantaja	prijevoznik
jatkuva	konstantno
Visa	Visa
suu	usta
mittari	metar
sidoksissa	povezan
haastattelut	razgovori
käsitteet	pojmovi
ase	puška
heijastaa	odraziti
puhdas	čist
helvetti	pakao
hedelmä	voće
alkaa	počinje
pätevä	kvalificiran
uudistaa	reforma
linssi	leće
käsitelty	liječi
löytö	otkriće
piirtää	crtati
luokiteltu	svrstan
olettaa	pretpostaviti
liitto	savez
vahvistaa	potvrditi
insinööri	inženjer
johdonmukainen	dosljedan
korvata	zamijeniti
raivaaminen	odobrenje
muunnin	konverter
organisaatio	organizacija
tyttö	dijete
tarkastuksia	provjere
saavuttanut	postignut
tulossa	postaje
tavoite	cilj
osoitettu	naznačeno
sokeri	šećer
miehistö	posada
jalat	noge
tikku	štap
suhde	odnos
käytössä	omogućeno
laji	žanr
vapaaehtoinen	dobrovoljac
takaosa	stražnji
demokraattinen	demokratski
parantaa	povećati
tarkka	točno
sidottu	granica
parametri	parametar
suoritin	procesor
solmu	čvor
muodollinen	formalan
myrsky	oluja
mikro	mikro
oppilaitokset	fakulteti
maili	milja
haasteet	izazovi
Editors	urednici
ylin	vrhovni
veljet	braća
tunnustus	priznanje
viite	Najbolje
arvio	procjena
lapsi	dijete
tarkastus	inspekcija
kuluttajien	potrošači
rajoja	granice
alue	teritorija
aseet	oružje
viive	odgoditi
lentäjä	pilot
maksut	doprinosi
jatkuva	stalan
aloite	inicijativa
uusi	roman
suoritus	izvršenje
vammaisuus	invalidnost
ultra	ultra
voittaja	pobjednik
episodi	epizoda
savenvalaja	lončar
ruokalaji	jelo
pelaa	igra
tiedotuslehti	bilten
ia	ia
muuttaa	izmijeniti
todella	uistinu
maailmankaikkeus	svemir
ehdokas	kandidat
aukko	prorez
maksamatta	izvanredan
ha	Ha
suunnitellut	planirani
jättää	loža
peili	ogledalo
turnaus	turnir
harkinta	obzir
istuntoja	sjednice
ydin	zrno
ostajien	kupci
lehdet	časopisi
harmaa	siva
luettelo	katalog
peritään	optužen
laaja	širok
und	und
valittu	odabran
esittely	demo
vihata	mrziti
pääte	terminal
julkaisijat	izdavači
öisin	noću
neste	tekući
riisi	riža
varaus	rezervacija
elintarvikkeet	hrana
vartija	straža
tallentaa	ušteda
imperiumi	carstvo
hiljattain	novo
nostaa	podići
laiton	nezakonit
laajeneminen	ekspanzija
johtava	premijer
huomenna	sutra
maito	mlijeko
draama	drama
vierailevat	gostujući
kilpailu	Natjecanje
koottu	prikupljeni
bändejä	bendovi
sopiva	pogodan
ehdottomasti	apsolutno
tarkastaa	revizija
kammio	komora
Guinea	Gvineja
tulokset	nalazi
ISO	izo
tyypillinen	tipičan
summa	iznos
kana	piletina
tilapäinen	privremen
käydä	prisustvovati
suihku	tuš
lähettäminen	slanje
riittävä	dovoljan
kuori	ljuska
maakunta	pokrajina
katolinen	katolički
kuvernööri	guverner
olut	pivo
panos	doprinos
kaava	formula
perustuslaki	ustav
pakkaus	ambalaža
luotettava	pouzdan
epäillä	sumnjati
ansaita	zaraditi
aikoja	razdoblja
iskut	napadi
kauppatavara	roba
oireet	simptomi
muistomerkki	spomen
twin	blizanac
lisätä	umetnuti
portti	prolaz
piirustus	crtanje
ehdokkaat	kandidati
tilasi	naredio
biologinen	biološki
taistelevat	borba
siirtyminen	tranzicija
mieltymykset	postavke
vakooja	špijun
romanssi	romantika
väline	instrument
jakaa	podjela
teemat	teme
valtuudet	sile
taivas	raj
bitit	komadići
raskaana	trudna
luokittelu	klasifikacija
keskittynyt	usmjerena
lääkäri	liječnik
pyytäminen	traži
lohkot	blokovi
katso	gle
hengellinen	duhovni
diabetes	dijabetes
ml	ml
siirtää	smjena
istua	sjediti
elinten	tjelesa
valokuvat	fotografije
leikkaus	rezanje
kirjailijat	pisci
joustava	fleksibilno
rakastettu	voljen
suosikit	favoriti
kartoitus	kartografija
useat	brojan
suhteellisesti	relativno
edustaa	predstavlja
esimies	superioran
edullinen	poželjna
tallennettu	spremaju
älyllinen	intelektualac
myönnetty	odobreno
hiili	ugljen
mukava	udobno
magneettinen	magnetski
vuorovaikutus	interakcija
kuuntelee	slušanje
kriisi	kriza
näkymät	pogled
massiivinen	masivan
kirkas	svijetao
muodostettu	formirana
piano	klavir
kaiku	jeka
vallankumous	revolucija
näytöt	prikazuje
plasma	plazma
tulot	zarada
mysteeri	misterija
maisema	pejzaž
mekaaninen	mehanički
matka	putovanje
lippu	zastava
kuva	smokva
maakunnat	županije
hankinta	akvizicija
tunnistettu	priznat
unelmat	snovi
ilmoitus	obavijest
kg	kg
opettaa	učiti
nopea	brz
Vedä	Vuci
ut	Juta
seminaari	seminar
investoinnit	investicije
pyörät	kotači
eritellä	odrediti
herkkä	osjetljiv
malleja	predlošci
formaatit	formati
pitää	drži
reititin	usmjerivač
betoni	beton
si	si
kansio	mapa
valmistuminen	završetak
pulssi	puls
tekniikka	tehnika
äänestys	glasanje
tuomioistuimet	sudovi
muunnettu	pretvaraju
metro	metro
vuosipäivä	godišnjica
parannuksia	poboljšanja
kaistale	traka
määrittely	specifikacija
onnettomuus	nesreća
lovi	zarez
saatavilla	dostupan
asukas	Rezidencija
juoni	zemljište
tyypillisesti	tipično
edustus	prikaz
pumppu	pumpa
olemassa	postoji
järjestelyt	aranžmani
konferenssit	konferencije
kulutus	potrošnja
kapea	suziti
uhkaus	prijetnja
tutkimukset	ankete
istuva	sjedenje
konsultti	konzultant
ohjain	kontrolor
valiokunnat	odbori
penis	penis
linna	dvorac
puutarhat	vrtovi
tarrat	etikete
halukas	spreman
bio	bio
näytteleminen	gluma
päät	glave
koe	ispit
asuinpaikka	prebivalište
tiheys	gustoća
sata	stotina
outo	čudan
kestävä	održiv
tilastollinen	statistički
mainita	spomenuti
innovaatio	inovacija
harmaa	siva
rinnakkainen	paralelno
toimia	raditi
setelit	novčanice
vakaa	stabilan
määritelmät	definicije
von	von
lääkärit	liječnici
oppitunti	lekcija
elokuva	kino
vaalit	izbori
reaktio	reakcija
tyhjä	prazan
tehostettu	poboljšane
oikeutettu	pravo
vaikea	ozbiljan
Tuottaa	generirati
sanomalehdet	novine
sairaalat	bolnice
vi	vi
huumori	humor
ikäinen	star
näytöt	monitori
poikkeus	izuzetak
kesto	trajanje
pääosa	Glavnina
käyntiä	posjeta
kyvyt	sposobnosti
suositus	preporuka
synti	grijeh
järjestetty	organizirani
ba	ba
kappale	stavak
hyväksyminen	posvajanje
parantaminen	poboljšanje
kallis	skup
puhveli	bizon
organisaatioiden	organizacija
kone	avion
ohjelmat	programi
mekanismi	mehanizam
ee	ee
merkitty	obilježen
ajettu	upravljan
pullo	boca
innovatiivinen	inovativan
hieronta	masaža
johtopäätös	zaključak
sulkeminen	zatvaranje
tuhat	tisuću
legenda	legenda
huvila	vila
luu	kost
pylväät	stupovi
häiriöt	poremećaji
yhteistyö	kolaboracija
havaitseminen	otkrivanje
sisäinen	unutrašnji
muodostus	formacija
med	med
insinöörien	inženjeri
kokonaisuus	osoba
risteilyt	krstarenja
portti	vrata
roomalainen	rimski
tehtävät	dužnosti
eroottinen	erotski
sävy	ton
etiikka	etika
lohikäärme	zmaj
kiireinen	zaposlen
kapteeni	kapetan
tuo	donosi
lämmitys	grijanje
jalka	noga
niska	vrat
siipi	krilo
skriptejä	skripta
ABC	abeceda
nimitetty	postavljen
tekemisissä	bavljenje
sitoutumaan	počiniti
kisko	željeznički
matkat	putovanja
aukko	praznina
sivut	strane
putki	cijev
vastaava	odgovara
kuvaukset	opisi
vyö	pojas
takki	jakna
animaatio	animacija
oraakkeli	proročanstvo
er	er
tuotannot	produkcija
ilmailu	zrakoplovstvo
ylpeä	ponos
katastrofi	katastrofa
konsoli	konzola
komennot	naredbe
jr	jr
tietoliikenne	telekomunikacija
ohjaaja	instruktor
jättiläinen	gigantski
saavutettu	postići
vammat	ozljede
lähestymistavat	pristupi
tavallinen	uobičajen
postimerkkejä	marke
kulma	kut
ryöstää	opljačkati
suunnittelijat	dizajneri
vapaus	sloboda
aikakausi	doba
muuntaa	Pretvoriti
mahdollisuus	mogućnost
analyytikko	analitičar
vaarallinen	opasno
luotettavuus	pouzdanost
vastaavasti	odnosno
vapaaehtoiset	volonteri
johdettu	izveden
ilo	zadovoljstvo
kunnia	čast
suuntautunut	orijentiran
kotka	orao
rukous	molitva
työpajat	radionice
Hurrikaani	uragan
hiljainen	miran
tuottaja	proizvođač
edustettuina	zastupljeni
vastuut	odgovornosti
juusto	sir
huolellisesti	pažljivo
tuottavuus	produktivnost
kruunu	kruna
par	jednakost
diagnoosi	dijagnoza
valmistaja	tvorac
crack	pukotina
periaate	načelo
poimii	motika
jengi	banda
fetissi	fetiš
ulkomuoto	izgled
savu	dim
suodattimet	filteri
yhdistetty	inkorporiran
alus	čamac
kaveri	kolega
sokea	slijep
aula	salon
hullu	lud
algoritmi	algoritam
voimakkaasti	snažno
kahvila	kafić
ken	znanje
proteiineja	proteini
su	Su
tuttu	upoznat
kykenevä	sposoban
pääsy	ulaz
kenkä	cipela
valittiin	izabran
kuljettaa	nošenje
terrorismi	terorizam
ilo	radost
painokset	izdanja
etninen	etnički
eduskunta	parlament
näyttelijä	glumac
löydöt	nalazi
tiiviste	pečat
tilanteita	situacije
viides	peti
kansalainen	građanin
pystysuora	vertikala
korjaukset	ispravke
kuvailee	opisuje
vammaiset	invaliditetom
aine	supstanca
kielletty	zabranjen
putki	cijev
sotilaat	vojnici
holhooja	čuvar
luento	predavanje
simulointi	simuliranje
layout	raspored
aloitteita	inicijative
sairas	bolestan
keskittyminen	koncentracija
asettaa	položiti
tulkinta	tumačenje
likainen	prljav
opettanut	učio
työntekijä	radnik
optimointi	optimizacija
temppeli	hram
aineet	tvari
todistaa	dokazati
löydetty	otkriven
siivet	krila
geneettinen	genetski
rajoituksia	ograničenja
ohut	tanak
näyttely	izložba
harjanne	greben
modeemi	modem
tuoden	donošenje
sairas	bolestan
arvioida	procijeniti
trooppinen	tropski
kerätä	prikupiti
vektori	vektor
ehdottomasti	definitivno
kääntyminen	tokarenje
olemassaolo	postojanje
selostus	komentar
kehitys	razvoj
maahanmuutto	imigracija
kohteet	destinacije
keskinäinen	zajednički
syntaksi	sintaksa
li	li
ominaisuus	atribut
vankila	zatvor
taito	vještina
tuolit	stolice
ympäröivä	okolni
vuoret	planine
suosio	popularnost
tiedustelu	pitanje
tarkistettu	provjeren
näyttely	izložak
heittää	bacanje
trendi	trend
kissat	mačke
aavikko	pustinja
ya	ya
koordinaattori	koordinator
elohopea	Merkur
palaa	spaljivanje
paeta	pobjeći
vastaanotin	prijamnik
etenevä	progresivan
veneet	brodovi
mestaruus	prvenstvo
arkadi	arkada
mahdoton	nemoguće
kertoo	govori
ilmeinen	očigledan
masennus	depresija
kaavio	grafikon
päällyste	pokrivati
platina	platina
tuomio	osuda
neuvottelut	razgovori
arkistointi	podnošenje
edistää	gajiti
palkittiin	nagrađen
tutkimuksissa	ispitivanja
Masters	majstori
patruuna	kaseta
selitys	obrazloženje
Org	org
petos	prevara
sähkö	elektricitet
spektri	spektar
saapuminen	dolazak
keramiikka	posuđe
painotus	isticanje
mahtava	super
vahvistettu	potvrđen
laskee	broji
romahdus	sudar
hissi	lift
inter	između
korkeudet	visine
varjo	sjena
kulu	trošak
hanke	pothvat
klinikka	Klinika
paranemista	liječenje
prinsessa	princeza
kirjoittamalla	ulazak
paketti	paket
studiot	studio
osallistuminen	učešće
isä	tata
painikkeet	tipke
sijoitus	plasman
havainnot	zapažanja
voittajat	pobjednici
tiet	ceste
myöhempi	sljedeći
piha	dvorište
julkistaminen	otkriće
perustaminen	osnivanje
muistoja	sjećanja
te	TE
luo	stvara
kasvoja	lica
turisti	turist
murhata	ubiti
riittävä	adekvatan
senaattori	senator
esitykset	prezentacije
sulattaa	probaviti
pöly	prah
wiki	wiki
vaihdettu	zamijeniti
tutka	radar
tappiot	gubici
taistelu	borba
vähentäminen	smanjivanje
pysäytetty	prestao
ammatti	okupacija
tarkasti	tijesno
säteily	radijacija
kuninkaat	kraljevi
ammunta	pucanje
korva	uho
liput	zastave
leipuri	pekar
konservatiivinen	konzervativan
järkyttää	šok
tehokkuuden	efikasnost
solmio	kravata
katto	krov
osoittaa	pokazati
ilmapiiri	atmosfera
suudella	poljubac
peto	zvijer
ra	ra
toimi	operiran
koe	eksperiment
tavoitteet	ciljevi
ostot	kupi
liittovaltio	federacija
pizza	pizza
kutsuttu	pozvan
toimeksianto	zadatak
mod	modni
kyselyt	upita
poissaolo	odsutnost
myyjät	dobavljači
jooga	joga
palvelee	služi
yllätys	iznenađenje
lamppu	svjetiljka
vitsit	vicevi
neuvonta	savjetovanje
palatsi	palača
vakuuttunut	zadovoljan
voittoa	pobjeda
varasto	skladište
oletettu	trebala
tavallinen	običan
aave	duh
rikkominen	povreda
pomo	šef
ylpeys	ponos
odotukset	očekivanja
itsenäisyys	nezavisnost
tietäen	poznavanje
reportteri	reporter
aineenvaihdunta	metabolizam
mestari	prvak
henkilökohtaisesti	lično
paljon	mnogo
soolo	solo
kurkku	grlo
rikkaus	bogatstvo
tyhjiö	vakuum
tanssi	ples
tunnistaa	prepoznati
kirjoittaa	piše
aukio	trg
etsintä	traganje
julkaista	objaviti
seulonta	probir
trans	trans
pioneeri	pionir
unohdettu	zaboravljen
akrobaatti	akrobata
levyt	ploče
esseitä	eseji
käytös	ponašanje
kertominen	reći
melko	pošteno
älykäs	inteligentan
tilat	načini
vaatimus	obaveza
satama	luka
matkustaja	putnik
segmentti	segment
vihollinen	neprijatelj
palapeli	puzzle
kaivot	bunara
rajoitettu	ograničen
tasavaltalainen	republikanac
salaisuudet	tajne
oireyhtymä	sindrom
läsnäolo	pohađanje
rangaistus	kazna
rumpu	bubanj
mahdollistaa	omogućuje
rakentaja	graditelj
näköala	vidik
tulva	poplava
helppous	olakšati
argumentit	argumenti
areena	arena
seikkailuja	avanture
oppilaat	zjenice
ilmoitus	Obavijest
tulokset	ishod
arvostaa	cijeniti
laajennettu	proširen
täysikasvuinen	odrastao
ihana	lijep
keskuksissa	centri
lauseke	klauzula
hymy	osmijeh
maat	zemljišta
joukot	trupe
aseistettu	naoružan
mänty	bor
jäähdytys	hlađenje
kuilu	zaljev
autot	kamioni
mekanismit	mehanizmi
avioero	razvod
perinne	tradicija
pillereitä	tablete
tiikeri	tigar
ihmiset	ljudi
sensori	senzor
avoin	izložen
metsästää	lov
enkelit	anđeli
sijainen	zamjenik
thaimaalainen	thai
päästöt	emisija
lääkärit	liječnici
valitus	prigovor
kohtaukset	scene
kokeiluja	pokusi
edistää	pojačati
hallintotavan	vladavina
mylly	mlin
perustettu	osnovan
krooninen	kroničan
den	jazbina
sormi	prst
pitää	drži
punta	funta
paikantaa	pronaći
pl	pl
koulutettu	obučen
toteuttamisessa	provođenje
leipä	kruh
moottorit	motori
kova	tvrd
tapaus	incident
dynamiikka	dinamika
valehdella	laž
keskustelu	razgovor
pienentää	smanjenje
palvonta	obožavanje
valmiudet	sposobnost
ak	ak
tarkkuus	preciznost
vahingonkorvaus	štete
varaukset	rezerve
ratkaista	riješiti
vähemmistö	manjina
monipuolinen	drugačiji
ainekset	Sastojci
Ah	Ah
sävyt	tonovi
kuntoutus	rehabilitacija
näky	vid
savi	glina
heikko	slab
jaettu	podijeljen
vastaanotto	recepcija
viisas	mudar
todennäköisyys	izgledi
seminaarit	seminari
seuraukset	posljedice
päättäjille	odluka
maantiede	geografija
eheys	integritet
perintö	nasljedstvo
tyytyväinen	zadovoljan
vaara	opasnost
vitamiini	vitamin
jalostettu	obrađen
fraasi	fraza
nostaminen	podizanje
vaikutukset	implikacije
toiminnallisuus	funkcionalnost
paratiisi	raj
hybridi	hibrid
lukee	čita
tunteellinen	emotivan
kunnia	slava
ja	ja
maantieteellinen	geografski
ylittää	prekoračiti
sauva	štap
silkki	svila
vauvat	bebe
bi	dvo
romanttinen	romantičan
paljastui	objavi
asiantuntijat	stručnjaci
generaattori	generator
jousitus	suspenzija
surullinen	tužan
korjaus	korekcija
susi	vuk
hitaasti	polako
täydentää	dopuniti
osat	dijelovi
pikkulasten	dječji
aloilla	sektori
neste	tekućina
perusteet	teren
ateria	obrok
ta	tA
koneet	strojevi
yhtälö	jednadžba
korit	košare
todennäköisyys	vjerojatnost
ulottuvuus	dimenzija
tutkittu	studirao
voitot	dobit
paholainen	vrag
ruoho	trava
kuvitettu	ilustrirano
kirsikka	trešnja
mannermainen	kontinentalni
saavutus	dostignuće
rajoituksia	ograničenja
hautajaiset	pogreb
luvuissa	poglavlja
matkustaja	putnik
mukava	zgodan
Mars	Mars
kokoinen	veličine
muna	jaje
signaalit	signali
suuntautuminen	orijentacija
varkaus	krađa
lapsuus	djetinjstvo
symbolit	simboli
lat	lat
meta	meta
analoginen	analog
lahjakkuus	talenat
päivätty	datiran
viisaus	mudrost
raja	granica
eliitti	elita
gi	vojnik
uskoo	vjeruje
runoja	pjesme
toimivalta	nadležnost
robotti	robot
näyttämällä	prikazivanje
todistaja	svjedok
varustettu	opremljen
vaiheet	faze
sur	sur
hankittu	stečena
arvioida	procijeniti
pestä	pranje
Sisäänkäynti	ulaz
ilmoitus	izjava
menettää	gubljenje
yrityksiä	pokušaji
jalo	plemenite
automaatio	automatizacija
vaikutukset	utjecaji
kierros	revolucija
edut	prednosti
ritari	vitez
tavoitteet	ciljevi
laajennukset	ekstenzije
valitukset	žalbe
sairaus	bolest
ho	Ho
vaihtoehtoja	alternative
sh	sh
saippua	sapun
hillo	pekmez
epätavallinen	neuobičajen
vastasi	odgovorio
tuho	razaranje
muutto	migracija
häiriö	poremećaj
tavanomainen	konvencionalne
yllään	nošenje
akseli	os
pyrittiin	traži
geenit	geni
mediaani	srednja
skanneri	skener
tässä	ovdje
eloisa	animirani
säätö	podešavanje
sankari	junak
hoidot	tretmani
asenne	stav
matto	tepih
linssit	leće
osallistui	prisustvovao
vaikeus	teškoća
punk	punk
koalitio	koalicija
rekisteröinti	upis
herttua	vojvoda
vauhti	tempo
tuottajia	proizvođači
kaari	luk
rajapinnat	sučelja
kartasto	atlas
havainto	zapažanje
kiduttaa	mučenje
Poistetaan	izbrisana
takki	kaput
entisöinti	obnova
sopivuus	pogodnost
palaavat	povratak
oppositio	opozicija
kontti	kontejner
vastaaja	tuženik
valvoja	nadglednik
joukot	korpus
toimijoiden	glumci
maksa	jetra
velvollinen	odgovoran
adressi	peticija
antenni	antena
poimitaan	izabran
uskomus	vjerovanje
tappaminen	ubijanje
olkapää	rame
sisustus	dekor
ioni	ion
halkaisija	promjer
podcast	podcast
vuorovaikutukset	interakcije
laulaja	pjevač
airut	glasnik
vanheneminen	starenje
interventio	intervencija
kytkeä	uključiti
vetovoima	privlačnost
sukellus	ronjenje
muutos	modifikacija
olettaa	pretpostaviti
ruoko	trska
sisältää	obuhvatiti
kohtalainen	umjeren
hiiret	miševi
ymmärsi	razumjeti
nopeasti	brzo
kieltää	zabrana
varmuus	uvjerenje
happening	događa
valtava	ogroman
myllyt	mlinovi
ääriviivat	obris
vastaanottaa	prima
farkut	traperice
kokoelma	kompilacija
outo	neparan
sigma	sigma
gr	gr
viehättävä	atraktivan
tilaisuus	prilika
tallenteet	snimke
uhri	žrtva
vaatii	zahtjevi
varovainen	pažljiv
palkki	snop
puutarhanhoito	vrtlarstvo
velvoitteet	obveze
saapua	stići
orkesteri	orkestar
lisenssi	licenca
säädettävä	prilagodljiv
jako	namjena
essee	esej
osoittivat	pokazao
vuoropuhelu	dijalog
leirit	kampovi
julistettu	proglašen
jäljittää	trag
sulkea	zatvoriti
pakkauksissa	omot
