of	od
että	do
sisään	u
varten	za
on	je
päällä	na
että	da
mennessä	po
Tämä	ovaj
kanssa	s
minä	ja
sinä	vas
se	to
tai	ili
olla	biti
olemme	su
at	na
kaikki	svi
omistaa	imati
Uusi	novi
me	mi
tahtoa	htjeti
Koti	Dom
meille	nas
noin	oko
jos	ako
sivu	stranica
minun	moj
on	ima
Hae	traži
vapaa	besplatno
mutta	ali
meidän	naše
yksi	jedan
muut	drugo
tehdä	čini
tiedot	informacija
aika	vrijeme
hän	on
joka	koji
heidän	njihov
uutiset	vijesti
käyttää	koristiti
siellä	tamo
nähdä	vidjeti
niin	tako
Kuka	tko
verkko	mreža
myös	također
saada	dobiti
pm	pm
näkymä	pogled
C	c
e	e
ensimmäinen	prvi
ollut	bila
olisi	bi
olivat	su
s	a
Kuten	Kao
x	x
kuin	od
löytö	pronaći
hinta	cijena
takaisin	leđa
ylin	vrh
ihmiset	narod
oli	imala
lista	popis
nimi	Ime
vain	samo
vuosi	godina
päivä	dan
osaksi	u
kaksi	dva
terveys	zdravlje
n	n
re	ponovno
käytetty	koristi
mennä	ići
b	b
kestää	posljednji
tehdä	napraviti
niitä	ih
pitäisi	treba
tuote	proizvod
järjestelmä	sistem
lähettää	pošta
hänen	nju
kaupunki	Grad
T	t
politiikka	politika
määrä	broj
tuki	podrška
viesti	poruka
jälkeen	nakon
sitten	zatim
tammikuu	siječanj
hyvä	dobro
d	d
missä	gdje
tiedot	Informacije
oikeudet	prava
kirjat	knjige
korkea	visok
koulu	škola
m	m
kukin	svaki
linkit	linkovi
hän	ona
vuotta	godine
tilata	narudžba
erittäin	vrlo
kirja	knjiga
kohdetta	stavke
yhtiö	društvo
R	r
lukea	čitati
ryhmä	skupina
sukupuoli	seks
monet	mnogi
käyttäjä	korisnik
de	de
sarja	set
yleinen	general
tutkimus	istraživanje
yliopisto	sveučilište
tammikuu	siječanj
posti	pošta
koko	puni
arvostelut	recenzije
ohjelmoida	program
tietää	znati
pelit	igre
tapa	put
päivää	dana
p	p
osa	dio
voisi	mogao
loistava	Sjajno
yhdistynyt	ujedinjen
todellinen	stvaran
f	f
kansainvälinen	međunarodna
keskusta	centar
matkustaa	putovati
kommentit	komentari
tehty	napravljen
kehitys	razvoj
raportti	izvješće
jäsen	član
yksityiskohdat	detalji
linja	crta
ehdot	Pojmovi
ennen	prije
hotellit	hoteli
teki	učinio
lähettää	poslati
oikea	pravo
tyyppi	tip
paikallinen	lokalne
nuo	oni
tulokset	rezultati
toimisto	ured
kansallinen	nacionalna
auto	automobil
design	dizajn
ottaa	uzeti
lähetetty	objavljeno
osoite	adresa
Yhteisö	zajednica
sisällä	unutar
valtiot	Države
haluta	željeti
puhelin	telefon
DVD	DVD
aihe	predmet
välillä	između
foorumi	forum
perhe	obitelj
l	l
pitkä	dugo
w	w
show	pokazati
O	o
jopa	čak
musta	crno
erityinen	poseban
indeksi	indeks
ollessa	biće
naiset	žene
paljon	mnogo
merkki	znak
tiedosto	datoteka
linkki	veza
avata	otvoren
etelä	jug
tapaus	slučaj
projekti	projekt
sivut	stranica
versio	verzija
jakso	odjeljak
oma	vlastiti
talo	kuća
turvallisuus	sigurnosti
g	g
lääni	okrug
amerikkalainen	američki
kuva	foto
peli	igra
jäsenet	članovi
teho	vlast
verkko	mreža
tietokone	Računalo
järjestelmät	sustavi
kolme	tri
paikka	mjesto
pää	kraj
h	h
häntä	mu
kohti	po
pääsy	pristup
ajatella	razmišljati
pohjoinen	sjeverno
voimavarat	resursi
nykyinen	Trenutno
iso	velik
tiedotusvälineet	media
laki	zakon
ohjaus	kontrolirati
vesi	voda
historia	povijest
koko	veličina
henkilökohtainen	osobni
opas	vodič
myymälä	dućan
hakemisto	imenik
muuttaa	promijeniti
valkoinen	bijela
teksti	tekst
pieni	mali
luokitus	klijenata
nopeus	stopa
hallitus	vlada
lapset	djeca
palata	povratak
opiskelijoille	studenti
v	v
tili	račun
ajat	puta
taso	nivo
digitaalinen	digitalni
profiili	profil
Edellinen	prijašnji
muoto	oblik
Tapahtumat	događaji
rakkaus	ljubav
vanha	star
Johannes	Ivan
tärkein	glavni
puhelu	poziv
kuva	slika
osasto	odjel
otsikko	titula
ei	ne
K	k
y	y
vakuutus	osiguranje
on	treba
omaisuus	svojstvo
luokka	klasa
CD	CD
laatu	kvaliteta
joka	svaki
listaus	spisak
pitoisuus	sadržaj
maa	zemlja
vähän	malo
Työkalut	alat
matala	nizak
Vastaa	odgovor
asiakas	kupac
joulukuu	prosinac
vertailla	usporediti
elokuvat	filmovi
college	koledž
arvo	vrijednost
artikla	članak
mies	čovjek
työpaikkaa	poslovi
j	j
ruoka	hrana
kirjailija	Autor
eri	drugačiji
U	u
oppia	naučiti
myynti	prodaja
Tulosta	otisak
kurssi	tečaj
Job	posao
huone	soba
kalusto	zaliha
koulutus	trening
liian	isto
luotto	Kreditna
kohta	točka
tiede	znanost
miehet	muškarci
luokat	kategorije
länsi	Zapad
Katso	izgled
Englanti	Engleski
tiimi	tim
omaisuus	imanje
laatikko	kutija
olosuhteet	Uvjeti
Valokuvat	fotografije
homo	homoseksualac
lanka	nit
kategoria	kategorija
Huomautus	Bilješka
elää	uživo
suuri	veliki
galleria	galerija
pöytä	stol
kuitenkin	međutim
kesäkuu	lipanj
lokakuu	listopad
marraskuu	studeni
markkinoida	tržište
kirjasto	knjižnica
toiminta	akcijski
alkaa	početak
sarja	niz
ominaisuudet	značajke
ilma	zrak
ala	industrija
suunnitelma	plan
ihmisen	ljudski
Joo	Da
toinen	drugi
kuuma	vruće
kustannus	cijena
elokuva	film
foorumit	forumi
maaliskuu	ožujak
la	la
syyskuu	rujan
sanoa	reći
menossa	odlazak
lääketieteellinen	medicinski
ystävä	prijatelj
joulukuu	prosinca
palvelin	server
hakemus	primjena
henkilöstö	osoblje
pelata	igra
kysymykset	pitanja
huhtikuu	travanj
käyttäjät	Korisnici
katu	ulica
aihe	tema
vastaan	protiv
sai	dobio
blogi	blog
juhla	Zabava
maksu	plaćanje
laitteet	oprema
antaa	pustiti
ohjelmat	programi
oikeudellinen	pravni
viimeaikainen	nedavni
pysäköidä	park
toimia	čin
ongelma	problem
punainen	Crvena
antaa	dati
muisti	memorija
esitys	izvođenje
sosiaalinen	socijalni
q	q
tarina	priča
myydä	prodavati
vaihtoehtoja	opcije
kokea	iskustvo
avain	ključ
ruumis	tijelo
nuori	mladi
tärkeä	važno
ala	polje
harvat	nekoliko
itään	istočno
yksittäinen	singl
ii	ii
ikä	dob
klubi	klub
esimerkki	primjer
tytöt	djevojke
z	z
tie	cesta
lahja	dar
kysymys	pitanje
ca	ca
kova	teško
maksaa	platiti
neljä	četiri
pokeri	poker
ongelma	problem
alue	opseg
rakennus	zgrada
myyjä	prodavač
tuomioistuin	sud
helmikuu	veljača
tulos	proizlaziti
valo	svjetlo
kirjoittaa	pisati
sota	rat
tarjous	ponuda
sininen	plava
ryhmät	grupe
ai	al
helppo	lako
tietty	dan
pyyntö	zahtjev
faksi	faks
Kiina	Kina
tehdä	izrađivanje
kuva	slika
tarpeisiin	potrebe
mahdollinen	moguće
kuukausi	mjesec
suuri	glavni
tähti	zvijezda
tulevaisuus	budućnost
tila	prostor
komitea	odbor
käsi	ruka
aurinko	Sunce
kortit	kartice
Lontoo	London
tapaaminen	sastanak
tulla	postati
lapsi	dijete
pitää	zadržati
porno	pornografija
Jaa	udio
samankaltainen	sličan
puutarha	vrt
koulut	škola
miljoona	milijuna
lisättyä	dodano
viite	upućivanje
yritykset	tvrtke
vauva	dijete
oppiminen	učenje
energia	energija
juosta	trčanje
toimitus	dostava
suosittu	popularan
termi	termin
elokuva	film
tarinoita	priče
laittaa	staviti
päiväkirja	časopis
raporttien	izvještaji
co	ko
yrittää	probati
kuvien	slika
ilmoitus	obavijest
Jumala	bog
alkuperäinen	izvornik
pää	glava
radio	radio
solu	ćelija
neuvosto	vijeće
sisältää	uključuje
seurata	staza
keskustelu	rasprava
arkisto	arhiva
toiset	drugi
sopimus	sporazum
muoto	format
yhteiskunta	društvo
kuukaudet	mjeseci
turvallisuus	sigurnosni
ystävät	prijatelji
varma	Naravno
painos	izdanje
viestien	poruke
markkinointi	Marketing
kertoa	reći
yhdistys	asocijacija
tarjoaa	pruža
hauska	zabava
jo	već
vihreä	zelena
opinnot	studije
kiinni	Zatvoriti
yhteinen	uobičajen
erityinen	specifično
