arasında	od
için	do
içinde	u
için	za
olduğu	je
üzerinde	na
o	da
tarafından	po
bu	ovaj
ile	s
ben	ja
sen	vas
o	to
veya	ili
olmak	biti
Hangi	su
en	na
herşey	svi
var	imati
yeni	novi
Biz	mi
irade	htjeti
ev	Dom
bize	nas
hakkında	oko
Eğer	ako
sayfa	stranica
benim	moj
vardır	ima
arama	traži
ücretsiz	besplatno
fakat	ali
bizim	naše
bir	jedan
diğer	drugo
yap	čini
bilgi	informacija
zaman	vrijeme
o	on
hangi	koji
onların	njihov
haber	vijesti
kullanım	koristiti
Orada	tamo
görmek	vidjeti
yani	tako
kim	tko
ağ	mreža
Ayrıca	također
almak	dobiti
pm	pm
görünüm	pogled
c	c
e	e
ilk	prvi
olmuştur	bila
olur	bi
idi	su
s	a
sevmek	Kao
x	x
göre	od
bulmak	pronaći
fiyat	cijena
geri	leđa
üst	vrh
insanlar	narod
vardı	imala
liste	popis
isim	Ime
sadece	samo
yıl	godina
gün	dan
içine	u
iki	dva
sağlık	zdravlje
n	n
yeniden	ponovno
Kullanılmış	koristi
gitmek	ići
b	b
son	posljednji
Yapmak	napraviti
onları	ih
meli	treba
ürün	proizvod
sistem	sistem
posta	pošta
ona	nju
Kent	Grad
t	t
politika	politika
numara	broj
destek	podrška
mesaj	poruka
sonra	nakon
sonra	zatim
Ocak	siječanj
iyi	dobro
d	d
nerede	gdje
bilgi	Informacije
haklar	prava
kitaplar	knjige
yüksek	visok
okul	škola
m	m
her	svaki
bağlantılar	linkovi
o	ona
yıl	godine
sipariş	narudžba
çok	vrlo
kitap	knjiga
ürün	stavke
şirket	društvo
r	r
okumak	čitati
grup	skupina
seks	seks
çok	mnogi
kullanıcı	korisnik
de	de
set	set
genel	general
Araştırma	istraživanje
Üniversite	sveučilište
Ocak	siječanj
posta	pošta
tam	puni
yorumlar	recenzije
program	program
bilmek	znati
oyunlar	igre
yol	put
günler	dana
p	p
Bölüm	dio
could	mogao
harika	Sjajno
birleşmiş	ujedinjen
gerçek	stvaran
f	f
Uluslararası	međunarodna
merkez	centar
seyahat	putovati
yorumlar	komentari
yapılmış	napravljen
gelişme	razvoj
rapor	izvješće
üye	član
ayrıntılar	detalji
hat	crta
şartlar	Pojmovi
önce	prije
oteller	hoteli
did	učinio
göndermek	poslati
sağ	pravo
tip	tip
yerel	lokalne
bu	oni
Sonuçlar	rezultati
ofis	ured
Ulusal	nacionalna
araba	automobil
dizayn	dizajn
almak	uzeti
gönderildi	objavljeno
adres	adresa
topluluk	zajednica
içinde	unutar
devletler	Države
istemek	željeti
telefon	telefon
DVD	DVD
konu	predmet
arasında	između
forum	forum
aile	obitelj
l	l
uzun	dugo
w	w
göstermek	pokazati
O	o
Üstelik	čak
siyah	crno
özel	poseban
indeks	indeks
olmak	biće
KADIN	žene
çok	mnogo
işaret	znak
dosya	datoteka
bağlantı	veza
açık	otvoren
güney	jug
dava	slučaj
proje	projekt
sayfalar	stranica
versiyon	verzija
Bölüm	odjeljak
kendi	vlastiti
ev	kuća
güvenlik	sigurnosti
g	g
kontluk	okrug
Amerikan	američki
Fotoğraf	foto
oyun	igra
üyeler	članovi
güç	vlast
ağ	mreža
bilgisayar	Računalo
sistemler	sustavi
üç	tri
yer	mjesto
son	kraj
h	h
onu	mu
başına	po
erişim	pristup
düşünmek	razmišljati
kuzeyinde	sjeverno
kaynaklar	resursi
şimdiki	Trenutno
büyük	velik
medya	media
kanun	zakon
kontrol	kontrolirati
Su	voda
Tarihçe	povijest
boyut	veličina
kişisel	osobni
kılavuz	vodič
Dükkan	dućan
rehber	imenik
değişiklik	promijeniti
beyaz	bijela
Metin	tekst
küçük	mali
değerlendirme	klijenata
oran	stopa
hükümet	vlada
çocuklar	djeca
dönüş	povratak
öğrencilerin	studenti
v	v
hesap	račun
zamanlar	puta
seviye	nivo
dijital	digitalni
profil	profil
önceki	prijašnji
form	oblik
olaylar	događaji
Aşk	ljubav
eski	star
John	Ivan
ana	glavni
aramak	poziv
görüntü	slika
Bölüm	odjel
Başlık	titula
olmayan	ne
k	k
y	y
sigorta	osiguranje
acak	treba
özellik	svojstvo
sınıf	klasa
CD	CD
kalite	kvaliteta
her	svaki
listeleme	spisak
içerik	sadržaj
ülke	zemlja
küçük	malo
araçlar	alat
düşük	nizak
cevap	odgovor
müşteri	kupac
Aralık	prosinac
karşılaştırmak	usporediti
filmler	filmovi
kolej	koledž
değer	vrijednost
makale	članak
adam	čovjek
Meslekler	poslovi
j	j
Gıda	hrana
yazar	Autor
farklı	drugačiji
u	u
öğrenmek	naučiti
satış	prodaja
baskı	otisak
kurs	tečaj
iş	posao
oda	soba
Stok	zaliha
Eğitim	trening
çok	isto
kredi	Kreditna
puan	točka
Bilim	znanost
erkekler	muškarci
kategoriler	kategorije
batı	Zapad
bak	izgled
ingilizce	Engleski
takım	tim
arazi	imanje
Kutu	kutija
koşullar	Uvjeti
fotoğraflar	fotografije
eşcinsel	homoseksualac
iplik	nit
kategori	kategorija
Not	Bilješka
canlı	uživo
büyük	veliki
galeri	galerija
tablo	stol
ancak	međutim
Haziran	lipanj
Ekim	listopad
Kasım	studeni
Market	tržište
kütüphane	knjižnica
aksiyon	akcijski
başla	početak
dizi	niz
Özellikler	značajke
hava	zrak
sanayi	industrija
plan	plan
insan	ljudski
Evet	Da
ikinci	drugi
Sıcak	vruće
maliyet	cijena
film	film
forumlar	forumi
Mart	ožujak
la	la
Eylül	rujan
söylemek	reći
gidiyor	odlazak
tıbbi	medicinski
arkadaş	prijatelj
Aralık	prosinca
sunucu	server
uygulama	primjena
Personel	osoblje
oyun	igra
sorunlar	pitanja
Nisan	travanj
kullanıcılar	Korisnici
sokak	ulica
konu	tema
karşısında	protiv
var	dobio
Blog	blog
Parti	Zabava
ödeme	plaćanje
ekipman	oprema
let	pustiti
programlar	programi
yasal	pravni
son	nedavni
park	park
davranmak	čin
sorun	problem
kırmızı	Crvena
vermek	dati
bellek	memorija
performans	izvođenje
sosyal	socijalni
q	q
Öykü	priča
satmak	prodavati
seçenekleri	opcije
deneyim	iskustvo
anahtar	ključ
vücut	tijelo
genç	mladi
önemli	važno
alan	polje
az	nekoliko
Doğu	istočno
tek	singl
ii	ii
yaş	dob
kulüp	klub
örnek	primjer
kızlar	djevojke
z	z
yol	cesta
hediye	dar
soru	pitanje
CA	ca
zor	teško
ödeme	platiti
dört	četiri
poker	poker
konu	problem
menzil	opseg
bina	zgrada
satıcı	prodavač
mahkeme	sud
Şubat	veljača
sonuç	proizlaziti
ışık	svjetlo
yazmak	pisati
savaş	rat
teklif	ponuda
mavi	plava
gruplar	grupe
ark	al
kolay	lako
verilmiş	dan
istek	zahtjev
faks	faks
Çin	Kina
yapma	izrađivanje
resim	slika
ihtiyaçlar	potrebe
mümkün	moguće
ay	mjesec
majör	glavni
star	zvijezda
gelecek	budućnost
uzay	prostor
Kurul	odbor
el	ruka
Güneş	Sunce
kartları	kartice
Londra	London
toplantı	sastanak
olmak	postati
çocuk	dijete
Tut	zadržati
porno	pornografija
pay	udio
benzer	sličan
Bahçe	vrt
okullar	škola
milyon	milijuna
katma	dodano
referans	upućivanje
şirketler	tvrtke
bebek	dijete
öğrenme	učenje
enerji	energija
koşmak	trčanje
teslim	dostava
popüler	popularan
terim	termin
film	film
hikayeleri	priče
koymak	staviti
dergi	časopis
raporlar	izvještaji
ko	ko
Deneyin	probati
Görüntüler	slika
ihbar	obavijest
Allah	bog
orijinal	izvornik
kafa	glava
radyo	radio
hücre	ćelija
konsey	vijeće
içerir	uključuje
Izlemek	staza
tartışma	rasprava
Arşiv	arhiva
diğerleri	drugi
anlaşma	sporazum
biçim	format
toplum	društvo
ay	mjeseci
Emniyet	sigurnosni
Arkadaş	prijatelji
emin	Naravno
baskı	izdanje
mesajları	poruke
pazarlama	Marketing
söylemek	reći
birleşme	asocijacija
sağlar	pruža
eğlence	zabava
zaten	već
yeşil	zelena
çalışmalar	studije
kapat	Zatvoriti
ortak	uobičajen
özel	specifično
birkaç	nekoliko
yaşam	život
Toplamak	kolekcija
denilen	zvao
kısa	kratak
sanat	umjetnost
çok	mnogo
Sor	pitati
sınırlı	ograničen
çözeltiler	rješenja
yönetmen	direktor
plaj	plaža
geçmiş	prošlost
doğal	prirodni
elektronik	elektronika
üzerine	na
dönem	razdoblje
planlama	planiranje
diyor	kaže
resmi	službeno
mar	pokvariti
tamam	učinio
teknik	tehnička
pencere	prozor
profesyonel	profesionalac
bölge	regija
ada	otoka
kayıt	snimiti
direkt	direktno
konferans	konferencija
kayıtlar	ploče
st	st
ilçe	okrug
takvim	kalendar
maliyetler	troškovi
stil	stil
Beyan	izjava
mil	milja
kaynak	resurs
uygulamaları	aplikacije
belge	dokument
sözcük	riječ
Eserleri	djela
malzeme	materijal
fatura	račun
yazılı	napisan
kurallar	pravila
nihai	konačni
şey	stvar
merkez	centar
Gereksinimler	zahtjevi
DOĞRU	PRAVI
dakika	minuta
Başka	drugo
işaret	ocjena
Kaya	stijena
kötü	loše
bireysel	pojedinac
artı	plus
Oto	auto
kapak	pokriti
Düzenle	Uredi
birlikte	zajedno
videolar	video
hızlı	brzo
fonksiyon	funkcija
gerçek	činjenica
alma	uzimajući
global	globalno
teknoloji	tech
karşılamak	sastati
uzak	daleko
ekonomik	ekonomski
tr	hr
oyuncu	igrač
projeler	projekti
Miktar	iznos
izlemek	Gledati
dahil	uključen
hissetmek	osjetiti
banka	banka
risk	rizik
fırsatlar	Popularna
çeşitli	raznovrstan
kelimeler	riječi
üretim	proizvodnja
ticari	trgovački
ağırlık	težina
kalp	srce
tedavi	liječenje
makas	bodova
bilgi	znanje
dergi	časopis
hata	greška
kamera	fotoaparat
kız	djevojka
inşaat	izgradnja
oyuncaklar	igračke
kayıtlı	zabilježen
domain	domena
yöntemleri	metode
bölüm	poglavlje
koruma	zaštita
politikaları	politika
geniş	širok
güzellik	ljepota
müdür	menadžer
Hindistan	Indija
pozisyon	položaj
alınmış	poduzete
çeşit	vrsta
listeleri	oglasi
bilinen	znan
yarım	pola
vakalar	slučajevi
adım	korak
mühendislik	inženjering
basit	jednostavan
hızlı	brz
lisans	licenca
göl	jezero
bütün	čitav
yıllık	godišnji
yayınlanan	Objavljeno
kilise	crkva
yöntem	način
aktif	aktivan
tepki	odgovor
şekil	lik
malzemeler	materijali
yeterli	dovoljno
tasarlanmış	konstruiran
arasında	među
ölüm	smrt
kayıp	gubitak
yüz	lice
marka	marka
indirim	popust
Etkileri	efekti
oluşturulan	stvorio
standartlar	standardi
bit	bit
siyasi	politički
krallık	kraljevstvo
baz	baza
iş	rade
krediler	krediti
ayakkabı	cipele
giriş	ulaz
kalmak	boravak
emirler	narudžbe
kullanılabilirlik	dostupnost
özet	Sažetak
dönüş	skretanje
büyüme	rast
Ajans	agencija
kral	kralj
Avrupa	europska
aktivite	aktivnost
kopya	kopirati
batı	zapadni
Kuvvet	sila
iş	zapošljavanje
Defne	zaljev
nehir	Rijeka
komisyon	komisija
paket	paket
görüldü	vidio
oyuncu	igrači
motor	motor
Liman	luka
albüm	album
bölgesel	Regionalni
durdurmak	Stop
başladı	počeo
yönetim	uprava
bar	bar
enstitü	institut
görünümler	pregleda
çift	dvostruko
köpek	pas
yakında	uskoro
hatlar	linije
elektronik	elektronička
faydaları	prednosti
gerekli	potreban
yazıcı	printer
şart	stanje
etkili	djelotvoran
inanmak	vjerovati
organizasyon	organizacija
Efekt	posljedica
us	um
seçim	izbor
kumarhane	kasino
pdf	pdf
tur	obilazak
çapraz	križ
umut	nada
şirket	korporacija
dilek	želja
çözüm	riješenje
olgun	zreo
rol	uloga
haftalar	tjedni
belli	siguran
alt	niži
gerekli	potreban
Birlik	unija
Pazartesi	mon
com	com
belirli	posebno
ince	fino
saat	sat
gaz	plin
becerileri	vještine
altı	šest
çalı	grm
adaları	otoci
tavsiye	savjet
kariyer	karijera
karar	odluka
ayrılmak	napustiti
önceden	prije
Kocaman	ogroman
Kadın	žena
tesisler	postrojenja
teklif	ponuda
orta	srednji
kablo	kabel
fırsatlar	prilike
alma	uzimanje
değerler	vrijednosti
bölünme	podjela
gelecek	dolazak
nesne	objekt
lezbiyen	lezbijka
uygun	prikladan
makine	mašina
logo	logo
uzunluk	dužina
Güzel	Lijepo
Gol	postići
istatistik	statistika
müşteri	klijent
Numune	uzorak
yatırım	ulaganje
gönderilen	poslao
gösterilen	prikazan
Noel	Božić
kültür	Kultura
flaş	bljesak
MS	ms
seçim	izbor
dersler	tečajevi
tüketici	potrošač
Merhaba	bok
yabancı	strana
sanatçı	umjetnik
mobilya	namještaj
kanal	kanal
mektup	pismo
kip	način
telefonlar	telefoni
fikirler	ideje
yapı	struktura
derece	stupanj
sözleşme	ugovor
Süper	super
erkek	muški
madde	stvar
neredeyse	skoro
bulunan	nalazi
çoklu	višekratnik
dağıtım	distribucija
editör	urednik
Han	gostionica
Sanayi	industrijski
potansiyel	potencijal
şarkı	pjesma
los	los
düşmek	pad
Fikir	ideja
Odalar	sobe
iletişim	komunikacije
kazanmak	pobijediti
birincil	osnovni
kanser	Rak
sayılar	brojevi
neden	razlog
araç	alat
bahar	Proljeće
vakıf	temelj
Cevap	odgovor
ses	glas
program	raspored
evraklar	dokumenti
amaç	Svrha
özellik	svojstvo
yatak	krevet
geliyor	dolazi
polis	policija
bağımsız	samostalan
yaklaşım	pristup
kahverengi	smeđ
fiziksel	fizička
Tepe	brdo
haritalar	Karte
ambar	držati
derecelendirme	ocjene
mutlu	sretan
demirci	kovač
gelişmiş	razvijen
teşekkür	zahvaliti
kasa	sef
benzersiz	jedinstvena
anket	pregled
önceki	prije
telefon	telefon
spor	sport
hazır	spreman
hayvan	životinja
kaynaklar	izvori
nüfus	populacija
baba	godišnje
düzenli	redovan
güvenli	siguran
operasyonlar	operacije
basitçe	jednostavno
kanıt	dokaz
istasyon	stanica
anlama	razumjeti
seçenek	opcija
vadi	dolina
muhtemelen	vjerojatno
deniz	more
yayınlar	publikacije
iyileştirmek	poboljšati
bağ	veza
Yayımcı	izdavač
salon	dvorana
anti	anti
ağlar	mreže
toprak	Zemlja
ebeveyn	roditelji
darbe	udarac
Aktar	prijenos
Giriş	Uvod
mutfak	kuhinja
kuvvetli	jak
düğün	vjenčanje
özellikleri	nekretnine
hastane	bolnica
zemin	tlo
gemi	brod
Konaklama	smještaj
hastalık	bolest
mükemmel	izvrstan
mükemmel	savršen
saç	dlaka
fırsat	prilika
malzeme	oprema
klasik	klasik
temel	osnova
komuta	naredba
şehirler	gradovi
ekspres	izraziti
ödül	dodijeliti
mesafe	udaljenost
ağaç	drvo
değerlendirme	procjena
duvar	zid
ilgili	umiješan
el	el
ekstra	ekstra
özellikle	posebno
bütçe	budžet
kılavuzlar	vodiči
başarı	uspjeh
maksimum	maksimum
anne	majka
operasyon	operacija
mevcut	postojanje
oldukça	dosta
seçilmiş	odabran
oğlan	dječak
restoranlar	restorani
güzel	lijep
uyarı	upozorenje
yerleri	lokacije
at	konj
oy	glasanje
Çiçekler	cvijeće
yıldızlar	zvijezde
listeleri	arena
sahip	vlasnik
hayvanlar	životinje
yolları	načine
oğul	sin
sağlama	pružanje
kural	Pravilo
Konut	kućište
alır	traje
getirmek	donijeti
katalog	katalog
maksimum	maksimum
anne	majka
yetki	vlast
söyledi	rekao
program	program
katıldı	spojen
giriş	ulazni
strateji	strategija
ayaklar	noge
ajan	agent
geçerli	vrijedi
modern	moderan
kıdemli	stariji
seksi	seksi
öğretim	nastava
kapı	vrata
büyük	veličanstven
Deneme	suđenje
birimler	jedinice
güzel	svjež
normal	normalan
kuruluş	poduzeće
gemiler	brodovi
tüm	čitav
pozitif	pozitivan
Fitness	sposobnost
Çince	kineski
görüş	mišljenje
Futbol	nogomet
soyut	sažetak
çıktı	izlaz
para	fondovi
Bay	mr
muhtemelen	Vjerojatno
geliştirmek	razviti
sanatçılar	izvođači
alternatif	alternativa
sorumluluk	odgovornost
java	Java
konuk	gost
yayın	objavljivanje
pas	proći
ilişkiler	odnosi
güven	povjerenje
kamyonet	kombi
içeren	sadrži
çok	multi
cumhuriyet	republika
harç	naknada
bileşenler	komponente
tatil	odmor
yüzyıl	stoljeće
akademik	akademski
yardım	pomoć
tamamlanan	dovršen
cilt	koža
grafik	grafika
Hintli	Indijanac
halka	prsten
sınıf	razred
dağ	planina
organizasyonlar	organizacija
filtre	filtar
panel	ploča
zemin	kat
alış	kupovina
maç	utakmica
önerilen	zaprosio
gerektirir	zahtijevati
çocuklar	dječaci
sabah	jutro
verir	omogućuje
protein	protein
bitki	biljka
rapor	izvijestio
vurmak	pogoditi
aa	mm
havuz	bazen
mini	mini
siyaset	politika
ortak	partner
yazarlar	autori
panoları	ploče
balık	riba
üyelik	članstvo
misyon	misija
göz	oko
sicim	niz
duyu	osjećaj
değiştirilmiş	promijenjen
yayınlandı	oslobođen
evre	faza
iç	interni
doğmuş	rođen
detaylı	detaljan
Japonca	japanski
yarış	utrka
onaylı	odobren
hedef	cilj
dışında	osim
karakter	lik
bakım	održavanje
kabiliyet	sposobnost
ed	ed
kolza	silovanje
pil	baterija
gençlik	mladež
basınç	pritisak
gönderilen	podnijeti
borç	dug
orta	srednji
televizyon	televizija
Ilgilenen	zainteresiran
çekirdek	srž
mola	pauza
amaçlar	svrhe
kümeler	setovi
dans	ples
ahşap	drvo
tanımlanmış	definiran
kâğıtlar	novine
ödülleri	nagrade
ücret	pristojba
stüdyo	studio
okuyucu	čitač
cihaz	uređaj
kurulmuş	osnovan
cevaplar	odgovori
kira	najam
las	las
karanlık	mrak
dış	vanjski
elma	jabuka
le	le
Talimatlar	instrukcije
min	min
sunulan	ponudio
teori	teorija
Kaldır	ukloniti
yardım	pomoć
görsel	vidni
evsahibi	domaćin
Çeşitlilik	raznolikost
öğretmenler	učitelji
Manuel	priručnik
blok	blok
konular	teme
ajanları	agenti
onarım	popravak
adil	pravedan
çelik	željezo
anlayış	razumijevanje
şarkılar	Pjesme
sabit	fiksni
yanlış	pogrešno
başlangıç	početak
eller	ruke
az	AZ
Paris	Pariz
alır	dobiva
sektör	sektor
kapasite	kapacitet
un	uN
şişman	mast
baba	otac
elektrik	električni
testere	pila
enstrümanlar	instrumenti
subay	časnik
sürücü	vozač
işletmeler	poduzeća
ölü	mrtav
Bilinmeyen	nepoznat
restoran	restoran
mikrofon	mikrofon
gezi	putovanje
mi	mi
fakir	siromašan
ilişki	odnos
işçiler	radnici
Barış	mir
geleneksel	tradicionalan
gösterme	pokazivanje
yaratıcı	kreativan
sahil	obala
yarar	korist
finansman	financiranje
cihazlar	uređaji
Kral	gospodar
hibe	odobriti
alt	pod
kurgu	fikcija
saatler	satovi
kariyer	karijere
gider	ide
Led	vodio
müze	muzej
yelpaze	ventilator
taşıma	prijevoz
ilginç	zanimljiv
bloglar	blogovi
değerlendirme	procjena
eski	prijašnji
bölge	zona
karmaşık	kompleks
inci	th
kedi	mačka
ölmek	umrijeti
sunulan	predstavili
düz	ravan
akış	teći
ajanslar	agencije
Edebiyat	književnost
ebeveyn	roditelj
ayar	postavljanje
dr	doktor
ölçek	ljestvica
ekonomi	Ekonomija
faydalı	koristan
aylık	mjesečno
kritik	kritično
çerçeve	okvir
müzikal	mjuzikl
tanım	definicija
Sekreter	tajnica
yol	staza
şef	glavni
verir	daje
paketler	paketi
detay	detalj
yasalar	zakoni
değişmiş	promijenjen
başla	početi
royal	kraljevski
temiz	čist
adam	momak
başlıkları	naslovi
uygun	relevantan
adalet	pravda
bağlamak	Spojiti
Fincan	kupa
sepet	košara
uygulamalı	primijenjen
haftalık	tjedni
cilt	vol
Kurulum	montaža
s	str
Dikkat	pažnja
ilerlemek	napredovati
atlamak	preskočiti
diyet	dijeta
ordu	vojska
vites	zupčanik
fark	razlika
izin	dopušteno
doğru	ispravan
ulus	narod
satış	prodaja
çok	mnogo
parça	komad
tabaka	list
firma	firma
Yedi	sedam
elementler	elementi
Türler	vrsta
atlama	skok
hücreler	Stanice
modül	modul
çare	pribjeći
sertifika	potvrda
bakan	ministar
hareket	pokret
moda	moda
talimatlar	smjerovi
Ziyaretçi	posjetitelji
belgeleme	dokumentacija
ticari	trgovački
orman	šuma
aramalar	pozivi
kapsama	pokrivenost
çift	par
vererek	davanje
şans	prilika
vizyon	vizija
top	lopta
bitirme	završni
istemciler	klijenti
eylemler	akcije
tartışmak	raspravljati
hedef	cilj
başarılı	uspješan
satıldı	prodan
rüzgar	vjetar
topluluklar	zajednice
klinik	klinički
durum	situacija
piyasalar	tržišta
yayıncılık	objavljivanje
görünmek	pojaviti
gelişen	razvoju
hayatları	život
belirlemek	odrediti
sıcaklık	temperatura
duyurular	najave
hasta	pacijent
gerçek	stvaran
tarihi	povijesni
taş	kamen
şilin	bob
ticaret	trgovina
kişiler	osobe
zor	težak
ilmi	znanstvena
uydu	satelit
testler	testovi
köy	selo
hesapları	računi
amatör	amater
eski	ex
met	sastali
Ağrı	bol
faktörler	čimbenici
Kahve	kava
alıcı	kupac
afiş	poster
kenar	rub
fonksiyonel	funkcionalna
kök	korijen
fi	fi
kapalı	zatvoreno
Bayram	Praznici
pembe	ružičasta
denge	ravnoteža
izleme	nadgledanje
cevaplar	odgovora
atış	šut
ilk	početni
etiket	označiti
sek	sek
kanon	kanon
lig	liga
atık	gubljenje
dakika	minuta
otobüs	autobus
sağlayan	usluga
sözlük	rječnik
muhasebe	računovodstvo
imalat	proizvodnja
bölümler	dijelovi
sandalye	stolica
çaba	napor
faz	faza
fantezi	fantazija
po	PO
va	va
profesör	profesor
kurmak	instalirati
gömlek	košulja
giysi	odjeća
ayak	noga
meme	grudi
teknikleri	Tehnike
dolar	dolara
din	religija
izin	dopuštenje
vahşi	divlji
nesil	generacija
bayan	propustiti
kimyasal	kemijski
doktor	liječnik
görev	zadatak
azaltmak	smanjiti
getirdi	donio
egzersiz	vježba
böcek	buba
garanti	jamčiti
lider	vođa
se	sebi
süreçler	procesi
yumuşak	mekan
toplantılar	sastanci
saniye	sekundi
uçuş	let
kongre	kongres
yakıt	gorivo
yürümek	hodati
üretilmiş	izrađen
aziz	svetac
tartışma	argument
yarışma	konkurencija
ilaçlar	lijekovi
ortak	zajednički
ödül	premija
taze	svježe
karakterler	likovi
avukat	pravnik
di	di
faktör	faktor
binlerce	tisuća
km	km
Akış	potok
daireler	apartmani
almak	odabrati
işitme	sluh
doğu	istočni
terapi	terapija
girdileri	unosi
imzalı	potpisan
idari	upravni
ciddi	ozbiljan
sınır	ograničiti
adımlar	koraci
dükkanlar	trgovine
esaret	ropstvo
del	del
çabaları	napori
bilgili	informiran
ga	gA
düşünceler	misli
dere	potok
ft	ft
miktar	količina
gerekli	osnovni
turlar	ture
yük	opterećenje
hemen	odmah
makineler	strojevi
belirlenmiş	određen
ağır	teško
kapalı	pokriven
kurtarma	oporavak
entegre	integriran
yapılandırma	konfiguracija
horoz	penis
tüccar	trgovac
kapsamlı	opsežan
uzman	stručnjak
korumak	zaštititi
katı	solidan
sunum	prezentacija
oldu	postao
Portakal	narančasta
uyma	usklađenost
tema	tema
zengin	bogat
kampanya	kampanja
vs	vs
gitar	gitara
bulgu	nalaz
örnekler	primjeri
ruh	duh
ar	ar
iddialar	zahtjevi
kabul	prihvaćanje
stratejiler	strategije
mo	mj
işler	poslovi
istenilen	namijenjen
sa	sa
hedefleri	ciljevi
kiralama	najam
seçim	izbor
önermek	predložiti
şube	podružnica
servis	poslužiti
bağlı	podružnice
dağ	montiranje
Latince	latinski
multimedya	multimedijalni
yönetmek	upravljati
köşe	ugao
rütbe	rang
eleman	element
doğum	rođenja
virüs	virus
interaktif	interaktivni
istekler	zahtjevi
ayrı	odvojen
çeyrek	četvrtina
prosedür	postupak
liderlik	rukovodstvo
tanımlamak	definirati
dini	vjerski
Gerçekler	činjenicama
kahvaltı	doručak
kolon	kolona
inanç	vjera
Zincir	lanac
belirlemek	identificirati
cadde	avenija
eksik	nedostaje
tavsiyeler	preporuke
taşındı	pomaknuto
ulaşmak	dohvatiti
karşılaştırma	usporedba
an	trenutak
Genişletilmiş	produžen
sıra	slijed
inç	palac
saldırı	napad
merkezleri	centri
açılış	otvor
laboratuvar	laboratorija
rezerv	rezerva
gama	gama
üretmek	proizvoditi
hakikat	istina
sayaç	brojač
başarısızlık	neuspjeh
şu	slijedi
dolar	dolar
kamp	kamp
des	des
filmler	filmovi
köprü	most
doldurmak	ispuniti
hareket	pokret
baskı	tiskanje
taslak	Nacrt
grafik	grafikon
Oyunun	igrao
kontaklar	kontakti
okuyucular	čitači
kulüpleri	klubovi
WA	wa
macera	avantura
teklif	ponuda
kâr	dobit
liderler	čelnici
afişler	plakati
kurumlar	institucije
asistan	asistent
değişken	varijabla
dj	dj
otopark	parkiralište
dün	jučer
belirlenen	odlučan
atölye	radionica
gitmiş	otišao
kodlar	kodovi
çeşit	vrste
uzantı	nastavak
ifadeleri	izjava
tamamen	potpuno
takımlar	timovi
kale	tvrđava
santimetre	cm
senato	senat
komik	smiješno
gen	gen
dönük	okrenut
disk	disk
Desen	uzorak
tekne	čamac
tiyatro	kazalište
üreticileri	proizvođači
sponsor	sponzor
klasik	klasična
ikon	ikona
garanti	garancija
adanmış	posvećen
yön	smjer
Basketbol	košarka
nesneleri	objekti
silmek	izbrisati
akşam	večer
montaj	skupština
nükleer	nuklearni
fare	miš
işaret	signal
adli	kriminalac
Veriliş	izdaje
güçlü	snažan
rüya	san
YANLIŞ	NETOČNO
da	da
oyuncular	baciti
çiçek	cvijet
personel	osoblje
geçti	prošao
verilen	isporučuje
düşme	Slapovi
ruh	duša
desteklemek	unaprijediti
belirtilen	navedeno
istatistikler	statistika
profesyoneller	profesionalci
belirir	Čini
Taşımak	nositi
bayrak	zastava
kapaklar	korice
em	em
avantaj	prednost
Merhaba	zdravo
tasarımlar	dizajna
sürdürmek	održavati
turizm	turizam
öncelik	prioritet
yetişkinler	odrasli
grafik	grafički
atom	atom
ödemeler	plaćanja
bağlayıcı	vezivanje
kısa	kratak
Bitti	završeno
kazanan	osvajanjem
anonim	anoniman
senaryo	skripta
hizmet	služio
istiyor	želi
hazırlanmış	pripremljen
geçersiz	poništiti
etiket	označiti
röportaj	intervju
karıştırmak	miješati
iskelet	okvir
disk	disk
Kurulmuş	instaliran
kraliçe	kraljica
kredi	krediti
Açıkça	jasno
düzeltmek	popraviti
sap	rukovati
tatlı	slatko
kriterleri	kriteriji
ortak	suradnik
ne	NE
davranış	ponašanje
büyütmek	uvećati
ışın	zraka
gelir	prihod
ölçmek	mjera
oy	glasova
du	du
görev	dužnost
tartışmalar	rasprave
ayı	snositi
kazanç	dobit
Festival	festival
laboratuvar	laboratorija
okyanus	ocean
uçuşlar	letovi
uzmanlar	stručnjaci
işaretler	znakovi
derinlik	dubina
tren	vlak
kuru	suho
keşfetmek	istražiti
spa	banja
kavram	koncept
neredeyse	skoro
kullanma	rukovanje
Menşei	podrijetlo
milyar	milijardi
zeka	inteligencija
satın	kupio
aleyhte	protiv
milletler	nacije
rota	put
kırık	slomljen
savaş	bitka
konuşmak	govoriti
protokol	protokol
sorgu	pitanje
ortaklık	partnerstvo
ifade	izraz
es	es
konuşma	govor
tel	žica
öneri	prijedlozi
değiştirme	zamjena
bant	traka
stratejik	strateški
hakim	suditi
asit	kiselina
bayt	bajtova
sent	cent
zorunlu	prisiljeni
uyumlu	kompatibilan
apartman	apartman
boş	nula
sıfır	nula
konuşmacı	zvučnik
Danışmanlık	savjetodavni
tasarımcı	dizajner
pr	pr
evlilik	brak
rulo	svitak
bankalar	banke
fr	fr
katılımcılar	sudionici
gizli	tajna
negatif	negativan
Favoriler	favoriti
tiyatro	kazalište
yaylar	izvori
var	var
yapmak	izvesti
çeviri	prijevod
tahminler	procjene
hasar	ozljeda
bakanlık	ministarstvo
sürücüler	vozači
avukat	odvjetnik
rakamlar	figure
korumalı	zaštićen
öneri	prijedlog
paylaşım	dijeljenje
kapı	portal
beta	beta
bedava	besplatno
karşı	prema
hafifçe	malo
yardım	pomoći
davranış	ponašanje
içeriyordu	sadržane
mevzuat	zakonodavstvo
çağrı	zvanje
parametreler	parametri
profiller	profili
hususlar	pitanja
evler	kuća
kontroller	kontrole
kombine	kombinirana
nihai	ultimativno
temsilci	predstavnik
küçük	manji
bölümler	odjeli
sakinleri	stanovnici
görüntülenen	prikazati
anne	mama
indirimli	smanjen
nadir	rijedak
gerçekleştirilen	izvedena
aşırı	krajnost
örnekler	uzorci
Barlar	barovi
tahmin	prognoza
çıkarıldı	ukloniti
Çevrim	ciklus
içermek	sadržati
doğruluk	točnost
uyku	spavati
mg	mg
kuş	ptica
eczane	ljekarna
oluşturma	stvaranje
statik	statički
avcı	Lovac
adresler	adrese
bayan	dama
kristal	kristal
ünlü	poznat
yazar	pisac
başkan	predsjednik
içki	piće
akademi	akademija
dinamik	dinamičan
yemek	jesti
kalıcı	trajan
temizlik	čišćenje
teşkil	tvori
portföy	portfelj
pratik	praktičan
teslim	isporučena
altyapı	infrastruktura
renk	boja
satıcı	prodavač
Felsefe	filozofija
düzenleme	regulacija
görevlileri	službenici
amaç	cilj
teklifleri	ponude
beslenme	ishrana
kayıt	snimanje
genç	mlađi
les	les
pelerin	rt
halkalar	prstenovi
bahşiş	Savjet
olağanüstü	predivan
bilet	ulaznica
açıkladı	najavio
tahmin	nagađati
kime	kome
Futbol	nogomet
matematik	matematika
ithalat	uvoz
gönderme	postavljanje
varlık	prisutnost
otomatik	automatski
görüntüleme	gledanja
muhafaza	održavati
ch	CH
dan	Dan
köpekler	psi
yönetmenler	direktori
yönleri	aspekti
önde	naprijed
ay	mjesec
katılım	sudjelovanje
düzen	shema
sinek	letjeti
tavır	držanje
matris	matrica
kombinasyon	kombinacija
düzeltme	amandman
kuvvet	snaga
Türkiye	purica
kütüphaneler	knjižnice
uygun	ispravan
derece	stupnjeva
işletmelerin	poduzeća
delta	delta
korku	strah
arayan	traži
inç	inča
Kongre	konvencija
hisseleri	dionice
asıl	glavni
konfor	udobnost
renkler	boje
savaşlar	ratovi
sipariş	naručivanje
tuttu	čuva
alfa	alfa
temyiz	apel
seyir	krstarenje
bonus	bonus
Hey	ej
binalar	građevine
özel	specijalaca
dövmek	pobijediti
piller	baterije
olur	postaje
sürücüler	diskovi
silâh	oružje
Çay	čaj
gelişmiş	poboljšan
başarmak	postići
pozisyonları	pozicije
elbise	haljina
abone	pretplata
satıcı	prodavač
çağdaş	suvremeni
gökyüzü	nebo
ROM	ROM
taşınan	prenosi
poz	izlaganje
saklamak	sakriti
imza	potpis
değirmenci	mlinar
hüküm	opskrba
çamaşırlar	odjeća
çerçeveler	okviri
kesinlikle	sigurno
gazete	novine
oyuncak	igračka
tabaka	sloj
basılı	tiskan
yavaş	usporiti
uzaklaştırma	uklanjanje
yükümlülük	odgovornost
yazıcılar	pisači
ekleme	dodajući
yer	mjesto
harcamak	potrošiti
fabrika	tvornica
iç	unutrašnjost
büyümek	rasti
optik	optički
tanıtım	promocija
bağıl	rođak
şaşırtıcı	nevjerojatan
nokta	točka
Kimlik	identitet
dönüştürme	pretvaranje
duygu	osjećaj
gizli	skriven
makul	razuman
revizyon	revizija
etki	utjecaj
oran	omjer
önem	važnost
yağmur	kiša
gezegen	planeta
kopyalar	kopije
izin	dozvola
görme	vidim
kanıt	dokaz
bas	bas
reçete	recept
boş	prazan
örnek	primjer
delik	rupa
binmek	vožnja
büro	zavod
koruma	konzervacija
çift	par
ideal	idealan
gözlük	naočale
kaydedilmiş	zabilježena
don	Don
parçalar	komada
bitmiş	gotov
parklar	parkovi
avukatları	odvjetnici
stres	stres
krem	krema
ss	ss
koşar	radi
keşfetmek	otkriti
ap	ap
desenler	obrasci
tepeler	brda
mil	nm
danışman	savjetnik
farkında	svjestan
şekil	oblik
evrim	evolucija
sertifikalar	potvrde
hedefleri	ciljevi
istasyonlar	stanice
önerdi	predložio
op	op
kalıntılar	ostaci
firmalar	tvrtke
euro	euro
Şebeke	operater
yapıları	strukture
genel	opći
ansiklopedi	enciklopedija
kullanım	upotreba
mürekkep	tinta
karışık	mješovit
sayım	popis
tekerlek	kotač
tedarikçileri	dobavljači
kompakt	kompaktan
şiir	poezija
ışıklar	svjetla
izleme	praćenje
melek	anđeo
hazırlık	priprema
girişim	pokušaj
kabul	primanje
maçlar	šibice
uyum	suglasnost
Genişlik	širina
motorlar	motori
unutmak	zaboraviti
dizi	red
tartışılan	raspravljati
doğru	točan
iklim	klima
Yunan	grčki
talimat	instrukcija
yönetme	upravljanje
çiğ	sirov
farklar	Razlike
açıklamak	objasniti
kurmak	uspostaviti
ifade	izrazio
derece	opseg
keskin	oštar
ben	Ben
paragraf	stav
öldürmek	ubiti
matematik	matematika
tazminat	kompenzacija
ihracat	izvoz
yöneticileri	menadžeri
modüller	moduli
yürütülen	provedena
versiyonları	verzije
bilir	zna
tanımlamak	opisati
vatandaşlar	građani
miras	nasljeđe
sorun	nevolja
Koç	trener
tarım	poljoprivredni
genişletmek	proširiti
seyirci	publika
atanmış	dodijeljena
koleksiyonları	zbirke
yaşlar	dobi
uzman	specijalista
pişirmek	kuhati
etkilemek	utjecati
bakire	Djevica
deneyimli	iskusan
soruşturma	istraga
kalkık	uzdignut
şapka	šešir
kurum	institucija
yönlendirilmiş	usmjerene
etkilenmiş	pogođeni
bisiklet	bicikl
bütünüyle	potpuno
plaka	ploča
giderler	troškovi
belirtmek	naznačiti
sarışın	plavuša
kovuşturma	postupak
favori	ljubimac
karakteristikleri	karakteristike
der	der
kaybetmek	izgubiti
organik	organski
aramak	tražiti
deneyimler	iskustva
albüm	albuma
sözleşmeler	ugovori
misafir	gosti
barındırılan	domaćin
hastalıklar	oboljenja
ilişkin	o
eşdeğer	ekvivalent
kimya	kemija
kitleri	setove
mantık	logika
prens	princ
daire	krug
toprak	tlo
Psikoloji	psihologija
ıslak	mokar
koşullar	okolnosti
yatırımcı	investitor
temel	osnovni
sponsorlar	sponzori
tilki	lisica
sınırsız	neograničen
yanıtlamak	odgovarati
boyutları	veličine
sade	običan
çıkış	Izlaz
kol	ruka
anahtarlar	ključevi
dalga	val
kutsal	svet
eylemler	djela
rehberlik	vođenje
iz	trag
sembol	simbol
karayolu	autocesta
gözlenen	promatranom
dekan	dekan
kurmak	postaviti
anket	anketa
stilleri	stilovi
dolu	ispunjen
bağ	veza
kanallar	kanali
apandis	dodatak
çikolata	čokolada
kısım	dio
kapsam	djelokrug
satıcı	dobavljač
kablolar	kabeli
pamuk	pamuk
gereklilik	zahtjev
öldürdü	ubijen
sınır	granica
eski	antički
tartışma	debata
temsilcileri	predstavnici
başlar	počinje
gebelik	trudnoća
konumlar	atrakcije
bilgili	naučeno
işlemler	transakcije
kâşif	istraživač
tarihi	povijesni
koca	suprug
yetkili	odobren
çılgın	lud
yaklaşan	Nadolazeći
konser	koncert
Skorlar	rezultate
verim	efikasnost
komedi	komedija
benimsenen	usvojen
verimli	učinkovit
doğrusal	linearan
taahhüt	opredjeljenje
uzmanlık	specijalitet
ayılar	medvjedi
atlama	hmelj
taşıyıcı	prijevoznik
sabit	konstantno
Visa	Visa
ağız	usta
metre	metar
bağlantılı	povezan
görüşmeler	razgovori
kavramlar	pojmovi
tabanca	puška
yansıtmak	odraziti
saf	čist
cehennem	pakao
meyve	voće
başlar	počinje
nitelikli	kvalificiran
reform	reforma
lens	leće
işlenmiş	liječi
keşif	otkriće
çekmek	crtati
sınıflandırılmış	svrstan
üstlenmek	pretpostaviti
ittifak	savez
onaylamak	potvrditi
mühendis	inženjer
tutarlı	dosljedan
değiştirmek	zamijeniti
Boşluk	odobrenje
dönüştürücü	konverter
organizasyon	organizacija
bebek	dijete
çekler	provjere
ulaştı	postignut
olma	postaje
amaç	cilj
belirtilen	naznačeno
şeker	šećer
mürettebat	posada
bacaklar	noge
Çubuk	štap
ilişki	odnos
etkin	omogućeno
Tür	žanr
gönüllü	dobrovoljac
arka	stražnji
demokratik	demokratski
artırmak	povećati
kesin	točno
ciltli	granica
parametre	parametar
işlemci	procesor
düğüm	čvor
biçimsel	formalan
fırtına	oluja
mikro	mikro
kolejler	fakulteti
mil	milja
zorluklar	izazovi
editörler	urednici
yüce	vrhovni
Kardeşler	braća
tanıma	priznanje
ref	Najbolje
tahmin	procjena
çocuk	dijete
teftiş	inspekcija
tüketicilerin	potrošači
sınırları	granice
bölge	teritorija
silahlar	oružje
gecikme	odgoditi
pilot	pilot
katkıları	doprinosi
sürekli	stalan
girişim	inicijativa
yeni	roman
icra	izvršenje
sakatlık	invalidnost
ultra	ultra
kazanan	pobjednik
bölüm	epizoda
çömlekçi	lončar
tabak	jelo
oyunlar	igra
bülten	bilten
ia	ia
değiştirmek	izmijeniti
gerçekten	uistinu
Evren	svemir
aday	kandidat
yarık	prorez
ödenmemiş	izvanredan
Ha	Ha
planlı	planirani
loca	loža
ayna	ogledalo
turnuva	turnir
düşünce	obzir
oturumları	sjednice
çekirdek	zrno
alıcılar	kupci
dergi	časopisi
gri	siva
katalog	katalog
yüklü	optužen
geniş	širok
und	und
seçilmiş	odabran
gösteri	demo
nefret	mrziti
terminal	terminal
yayıncılar	izdavači
gece	noću
sıvı	tekući
pirinç	riža
rezervasyon	rezervacija
gıdalar	hrana
bekçi	straža
tasarruf	ušteda
imparatorluk	carstvo
yeni	novo
yükseltmek	podići
yasadışı	nezakonit
genişleme	ekspanzija
başbakan	premijer
yarın	sutra
Süt	mlijeko
dram	drama
ziyaret	gostujući
yarışma	Natjecanje
toplanmış	prikupljeni
bantları	bendovi
uygun	pogodan
kesinlikle	apsolutno
denetim	revizija
bölme	komora
Gine	Gvineja
bulgular	nalazi
iso	izo
tipik	tipičan
toplam	iznos
tavuk	piletina
geçici	privremen
katılmak	prisustvovati
duş	tuš
gönderme	slanje
yeterli	dovoljan
kabuk	ljuska
il	pokrajina
liberal	katolički
Vali	guverner
bira	pivo
katkı	doprinos
formül	formula
anayasa	ustav
paketleme	ambalaža
dürüst	pouzdan
şüphe	sumnjati
kazanmak	zaraditi
dönemleri	razdoblja
saldırılar	napadi
mal	roba
semptomlar	simptomi
anıt	spomen
ikiz	blizanac
eklemek	umetnuti
geçit	prolaz
çizim	crtanje
adaylar	kandidati
düzenli	naredio
biyolojik	biološki
kavga	borba
geçiş	tranzicija
tercihleri	postavke
casus	špijun
romantik	romantika
enstrüman	instrument
Bölünmüş	podjela
temalar	teme
güçler	sile
cennet	raj
bit	komadići
hamile	trudna
sınıflandırma	klasifikacija
odaklı	usmjerena
doktor	liječnik
sormak	traži
bloklar	blokovi
bak	gle
manevi	duhovni
diyabet	dijabetes
mi	ml
vardiya	smjena
oturmak	sjediti
bedenler	tjelesa
fotoğraflar	fotografije
kesim	rezanje
yazarlar	pisci
esnek	fleksibilno
sevilen	voljen
Favoriler	favoriti
haritalama	kartografija
sayısız	brojan
Nispeten	relativno
temsil	predstavlja
üstün	superioran
tercihli	poželjna
kaydedilmiş	spremaju
entellektüel	intelektualac
verilmiş	odobreno
karbon	ugljen
rahat	udobno
manyetik	magnetski
etkileşim	interakcija
dinleme	slušanje
kriz	kriza
görünüm	pogled
masif	masivan
parlak	svijetao
oluşturulan	formirana
piyano	klavir
Eko	jeka
devrim	revolucija
görüntüler	prikazuje
plazma	plazma
kazanç	zarada
gizem	misterija
peyzaj	pejzaž
mekanik	mehanički
seyahat	putovanje
afiş	zastava
incir	smokva
ilçeler	županije
edinme	akvizicija
tanınan	priznat
rüyalar	snovi
bildirim	obavijest
kilogram	kg
öğretmek	učiti
hızlı	brz
Çek	Vuci
ut	Juta
seminer	seminar
yatırımlar	investicije
tekerlekler	kotači
belirtmek	odrediti
hassas	osjetljiv
şablonları	predlošci
formatları	formati
tutar	drži
yönlendirici	usmjerivač
beton	beton
si	si
Klasör	mapa
tamamlama	završetak
nabız	puls
teknik	tehnika
oylama	glasanje
mahkemeler	sudovi
dönüştürülmüş	pretvaraju
metro	metro
yıldönümü	godišnjica
iyileştirmeler	poboljšanja
şerit	traka
Şartname	specifikacija
kaza	nesreća
Nick	zarez
ulaşılabilir	dostupan
oturan	Rezidencija
arsa	zemljište
tipik	tipično
temsil	prikaz
pompa	pumpa
var	postoji
düzenlemeler	aranžmani
konferanslar	konferencije
tüketim	potrošnja
dar	suziti
tehdit	prijetnja
anketler	ankete
oturma	sjedenje
danışman	konzultant
kontrolör	kontrolor
komiteler	odbori
penis	penis
kale	dvorac
bahçeleri	vrtovi
etiketler	etikete
istekli	spreman
biyo	bio
oyunculuk	gluma
kafaları	glave
sınav	ispit
Konut	prebivalište
yoğunluk	gustoća
yüz	stotina
garip	čudan
sürdürülebilir	održiv
istatistiksel	statistički
Anma	spomenuti
yenilik	inovacija
gri	siva
paralel	paralelno
işletmek	raditi
fatura	novčanice
kararlı	stabilan
tanımlar	definicije
von	von
doktorlar	liječnici
ders	lekcija
sinema	kino
seçimler	izbori
reaksiyon	reakcija
boş	prazan
gelişmiş	poboljšane
adlı	pravo
şiddetli	ozbiljan
üretmek	generirati
gazeteler	novine
hastaneler	bolnice
vi	vi
Mizah	humor
yaşlı	star
monitör	monitori
istisna	izuzetak
süre	trajanje
kütle	Glavnina
ziyaret	posjeta
yetenekleri	sposobnosti
tavsiye	preporuka
günah	grijeh
örgütlü	organizirani
ba	ba
paragraf	stavak
Benimseme	posvajanje
geliştirme	poboljšanje
pahalı	skup
bizon	bizon
organizasyonlar	organizacija
uçak	avion
programlar	programi
mekanizma	mehanizam
ee	ee
işaretlenmiş	obilježen
tahrik	upravljan
şişe	boca
yenilikçi	inovativan
masaj	masaža
Sonuç	zaključak
kapanış	zatvaranje
bin	tisuću
efsane	legenda
villa	vila
kemik	kost
sütunlar	stupovi
bozukluklar	poremećaji
işbirliği	kolaboracija
bulma	otkrivanje
iç	unutrašnji
formasyon	formacija
med	med
mühendisler	inženjeri
varlık	osoba
yolculukları	krstarenja
kapı	vrata
Roma	rimski
görevleri	dužnosti
erotik	erotski
ton	ton
ahlâk	etika
Ejderha	zmaj
meşgul	zaposlen
Kaptan	kapetan
getiriyor	donosi
ısıtma	grijanje
bacak	noga
boyun	vrat
kanat	krilo
senaryo	skripta
ABC	abeceda
döşenmiş	postavljen
muamele	bavljenje
işlemek	počiniti
Demiryolu	željeznički
gezileri	putovanja
boşluk	praznina
taraf	strane
tüp	cijev
uyan	odgovara
açıklamaları	opisi
kemer	pojas
ceket	jakna
animasyon	animacija
torpil	proročanstvo
er	er
yapımları	produkcija
havacılık	zrakoplovstvo
gururlu	ponos
afet	katastrofa
konsol	konzola
komutlar	naredbe
jr	jr
telekomünikasyon	telekomunikacija
eğitmen	instruktor
dev	gigantski
elde	postići
yaralanmalar	ozljede
yaklaşımlar	pristupi
olağan	uobičajen
pullar	marke
açı	kut
soymak	opljačkati
tasarımcılar	dizajneri
özgürlük	sloboda
çağ	doba
dönüştürmek	Pretvoriti
olasılık	mogućnost
analist	analitičar
tehlikeli	opasno
güvenilirlik	pouzdanost
sırasıyla	odnosno
gönüllüler	volonteri
türetilmiş	izveden
Zevk	zadovoljstvo
Onur	čast
yönlü	orijentiran
kartal	orao
namaz	molitva
atölyeler	radionice
kasırga	uragan
sessiz	miran
yapımcı	proizvođač
temsil	zastupljeni
sorumluluklar	odgovornosti
peynir	sir
dikkatlice	pažljivo
verimlilik	produktivnost
taç	kruna
eşitlik	jednakost
Teşhis	dijagnoza
yapıcı	tvorac
çatlak	pukotina
prensip	načelo
seçtikleri	motika
çete	banda
fetiş	fetiš
görünüm	izgled
duman	dim
filtreler	filteri
Anonim	inkorporiran
zanaat	čamac
adam	kolega
kör	slijep
salon	salon
deli	lud
algoritma	algoritam
şiddetle	snažno
kafe	kafić
ken	znanje
proteinler	proteini
su	Su
tanıdık	upoznat
yetenekli	sposoban
kabul	ulaz
ayakkabı	cipela
seçildi	izabran
taşıma	nošenje
terörizm	terorizam
sevinç	radost
sürümleri	izdanja
etnik	etnički
parlamento	parlament
aktör	glumac
buluntular	nalazi
mühür	pečat
durumlar	situacije
beşinci	peti
vatandaş	građanin
dikey	vertikala
düzeltmeler	ispravke
açıklar	opisuje
engelli	invaliditetom
madde	supstanca
yasak	zabranjen
boru	cijev
askerler	vojnici
Gardiyan	čuvar
ders	predavanje
simülasyon	simuliranje
düzen	raspored
girişimler	inicijative
hasta	bolestan
konsantrasyon	koncentracija
yatırmak	položiti
yorumlama	tumačenje
kirli	prljav
öğretilen	učio
işçi	radnik
optimizasyon	optimizacija
tapınak	hram
maddeler	tvari
kanıtlamak	dokazati
keşfedilen	otkriven
kanatlar	krila
genetik	genetski
kısıtlamalar	ograničenja
ince	tanak
sergi	izložba
sırt	greben
modem	modem
getiren	donošenje
hasta	bolestan
değerlendirmek	procijeniti
tropikal	tropski
toplamak	prikupiti
vektör	vektor
kesinlikle	definitivno
döndürme	tokarenje
varoluş	postojanje
yorum	komentar
gelişmeler	razvoj
göç	imigracija
yerler	destinacije
karşılıklı	zajednički
sözdizimi	sintaksa
li	li
nitelik	atribut
hapis	zatvor
beceri	vještina
sandalye	stolice
çevreleyen	okolni
dağlar	planine
popülerlik	popularnost
soruşturma	pitanje
kontrol	provjeren
sergi	izložak
atmak	bacanje
akım	trend
kediler	mačke
çöl	pustinja
ya	ya
koordinatör	koordinator
Merkür	Merkur
yanan	spaljivanje
kaçış	pobjeći
alıcı	prijamnik
ilerici	progresivan
tekneler	brodovi
şampiyonluk	prvenstvo
çarşı	arkada
imkansız	nemoguće
anlatır	govori
açık	očigledan
depresyon	depresija
grafik	grafikon
kaplama	pokrivati
platin	platina
yargı	osuda
görüşmeler	razgovori
dosyalama	podnošenje
beslemek	gajiti
layık	nagrađen
denemeler	ispitivanja
ustaları	majstori
kartuş	kaseta
açıklama	obrazloženje
org	org
dolandırıcılık	prevara
elektrik	elektricitet
spektrum	spektar
varış	dolazak
çömlekçilik	posuđe
vurgu	isticanje
müthiş	super
onaylı	potvrđen
sayımları	broji
kaza	sudar
asansör	lift
arası	između
yükseklikleri	visine
gölge	sjena
gider	trošak
girişim	pothvat
klinik	Klinika
şifa	liječenje
prenses	princeza
girme	ulazak
paket	paket
stüdyoları	studio
ilgi	učešće
baba	tata
düğmeleri	tipke
yerleştirme	plasman
gözlemler	zapažanja
kazananlar	pobjednici
yollar	ceste
sonraki	sljedeći
avlu	dvorište
ifşa	otkriće
kuruluş	osnivanje
hatıralar	sjećanja
te	TE
yaratır	stvara
yüzleri	lica
turist	turist
cinayet	ubiti
yeterli	adekvatan
senatör	senator
sunumlar	prezentacije
özet	probaviti
toz	prah
wiki	wiki
değiştirilir	zamijeniti
radar	radar
kayıplar	gubici
savaş	borba
indirgen	smanjivanje
durduruldu	prestao
Meslek	okupacija
yakından	tijesno
radyasyon	radijacija
krallar	kraljevi
çekim	pucanje
kulak	uho
bayraklar	zastave
fırıncı	pekar
muhafazakâr	konzervativan
şok	šok
etki	efikasnost
kravat	kravata
çatı	krov
göstermek	pokazati
atmosfer	atmosfera
öpücük	poljubac
canavar	zvijer
ra	ra
ameliyat	operiran
deney	eksperiment
hedefler	ciljevi
alımları	kupi
federasyon	federacija
Pizza	pizza
davet	pozvan
atama	zadatak
şık	modni
sorguları	upita
yokluk	odsutnost
satıcıları	dobavljači
yoga	joga
vermektedir	služi
sürpriz	iznenađenje
Lamba	svjetiljka
espriler	vicevi
danışmanlık	savjetovanje
Saray	palača
memnun	zadovoljan
kazanç	pobjeda
depo	skladište
sözde	trebala
sıradan	običan
hayalet	duh
ihlal	povreda
patron	šef
gurur	ponos
beklentiler	očekivanja
bağımsızlık	nezavisnost
bilme	poznavanje
muhabir	reporter
metabolizma	metabolizam
şampiyon	prvak
Şahsen	lično
bol	mnogo
solo	solo
boğaz	grlo
servet	bogatstvo
vakum	vakuum
dans	ples
tanımak	prepoznati
yazıyor	piše
plaza	trg
araştırma	traganje
Yayınla	objaviti
tarama	probir
trans	trans
öncü	pionir
unutulmuş	zaboravljen
akrobat	akrobata
plakalar	ploče
denemeler	eseji
davranış	ponašanje
söylüyorum	reći
oldukça	pošteno
akıllı	inteligentan
modları	načini
yükümlülük	obaveza
liman	luka
gezgin	putnik
bölüm	segment
düşman	neprijatelj
bulmaca	puzzle
kuyular	bunara
kısıtlı	ograničen
cumhuriyetçi	republikanac
sırlar	tajne
sendrom	sindrom
katılım	pohađanje
ceza	kazna
davul	bubanj
sağlayan	omogućuje
kurucu	graditelj
manzara	vidik
sel	poplava
kolaylaştırmak	olakšati
argümanlar	argumenti
arena	arena
maceralar	avanture
öğrenciler	zjenice
duyuru	Obavijest
sonuç	ishod
anlamak	cijeniti
genişletilmiş	proširen
yetişkin	odrastao
güzel	lijep
merkezleri	centri
fıkra	klauzula
gülümseme	osmijeh
topraklar	zemljišta
asker	trupe
silâhlı	naoružan
çam	bor
soğutma	hlađenje
körfez	zaljev
kamyonlar	kamioni
mekanizmalar	mehanizmi
boşanma	razvod
gelenek	tradicija
haplar	tablete
kaplan	tigar
arkadaşlar	ljudi
algılayıcı	senzor
maruz	izložen
av	lov
melekler	anđeli
milletvekili	zamjenik
Tayland	thai
emisyonları	emisija
hekimler	liječnici
şikâyet	prigovor
sahneler	scene
deneyler	pokusi
artırmak	pojačati
Yönetim	vladavina
değirmen	mlin
kurulmuş	osnovan
kronik	kroničan
den	jazbina
parmak	prst
tutar	drži
pound	funta
yerleştirmek	pronaći
pl	pl
eğitilmiş	obučen
uygulanması	provođenje
ekmek	kruh
motorlar	motori
sert	tvrd
olay	incident
dinamik	dinamika
Yalan	laž
konuşma	razgovor
azaltmak	smanjenje
ibadet	obožavanje
kabiliyet	sposobnost
ak	ak
hassas	preciznost
tazminat	štete
rezervler	rezerve
çözmek	riješiti
azınlık	manjina
çeşitli	drugačiji
malzemeler	Sastojci
Ah	Ah
sesleri	tonovi
rehabilitasyon	rehabilitacija
görme	vid
kil	glina
zayıf	slab
bölünmüş	podijeljen
resepsiyon	recepcija
bilge	mudar
olasılık	izgledi
seminer	seminari
sonuçları	posljedice
vericiler	odluka
coğrafya	geografija
bütünlük	integritet
miras	nasljedstvo
memnun	zadovoljan
Tehlike	opasnost
vitamin	vitamin
işlenmiş	obrađen
ifade	fraza
yükselen	podizanje
etkileri	implikacije
işlevselliği	funkcionalnost
cennet	raj
melez	hibrid
okur	čita
duygusal	emotivan
şan	slava
ja	ja
coğrafi	geografski
aşmak	prekoračiti
çubuk	štap
ipek	svila
bebekler	bebe
bi	dvo
romantik	romantičan
ortaya	objavi
uzmanlar	stručnjaci
jeneratör	generator
süspansiyon	suspenzija
üzgün	tužan
düzeltme	korekcija
Kurt	vuk
yavaşça	polako
ek	dopuniti
bölümleri	dijelovi
bebek	dječji
sektörler	sektori
akışkan	tekućina
zeminler	teren
yemek	obrok
ta	tA
makinalar	strojevi
denklem	jednadžba
sepetler	košare
olasılık	vjerojatnost
boyut	dimenzija
okudu	studirao
kar	dobit
şeytan	vrag
çimen	trava
resimli	ilustrirano
Kiraz	trešnja
kıta	kontinentalni
başarı	dostignuće
sınırlamaları	ograničenja
cenaze	pogreb
bölümler	poglavlja
yolcu	putnik
uygun	zgodan
Mars	Mars
boy	veličine
Yumurta	jaje
sinyalleri	signali
oryantasyon	orijentacija
Çalınması	krađa
çocukluk	djetinjstvo
semboller	simboli
lat	lat
meta	meta
analog	analog
yetenek	talenat
tarihli	datiran
bilgelik	mudrost
sınır	granica
seçkinler	elita
gi	vojnik
inanır	vjeruje
şiirler	pjesme
yargı	nadležnost
robot	robot
sergileyen	prikazivanje
tanık	svjedok
donanımlı	opremljen
aşamaları	faze
sur	sur
Edinilen	stečena
belirlemek	procijeniti
yıkama	pranje
Giriş	ulaz
deklarasyon	izjava
kaybetme	gubljenje
denemeler	pokušaji
asil	plemenite
otomasyon	automatizacija
etkiler	utjecaji
devir	revolucija
avantajları	prednosti
şövalye	vitez
Amaçları	ciljevi
uzantılar	ekstenzije
itirazlar	žalbe
hastalık	bolest
ho	Ho
alternatifleri	alternative
sh	sh
sabun	sapun
reçel	pekmez
olağandışı	neuobičajen
cevap	odgovorio
imha	razaranje
göç	migracija
düzensizlik	poremećaj
Konvansiyonel	konvencionalne
giyme	nošenje
eksen	os
aranan	traži
genler	geni
medyan	srednja
tarayıcı	skener
burada	ovdje
canlandırılmış	animirani
ayarlama	podešavanje
kahraman	junak
tedaviler	tretmani
tutum	stav
halı	tepih
lensler	leće
katıldı	prisustvovao
zorluk	teškoća
punk	punk
koalisyon	koalicija
kayıt	upis
dük	vojvoda
hız	tempo
üreticileri	proizvođači
yay	luk
arayüzleri	sučelja
Atlas	atlas
gözlem	zapažanje
işkence	mučenje
silindi	izbrisana
ceket	kaput
restorasyon	obnova
Kolaylık	pogodnost
dönen	povratak
muhalefet	opozicija
konteyner	kontejner
sanık	tuženik
gözetmen	nadglednik
kolordu	korpus
aktörler	glumci
karaciğer	jetra
sorumlu	odgovoran
dilekçe	peticija
anten	antena
seçilmiş	izabran
inanç	vjerovanje
öldürme	ubijanje
omuz	rame
dekor	dekor
iyon	ion
çap	promjer
podcast	podcast
etkileşimler	interakcije
şarkıcı	pjevač
haberci	glasnik
yaşlanma	starenje
müdahale	intervencija
Eklenti	uključiti
cazibe	privlačnost
dalış	ronjenje
değişiklik	modifikacija
varsaymak	pretpostaviti
kamış	trska
dahil	obuhvatiti
ılımlı	umjeren
fareler	miševi
anladım	razumjeti
hızla	brzo
yasak	zabrana
güvence	uvjerenje
olay	događa
Muazzam	ogroman
üreticiler	mlinovi
taslak	obris
aldığı	prima
kot	traperice
derleme	kompilacija
garip	neparan
sigma	sigma
gr	gr
çekici	atraktivan
fırsat	prilika
kayıtları	snimke
kurban	žrtva
talepler	zahtjevi
dikkatli	pažljiv
kiriş	snop
Bahçıvanlık	vrtlarstvo
yükümlülükleri	obveze
varmak	stići
orkestra	orkestar
lisans	licenca
ayarlanabilir	prilagodljiv
tahsis	namjena
deneme	esej
gösterdi	pokazao
diyalog	dijalog
kampları	kampovi
beyan	proglašen
iz	trag
kapamak	zatvoriti
paketleri	omot
ge	ge
yükleme	instaliranje
anahtarlar	prekidači
gönüllü	dobrovoljan
sen	ti
çokça	veoma
ng	ng
çoğunlukla	obično
pe	pe
fotoğrafçı	fotograf
Ağla	plakati
kuantum	kvantni
inşa	konstruiran
ilave	dodaci
gerektiren	traži
ok	strijela
nişan	angažman
kaba	hrapav
tuhaf	čudan
aslan	lav
düğün	vjenčanja
oksijen	kisik
kanyon	kanjon
metre	metara
sadece	samo
takvimler	kalendari
aranjman	uređenje
sonuçlar	zaključci
kaynakça	bibliografija
Işaretçi	pokazivač
uygunluk	kompatibilnost
Uzatmak	rastezanje
izinler	dozvole
kooperatif	zadruga
besleme	hraniti
nahiye	općina
sıralamaları	ljestvici
ölçme	mjerenje
kayış	remen
kalabalık	gužva
transferler	transferi
Olimpiyat	olimpijski
dönüşüm	transformacija
dir	dir
Gümrük	carina
yöneticiler	administratori
kişilik	osoba
kanca	kuka
rulet	rulet
düşüş	odbiti
kordon	vrpca
bulut	oblak
kolaylaştırmak	olakšati
val	val
açıklıyor	objašnjava
ilerlemek	postupiti
duygular	osjećaji
bıçak	nož
benimsemek	posvojiti
inkar	odbijen
bağış	donacija
dış	vanjski
ekin	usjev
nehirler	rijeka
düğümleri	čvorovi
anılan	naveo
merkez	središte
Hedeflenen	ciljano
gerçekleştirilen	shvatio
kurucu	osnivač
onyıl	desetljeće
ihtilaf	rasprava
yorgun	umoran
ters	štetan
alıntı	izvod
deşarj	pražnjenje
içecekler	pića
as	as
sesleri	glasovi
Tırmanmak	penjanje
ton	tona
parfüm	parfem
tehlikeli	opasan
geri	vratiti
yığın	stog
metodoloji	metodologija
itibar	ugled
demokratlar	demokrati
asmak	objesiti
eğri	zavoj
yaratıcı	tvorac
kehribar	jantar
müzeler	muzeji
kodlama	šifriranje
takipçi	tragač
varyasyon	varijacija
geçit	prolaz
transfer	prebačen
gövde	deblo
fotoğraf	fotografirati
dalgalar	valovi
deve	deva
distribütör	distributer
ki	chi
toplama	prikupljanje
projeksiyon	projekcija
matematiksel	matematički
mantıksal	logičan
Sos	umak
şöhret	slava
uzman	specijalizirani
şirketler	korporacije
eleştiri	kritika
otomobil	automobil
yargıçlar	suci
Uyarılar	opaske
algılandı	otkrivena
resimlerinde	slike
yürüdü	hodao
yükselme	proizlaze
popülasyonları	populacije
korkmuş	uplašen
akustik	akustički
kaset	kaseta
gösterge	indikator
jpg	jpg
hata	pogreška
elemek	eliminirati
mineral	mineral
yakut	rubin
boncuklar	perle
servet	bogatstvo
tuval	platno
eşik	prag
kilise	župljani
ekranlar	ekrani
mezarlık	groblje
stadyum	stadion
keşif	istraživanje
dk	min
kök	stabljika
astronomi	astronomija
yarışmalar	natjecanja
grip	gripa
kostüm	kostim
bisiklet	bicikle
piskopos	biskup
çekti	izvukao
Mısır	kukuruz
sıkıştırma	kompresija
kuran	uspostavljanje
çiftçi	seljak
teneke	kositar
köle	rob
anında	odmah
antrenörlük	treniranje
incelenen	pregledan
kodlama	kodiranje
gönderimler	Tvrdnje
kahramanlar	heroji
boyalı	obojen
portre	portret
terörist	terorista
ahlâki	etički
taşıyıcılar	nositelji
hareketlilik	mobilnost
mücadele	borba
şemaları	sheme
çile	pati
nötr	neutralan
balıkçı	ribolovac
sıçan	štakor
mızraklar	koplja
birleştirme	spajanje
başlık	naslov
yapay	Umjetna
yatak	ležaj
muhteşem	spektakularan
dünyalar	svjetovi
suçlu	kriv
etkinleştirme	aktiviranje
sığınak	utočište
tablet	tableta
jüri	porota
dos	dos
kuyruk	rep
çekicilik	draž
şiddetli	nasilan
potansiyel	potencijalno
çiftlik	ranč
kısıtlamaları	ograničenja
geçit	prijelaz
dahil	uključujući
kulübe	kućica
sarhoş	pijan
önemli	znatan
suçları	zločini
kararlı	riješen
bayt	bajt
burun	nos
dalları	grane
yabancı	stranac
işlemciler	procesora
kırdı	razbio
karmaşa	složenost
sürekli	konstantno
çözmek	odlučnost
bölgeler	područja
tez	teza
diskler	diskovi
sık	čest
tavan	strop
piksel	piksela
gen	gen
elmaslar	karo
filo	flota
Demet	mnogo
teorik	teorijski
Referans	upućivanje
çıkmak	prestati
protokolleri	protokoli
akciğer	pluća
vekil	zamjena
parlak	sjajan
ti	ti
jel	gel
konuşulmuş	govorni
omega	omega
değerlendirilir	procijenjen
kaldı	ostao
görür	vidi
sonlandırma	završetak
izledi	gledao
hane	domaćinstva
kurtarmak	otkupiti
tahıl	žitarica
rejim	režim
Boğa	bik
mimari	arhitektonski
farklılık	razlikuju
hareketler	pokreti
tamirat	popravci
nefes	dah
kolaylıklar	sadržajima
fiilen	praktično
çarşı	tržište
mum	svijeća
asılı	vješanje
renkli	obojen
masal	priča
eskiden	ranije
projektör	projektor
bulunan	smješten
istiyor	traži
kesinlikle	strogo
psikolojik	psihološki
vitaminler	vitamini
zarif	elegantan
kazançlar	dobici
yenileme	obnova
şecere	genealogija
sayılır	smatra
puanlama	urezivanje
harcama	trošak
eleştirmenler	kritičari
algoritmalar	algoritmi
Hacker	haker
salon	salon
turbo	turbina
Çare	lijek
ni	ni
düşünüyor	misli
öneri	prijedlog
asker	vojnik
bomba	bomba
zarar	šteta
Aralık	interval
aynalar	ogledala
incelemek	istraga
senin	tvoj
paneller	paneli
tekrarlanan	ponovljen
saldırı	napad
geyik	jelen
dil	jezik
bowling	kuglanje
tri	tri
maymun	majmun
oran	razmjer
etek	suknja
analizleri	analize
çizimler	crteži
önem	značaj
senaryo	scenario
siz	vi
Arapça	arapski
ölçü	mjerilo
koruyucu	zaštitu
yüzlü	suočeni
çözme	rješavanje
üretir	proizvodi
yoğun	intenzivan
zincirler	lanci
altıncı	šesti
tutmak	angažirati
anahtarlama	prebacivanje
yazışma	Dopisivanje
ithalat	uvoz
nezaret	nadzor
harcamalar	rashodi
ayırma	odvajanje
tanıklık	svjedočanstvo
şüpheli	sumnjiv
zorunlu	obavezan
sınırları	granice
kutlama	Proslava
süzme	filtriranje
eş	suprug
egzotik	Egzotično
izleyici	gledatelj
ulaşan	dostizanje
gülmek	smijeh
cerrahi	kirurška
yıkmak	uništiti
alıntı	citat
yo	yo
tesislerinde	prostorije
kanıtlanmış	dokazao
saldırgan	uvredljiv
imparatorluk	carski
düzine	tucet
yayılma	razvoj
bez	tkanina
lotus	lotos
Somon	losos
kargo	teret
direktif	direktiva
Dostum	pariti
Tereyağı	maslac
biber	papar
silah	oružje
yük	teret
bantlar	vrpce
bölgeler	zone
ada	Otok
ince	vitak
akçaağaç	javor
Bakkal	trgovine
yöneten	upravni
depo	depo
alt	alt
turta	pita
harman	mješavina
emisyon	emisija
bariz	vidljiv
eğitici	nastavni
izinler	dozvole
tuvalet	WC
sıralanmış	rangirani
rotalar	ruta
montaj	montiranje
bağlı	vezan
dengeli	uravnotežen
gecikmiş	kasni
vadi	dolina
hesaplama	računanje
villalar	vile
durumlar	prilike
denklemler	jednadžbe
yağlar	ulja
Eylül	bratstvo
olağanüstü	izuzetan
kaygı	anksioznost
uzaysal	prostorni
katılımcıların	ispitanici
hususlar	razmatranja
öder	plaća
güneşli	sunčano
teslim	donosi
je	Je
kolye	ogrlica
karma	mješavina
lang	lang
tiyatro	kazališta
tasarım	projektiranje
umutlar	nade
değerlendirmeler	procjene
diyagram	dijagram
ayakkabı	obuća
sG	sg
halklar	narodi
galip	pobjednik
lisansları	licence
aralıklar	rasponi
çiftleri	parovi
duyarlılık	osjetljivost
koruma	čuvanje
yalıtılmış	izolirani
geçici	privremena
yardımlı	pomogao
ilahi	božanski
onaylamak	odobriti
bileşik	spoj
yoğunluk	intenzitet
teknolojik	tehnološki
kürtaj	abortus
diyalog	dijaloški
mekânları	prostorima
üfleme	eksplozija
adresleme	adresiranje
kutup	pol
kalkan	štit
zar	membrana
umutsuz	očajan
anneler	majke
gösteri	demonstracija
hükümet	vladin
üretilmiş	proizveden
mumlar	svijeće
varyasyonlar	varijacije
anneler	mame
kutsal	svet
bağımlılık	ovisnost
krom	krom
reddetti	odbijen
fren	kočnica
dış	vanjski
selamlama	pozdrav
ekoloji	ekologija
vadi	klisura
işsizlik	nezaposlenost
attı	zabio
artırma	poboljšanje
klon	klon
hız	brzina
lambda	À
oluşan	sastavljen
gözyaşı	suze
vaha	oaza
taksi	taksi
fa	fa
toplumlar	društva
silikon	silicij
özdeş	identičan
petrol	nafta
yarışmak	konkurirati
ist	ist
sevgili	ljubavnik
ait	pripadati
dudaklar	usne
eskort	pratnja
gölet	jezero
feribot	trajekt
tavşan	zec
meslek	profesija
baraj	brana
fizyoloji	fiziologija
ihracat	izvoz
lastik	guma
katılımcı	učesnik
elektron	elektron
yükler	opterećenja
funda	vrijesak
motel	motel
sendikalar	sindikati
hazine	riznica
meşgul	okupiran
terazi	vage
Gerginlik	naprezanje
tutuklandı	uhićen
araştırmalar	istraživanja
kazanmış	stekao
çamaşır	praonica
yerleştirme	smještanje
ayarlamak	prilagoditi
değerlendirilen	procjenjuje
şifreleme	šifriranje
dolgu	punjenje
uygulanan	nametnuti
Sessizlik	tišina
Sovyet	sovjetski
mülk	posjed
antlaşma	ugovor
eğitimci	trener
organ	orgulje
Limon	limun
karanlık	tama
karış	pedalj
şaka	vic
paketleme	pakiranje
tüzük	statut
reddedilen	odbijen
barınak	sklonište
tapınak	kapela
üretim	proizvodnja
katmanlar	slojevi
kutlamak	slaviti
cihaz	uređaj
karışım	smjesa
binici	jahač
yarıçap	radius
etkileyici	impresivan
koyun	ovca
mimar	arhitekt
dersler	predavanja
şaraplar	vina
bardaklar	šalice
kül	pepeo
katkıda	suradnici
salata	salata
ihlalleri	prekršaji
sıcaklıklar	temperature
yarışmalar	natjecanja
korumak	sačuvati
şiir	pjesma
kalma	ostanak
Paskalya	Uskrs
teoriler	teorije
depo	skladište
akışları	potoci
iniş	slijetanje
infaz	pogubljen
müzakereler	pregovori
gerçekçi	realističan
sorar	pita
özet	sinopsis
besteci	kompozitor
fasulye	grah
kılıç	mač
modifikasyonlar	izmjene
mercan	koraljni
piksel	piksela
yolları	staze
kabarcık	mjehurić
por	por
kazanmak	steći
aksi	suprotno
tribün	tribina
Gemi	Brod
asitler	kiseline
virüsler	virusi
çıkartmalar	naljepnice
reaksiyonları	reakcije
inançlar	vjerovanja
takım	odjeljenje
çözümlemek	analizirati
bölünmeler	podjele
yüzmek	plivati
nano	nano
konserler	koncerti
erkek	muškarci
tutmak	zadržati
renkler	boje
gerçekleştirmek	izvršiti
tünel	tunel
türler	žanrovi
patent	patenti
buğday	pšenica
kronikler	kronike
edinme	dobivanje
kunduz	dabar
kaynaklar	čitanja
genişleme	uvećanje
kartallar	orlovi
bazlar	baze
sanık	optuženik
kampanyalar	kampanje
birlik	jedinstvo
tanımlar	definira
örnekleri	slučajevi
yerli	domaći
başladı	počela
paketler	paketi
Çapa	sidro
çorap	čarape
tetik	okidač
kolesterol	kolesterol
diferansiyel	diferencijal
yüzeyler	površine
korkunç	užasan
yönlendiriciler	usmjerivači
saatler	satovi
artrit	artritis
bios	bios
dişiler	ženke
yansıtır	odražava
vergilendirme	oporezivanje
ateş	groznica
mutfak	kuhinja
elbette	sigurno
uygulayıcıları	praktičari
teorem	teorema
enflasyon	inflacija
sana	ti
Bileşikler	spojevi
davul	bubnjevi
oldukça	razumno
çıplak	ogoljen
radikal	radikal
önerir	preporučuje
kontrol	kontrolni
hazine	blago
alev	plamen
çukur	jama
mono	mono
parçacıklar	čestice
yüzer	plivajući
koordinat	Koordinirati
sadece	isključivo
sınırlama	ograničenje
vurdu	pogođen
örnekleme	ilustracija
uyarılar	upozorenja
kurmak	izgraditi
uygulamaların	aplikacije
Araştırma	upita
ek	dodatak
ilham	inspiracija
navlun	teretni
tutulma	zasjeniti
etkiler	utječe
tahminleri	prognoze
belirlemek	otkriti
aktif	aktivno
karmaşık	složen
yaralı	ozlijeđen
ifade	izrazi
ton	tona
kurye	kurir
ipuçları	savjeti
gif	gif
çatışmalar	sukobi
içecek	piće
haraç	danak
bağışık	imun
ormancılık	šumarstvo
engeller	barijere
can	nagib
nadiren	rijetko
teklifleri	ponuda
bariyer	prepreka
bisiklet	bicikl
mobilya	namještaj
ortaya	ustati
Kelt	keltski
parçacık	čestica
nem	vlažnost
şişeler	boce
dm	dm
Rönesans	preporod
yönetmelik	propis
fotoğrafçılar	fotografi
enfeksiyonlar	infekcije
satranç	šah
faaliyet	djeluje
festivaller	festivale
olasılıklar	mogućnosti
ördek	patka
kanal	kanal
katkı	doprinosi
inek	krava
analitik	analitički
kostüm	kostimi
sıkı	strog
dolaşım	Cirkulacija
suç	prekršaj
varsayım	pretpostavka
hobi	hobi
çalışır	pokušava
icat	izum
teknisyen	tehničar
yöneticiler	rukovoditelji
Araştırma	upita
bilişsel	spoznajni
keşfetmek	istraživanje
hile	trik
soruşturma	pitanje
kapatma	zatvaranje
kereste	greda
volt	volt
yoğun	intenzivan
destekçileri	pristaše
tüzük	statuti
kaydedilmiş	upisao
sensörler	senzori
vida	vijak
bakanlar	ministri
alenen	javno
acı	patio
giriş	usisni
kelebek	leptir
mekanik	mehanika
başlıkları	zaglavlja
hatalar	greške
sayısal	numerički
tanımlarken	definiranje
sayma	računajući
yansıma	odraz
davetiye	poziv
sodyum	natrij
hormon	hormon
çocuk	dječji
tuğla	cigla
kavrama	zahvat
Ortaçağ	srednjovjekovni
porselen	porculan
yakalanan	uhvaćen
terbiyeli	pristojan
döküm	lijevanje
tercüme	preveo
donna	gospođa
savaşçı	ratnik
kabin	kabina
tarama	skeniranje
polo	polo
kopyalama	kopiranje
Boynuz	rog
gazetecilik	novinarstvo
kurbağa	žaba
dilbilgisi	gramatika
niyet	namjera
lastikler	gume
üstlenilen	poduzeti
tehlike	opasnost
bölüm	epizoda
dairesel	kružni
öfke	bijes
çizimler	ilustracije
şansı	šanse
mutluluk	sreća
tuhaf	bizaran
ur	ur
meyve	voće
tanımlayıcı	identifikator
kurdele	vrpca
hesaplamalar	izračuni
jpeg	jPEG
başlamak	pokretanje
kullanışlı	spretan
takas	razmjena
muaf	oslobođen
bitkileri	usjevi
azaltır	smanjuje
başarılı	ostvariti
geometri	geometrija
izlenim	utisak
lonca	ceh
bağıntı	korelacija
sim	sim
sinir	živčani
koku	miris
kopya	replika
kabile	pleme
işlemler	obrta
muhteşem	divan
kurtulmuş	osloboditi
üçlü	trojstvo
ele	rukovati
efsaneler	legende
Boom	uspon
sakin	smiriti
şampiyonlar	prvaci
katlar	podovi
seçimleri	izbor
karşılaştıran	uspoređivanje
konuşur	govori
mesleki	strukovno
eczaneler	ljekarne
ln	ln
rulman	valjak
yığın	serija
düzenlemek	organizirati
takdir	poštovati
değiştirmek	mijenjati
kenarları	rubovi
karıştırma	miješanje
kolları	ručke
armoni	sklad
seçkin	razlikuje
astım	astma
varsayımlar	pretpostavke
düzenlenmiş	regulirano
üçgen	trokut
değiştirmek	ispraviti
beklenen	predviđa
oryantal	istočnjački
ödül	nagrada
hidrojen	vodik
karşılaştırılabilir	usporedivo
savunucu	pristalica
karışıklık	zbunjenost
girişler	ulazi
garantiler	jamstva
genom	genom
madalya	medalja
koçlar	treneri
gemiler	posuđe
liman	luka
eko	eko
savunmasız	ranjiv
düzenlemek	urediti
artistik	umjetnički
onur	počasti
yansıtılan	ogleda
birleşik	ujedinjen
doğurmak	vrsta
detektör	detektor
ihmal	zanemarena
kesin	precizan
değerlendirilmesi	ocjenjivanje
dudak	usna
toplamak	okupiti
şekillendirme	formiranje
gazeteciler	novinari
hafif	blagi
dolaylı	posredan
arasında	među
temeller	temelji
ufuk	horizont
nu	nu
derinden	duboko
yükümlülükler	pasiva
ödülleri	nagrade
azalmış	smanjen
açıklayan	opisujući
optik	optika
sürdürmek	progoniti
Şimşek	munja
ou	ou
alıntılar	citati
müfettiş	inspektor
yılan	zmija
hatırlatma	podsjetnik
arandı	tražili
ovalar	ravnice
anlayışlar	uvidi
yetenekleri	sposobnosti
başlatılan	pokrenut
karaoke	karaoke
tuzak	zamka
yalnız	usamljen
ettik	ve
gözlemek	promatrati
konteynerler	spremnici
tutumlar	stavovi
dut	bobica
yaka	ovratnik
birleştirmek	integrirati
sosyoloji	sociologija
sergileyen	izlošci
kalıp	umire
teras	terasa
bakteriler	bakterija
gerektiğini	treba
lezzetli	ukusno
gelenekler	tradicija
sınırlı	konačan
gönderir	šalje
dayanıklı	trajan
müttefik	saveznički
nem	vlaga
dönüştürmek	transformirati
kronometre	brojač
tabletler	tablete
kazanılmış	dobivši
eğitimciler	nastavnici
sebze	povrće
ayet	stih
bağımsız	nezavisno
rakipler	natjecatelji
roket	raketa
evet	aye
mermi	metak
kuleler	kule
görünürlük	vidljivost
enlem	širina
bilinç	svijest
tümör	tumor
çirkin	ružan
mevduat	depoziti
metres	ljubavnica
karşılaşma	susret
watt	vata
kırk	četrdeset
borular	cijevi
teşebbüs	pokušaj
rahip	svećenik
analistler	analitičari
çekiç	čekić
istila	invazija
koşucu	trkač
satırlar	redovi
uygulanan	davati
kavram	pojam
yazım	pravopis
Arktik	Arktik
ödülleri	nagrade
altında	ispod
güçlendirmek	ojačati
savunmak	braniti
kızılötesi	infracrveni
yedinci	sedmi
göbek	trbuh
agresif	agresivan
reklamlar	Oglasi
kışla	četvrtine
çalıntı	ukraden
belirleyen	određuje
heykel	skulptura
poli	poli
kulaklar	uši
yumruk	šaka
neo	neo
motivasyon	motivacija
yolcular	putnici
sürekli	dosljedno
fazlalık	višak
kazmak	kopati
taksi	taksi
takdir	zahvalnost
om	om
kısıtlama	ograničenje
gitarlar	gitare
öz	suština
güçlü	moćan
insanlık	čovječanstvo
transkripsiyon	transkripcija
komplikasyonlar	komplikacije
alimler	znanstvenici
gökada	galaksija
sempatik	brižan
ahit	zavjet
baskın	dominantan
mide	trbuh
kısmen	djelimično
küçültmek	umanjiti
rütbeler	redovima
ilk	debi
nesiller	generacije
turnuvalar	turniri
reddetmek	poreći
anatomi	anatomija
kulaklık	slušalice
kesir	frakcija
üçlü	trio
işlem	postupak
küp	kocka
kusurlar	nedostaci
belirsizlik	nesigurnost
Yıkmak	kvar
yerleşik	riješiti
aşı	cjepivo
kader	sudbina
rezervasyon	rezervacije
cumhuriyetçiler	Republikanci
orman	džungla
Zen	Zen
dis	dis
tahmin	proricanje
ekolojik	ekološki
oval	ovalan
ima	podrazumijeva
ser	ser
değerlendirme	procjena
olasılık	vjerojatnost
coğrafi	geografski
verici	donor
gerginlik	napetost
çöp	smeće
şekiller	oblika
aşama	red
Kont	grof
vatan	zavičaj
şampiyona	prvenstvo
ırkları	pasmine
disko	diskoteka
aus	aus
bitirme	dorada
duygular	emocije
sonsuz	vječan
rotasyon	rotacija
nam	Nam
üretken	produktivan
bulvar	bulevar
domuz	svinja
metrik	metrički
cezalar	kazne
çeşitli	raznolik
grande	grande
aktris	glumica
atamak	dodijeliti
Karşılamak	smjestiti
kaplanlar	tigrovi
köyler	sela
gölge	hlad
Koro	pripjev
ritim	ritam
hane	broj
senfoni	simfonija
ani	naglo
kabul	prihvaćanjem
havuzlarda	bazeni
lirik	lirski
izolasyon	izolacija
hızlar	brzine
sürekli	neprekidan
eşleşti	uskladiti
yaklaşık	približan
Halat	uže
akılcı	racionalan
programcı	programer
savaşçıları	borci
miras	naslijedio
tamamlanmamış	nepotpun
vokal	vokal
Çeşme	fontana
meşru	legitiman
biyografiler	biografije
araştırmacı	istraživač
davacı	tužitelj
nazik	nježan
layık	dostojan
mimarlar	arhitekti
azizler	sveci
girişimci	poduzetnik
taşır	nosi
düet	dvojac
aşırı	pretjeran
kaydeder	štedi
kabul	smatrati
değerleme	vrijednost
beklenmedik	neočekivan
sis	magla
karakteristik	svojstvo
lobi	lobi
özetlenen	navedeno
muazzam	ogroman
karma	karma
oluşmaktadır	sastojati
kraliçeler	kraljice
akademisyenler	akademici
kabileler	plemena
ayrım	razlika
tehlikeler	opasnosti
muafiyet	izuzeće
kiracı	stanar
Sürdürülebilirlik	održivost
dövme	tetoviranje
cebir	algebra
gölgeler	sjene
saçma	glup
serbestçe	slobodno
hafif	blag
kürk	krzno
kolayca	spremno
üyelik	pripadanje
çit	ograda
sonsuz	beskonačan
klan	klan
devrimci	revolucionar
bilezikler	narukvice
çare	lijek
nefes	disanje
kısaca	kratko
kalınlık	debljina
grafik	grafički
deha	genije
tartışılması	raspravlja
savaşçı	borac
anlamlı	značajan
uyarlanmış	prilagođen
Emlak	imanja
kilim	tepih
demokrat	demokrat
ilçe	varoš
korur	održava
ka	ke
muhafaza	zadržan
mermer	mramor
dem	dem
meditasyon	meditacija
mikrofon	mikrofon
birleştirme	Kombinirajući
devleri	divovi
düzenleme	organiziranje
not	memorandum
jambon	šunka
çözülmüş	riješen
gelgit	plima
bölme	pregrada
görünmez	nevidljiv
konsolları	konzole
mıknatıs	magnet
çeviriler	prijevodi
jaguar	jaguar
emtia	roba
kilometre	kilometara
garantiler	jamstva
Gotik	gotika
silindir	cilindar
cadı	vještica
dolar	mužjak
düşmanları	Neprijatelji
danışmanlık	savjetovanje
keyfi	uživanje
devriye	patrola
koku	miris
karnaval	karneval
kabaca	grubo
etiket	naljepnica
sözler	obećanja
resif	greben
bölmek	podijeliti
ardışık	uzastopni
bon	bon
gösterimleri	prikazi
chan	chan
melodileri	pjesme
mas	mas
ifadeler	fraze
kai	kai
yarımada	poluotok
sıkıcı	dosadan
dom	dom
konuşmalar	govori
ulaşır	doseže
şema	shema
kataloglar	katalozi
bakanlıklar	ministarstva
meclis	parlamentarni
önek	prefiks
savan	Savannah
varil	barel
sinir	živac
dans	dans
gezegenler	planeti
açık	deficit
yenilemek	obnoviti
bağlanmış	spojen
devreler	krugovi
doku	tekstura
kabul	priznati
çadır	šator
tanımlar	identificira
vasıf	kvalifikacija
kilitler	brave
minyatür	minijatura
Euro	eura
korsanlar	pirati
hava	antena
şahin	Sokol
sonuç	posljedica
sistematik	sistematski
algılanan	percipiraju
kökenleri	podrijetlo
kiralanmış	zaposlen
makyaj	šminka
ui	UI
ağırlıklar	utezi
jeolojik	geološki
kalıcı	trajan
kötü	zao
tanıtır	uvodi
itilmiş	gurnula
ro	ro
eğim	nagib
şair	pjesnik
komplo	zavjera
ilahiyat	teologija
çiviler	nokti
belirgin	evidentan
sürmek	vožnje
epik	ep
organizatör	organizator
alerji	alergija
uğruna	sake
kombinasyonlar	kombinacije
önceki	prethodnih
hak	zasluga
enzim	enzim
düzlemler	zrakoplovi
diskler	diskovi
amplifikatör	pojačalo
keyfi	proizvoljan
belirgin	istaknut
sans	sans
kurar	gradi
temas	kontakt
şaft	vratilo
yağsız	mršav
nadiren	poneki
yenilikler	inovacije
gözden	pregleda
panik	panika
vatandaşlık	državljanstvo
bahane	izgovor
reformlar	reforme
soğan	luk
sandviç	sendvič
alto	alt
hiyerarşi	hijerarhija
terkedilmiş	napušten
çevreler	krugovi
atım	otkucaja
şen	veseo
tarikat	kult
tire	crtica
pasif	pasivno
değerli	cijenjena
kafes	kavez
cesaret	hrabrost
yükseklik	visina
kucak	krug
kullanım	iskorištenje
içkiler	pića
ping	ping
eğlenceli	zabavan
önkoşul	preduvjet
sınır	granica
mülteciler	izbjeglice
şövalyeler	vitezovi
hipotez	hipoteza
ilaçlar	lijekovi
değişmiş	promijenjen
doktrin	doktrina
manzara	lijep
geliştirmeleri	poboljšanja
kesişim	križanje
dikiş	šivanje
toplayıcıları	kolektori
tanınan	priznat
öfke	bijes
prix	prix
astroloji	astrologija
danışmanları	savjetnici
köşk	paviljon
taktik	taktika
tamamlayıcı	naknadni
yetenekli	talentirani
yastık	jastuk
yayma	širenje
taşra	provincija
çalmak	ukrasti
parsel	parcela
oran	učestalost
endişe	strahovi
tahmin	predvidjeti
lezzet	aroma
aç	gladan
madeni	metalik
girişim	interferencija
savaşçı	ratnici
atmosferik	atmosferski
hale	halo
ebeveyn	roditeljski
başvurulan	upućuje
vurur	štrajkovi
karınca	mrav
önerme	prijedlog
uygun	pogodan
ele	rješavati
tüccar	trgovac
atılmış	bačen
kriter	kriterij
rozet	Bedž
medeniyet	civilizacija
funda	vrijes
muazzam	ogroman
gerçekleştirir	obavlja
Diyar	carstvo
düzeltilmiş	ispravljeno
kask	kaciga
karşılaşılan	naišao
tsunami	cunami
akademisyen	učenjak
çevrili	okružen
jeoloji	geologija
yaratıklar	stvorenja
temizlenir	izbrisan
başarmak	ostvariti
köşeleri	kutovi
vejetaryen	vegetarijanac
Maya	kvasac
pas	korak
araştırılmıştır	istražuju
büyükelçi	ambasador
kaplanmış	premazan
kader	sudbina
rutinleri	rutine
varlıklar	bića
güven	oslanjanje
efsane	mit
dere	potok
fu	fu
fenomen	fenomen
topluluk	ansambl
emin	osiguran
bilinçli	svjestan
Aksan	naglasak
eşleri	supruge
yararlanmak	iskoristiti
rehin	zalog
vampir	vampir
rıhtım	pristanište
örgütlü	organizirani
müzisyen	glazbenik
sınırlayıcı	ograničavajući
restore	obnovljena
ipucu	savjet
zırh	oklop
düşünce	napomena
onlarca	desetine
değişir	varira
muhakeme	rasuđivanje
gardiyanlar	čuvari
açıklıklar	otvori
yerine	zamjena
araştırmacı	istraživač
konseyler	vijeća
meslekler	zanimanja
tanınan	priznao
domuz	svinjetina
zu	zu
denge	ravnoteža
borular	cijevi
evler	vikendice
birleşmek	sjediniti
ayrıcalık	privilegija
geliştirir	razvija
şasi	šasija
tahmin	procjena
ahır	staja
don	mraz
enstitüleri	ustanove
kalıp	kalup
kadın	dama
yat	jahta
tercih	voli
delme	bušenje
ot	biljka
ihlal	kršenje
balina	kit
gezgin	putnik
ödenek	izdvajanja
şüpheli	sumnja
domates	rajčice
eğitmenler	instruktori
moment	moment
yüzgeç	peraje
papaz	pastor
çamur	blato
zümrüt	smaragd
büyür	raste
sistem	rasprava
ul	ul
bale	balet
gazeteci	novinar
dinler	religije
Sarımsak	češnjak
parlaklık	sjaj
patlama	Eksplozija
külot	gaćice
imzalar	potpisi
ozon	ozon
disiplinler	discipline
casa	casa
konuşmaları	razgovori
radyolar	radio
tarife	tarifa
basitleştirilmiş	pojednostavljen
kaslar	mišići
hızlı	brz
vajina	vagina
Şampanya	šampanjac
sapma	devijacija
samba	samba
kullanmak	zaposliti
penguen	pingvin
büyülü	čaroban
etkiler	utjecaji
denetimler	inspekcije
sulama	navodnjavanje
mucize	čudo
hidrolik	hidraulički
nüfuz	prodiranje
yara	rana
belle	ljepotica
rosa	Rosa
mahkumiyet	osuda
tembel	lijen
nitelikleri	osobine
babalar	oci
doldurma	punjenje
önemlisi	važnije
minyon	tanka
cihaz	aparat
arazi	teren
açıklayan	objašnjavajući
şeritler	trake
adaylık	imenovanje
deneysel	empirijska
solucan	crv
bağımlılık	zavisnost
ayrık	diskretna
acemi	početnik
kapak	poklopac
cinsellik	seksualnost
safir	safir
ayrıcalıkları	povlastice
uzmanlaşmış	specijaliziran
işaretleme	obilježava
şerif	šerif
reddedildi	odbijeno
casuslar	špijuni
motosikletler	motocikli
seçilmiş	izabrati
karayolları	autoceste
yoğunlaşmak	koncentrat
samimi	intiman
moleküller	molekule
mermi	kola
buzdolabı	hladnjak
aralıkları	intervali
cümleler	rečenice
soykırım	uništenje
pilot	letak
bezelye	grašak
dozaj	doziranje
varyans	varijacija
denizci	navigator
iğne	igla
hamam	kupke
frenler	kočnice
og	og
ko	ko
sahibi	posjeduje
Kader	sudbina
manzaralar	krajolici
hesaplama	računanje
saman	sijeno
kurtuluş	spasenje
tahminler	predviđanja
öğrenenler	učenici
jeton	znak
çinko	cinkov
kurban	žrtva
arayanlar	azila
guru	guru
uygun	prilagođen
sayısal	numerički
antropoloji	antropologija
imparator	car
mezun	grad
kemerleri	remenje
siyahlar	crnci
eğitimli	obrazovan
gururla	ponosno
zorunluluk	nužnost
eğrileri	krivulje
gezici	obilazak
tepe	tjeme
domates	rajčica
Now	putovanja
soluk	blijed
işleyen	funkcioniranje
ekonomiler	ekonomija
üstlenmek	poduzeti
bildirmek	proglasiti
valfler	ventili
boşluklar	praznine
başarılar	dostignuća
gözyaşı	suza
öğretir	uči
sıfır	nula
yabancı	stranac
yuva	gnijezdo
mahkeme	sud
çizgili	vladao
emekli	mirovine
namaz	molitve
polis	policajac
genç	adolescent
aday	nominacije
muz	banana
tanıtıcı	uvodni
rezervuar	rezervoar
olay	pojavljivanje
idol	idol
kanlı	krvav
hatırlatmak	podsjetiti
büyüleyici	šarmantan
diş	zub
itibarlı	ugledan
kalır	ostaje
mesele	afera
kısıtlamak	ograničiti
mayınlar	mine
portreler	portreti
yorumlanır	tumačiti
değerlendirmeler	procjene
eliminasyon	eliminacija
metre	metara
farazi	hipotetski
helikopter	helikopter
kalem	olovka
sanatçı	izvođač
komisyonlar	provizije
küre	sfera
yosun	mahovina
oranlar	omjeri
uyum	sloga
mezun	diplomirao
onaylanan	potvrđen
şaşırtıcı	iznenađujuće
mızrak	koplje
merdiven	ljestve
mantar	pluta
senatörler	senatori
kanama	krvarenje
niteleme	karakterizacija
olasılık	vjerojatnost
şerit	staze
temelleri	osnove
bulaşma	kontaminacija
kubbe	kupola
kutsamak	blagosloviti
müzakere	Pregovaranje
ibik	vrh
rakipler	protivnici
zafer	trijumf
aday	nominiran
kaynak	zavarivanje
orgazm	orgazam
alaşım	legura
araziler	parcele
nazikçe	nježno
kilitleme	zaključavanje
kontrollü	kontroverzno
çizer	neriješeno
buzdolabı	hladnjak
bıçaklar	noževi
döngüler	petlje
dalgalanma	udar
travma	trauma
ilan	oglas
savunma	obrambeni
yasak	zabranjen
vanilya	vanilija
programcılar	programera
izlenen	prati
tesisat	instalacije
ruhlar	duše
motive	motiviran
dilsiz	glup
oyuk	šupalj
tonoz	svod
oluk	žlijeb
vahiy	otkrivanje
kovalama	potjera
delegasyon	delegacija
teller	žice
sözlükleri	rječnici
şeffaflık	prozirnost
yörünge	orbita
para	valute
Nijer	Niger
konumlandırma	namještanje
koloni	kolonija
top	top
sirk	cirkus
terfi	unaprijeđen
alabalık	pastrva
ustalık	podvig
geçici	privremeno
pişmiş	kuhan
iletmek	prenositi
frekansları	frekvencije
yansımalar	razmišljanje
açlık	glad
belediye	općina
dedektif	detektiv
çimento	cement
yaşandığı	doživljava
şömine	kamin
ciro	odobrenje
tekstil	tekstil
füze	raketa
psikiyatri	psihijatrija
asist	asistencija
denetçi	revizor
keman	violina
peygamber	prorok
oksit	oksid
muhteşem	veličanstven
derhal	brzo
adaptasyon	prilagodba
zararlı	štetan
cinsel	seksualno
kuşatma	prilog
glikoz	glukoza
norm	norma
playback	reprodukcija
kaplumbağa	kornjača
mesafeler	udaljenosti
emme	apsorpcija
hazineler	blaga
fosil	fosil
kötü	Loše
komünist	komunist
girişimciler	poduzetnici
robotlar	roboti
faul	prekršaj
biyoçeşitlilik	bioraznolikosti
heyecan	uzbuđenje
sözlü	glagolski
denizler	morima
gizemli	misteriozan
yenilik	novost
fayans	pločice
kütüphaneci	bibliotekar
anahtarlamalı	uključen
ru	ru
poz	poza
gram	grama
terapist	terapeut
bütçeleri	proračuni
keçi	Jarac
kılmak	učiniti
yelken	ploviti
komisyon	povjerenici
yoğun	gust
cesur	hrabar
nakliye	prosljeđivanje
korkunç	grozan
uçak	zrakoplov
organizmalar	organizmi
teleskop	teleskop
asbest	azbest
ilerleme	napredak
Söğüt	vrba
özgeçmiş	nastavlja
var	postojala
jeneratörler	generatori
üretir	generira
patates	krumpir
tam	temeljita
reseptörleri	receptori
Optimum	optimalno
yaratık	stvorenje
yalnız	usamljen
ince	fin
çizgili	pruge
firmware	firmware
çoban	pastir
beşik	kolijevka
rektör	kancelar
un	brašno
tartışma	polemika
efsanevi	legendaran
koro	zbor
kaçınma	izbjegavanje
güzel	lijepo
beklediğini	očekuje
atlama	skakanje
kumaşlar	tkanine
polimer	polimer
temizlik	higijena
Erdem	vrlina
cerrahlar	kirurzi
manda	mandat
külliyat	zbirka
terminoloji	terminologija
beyefendi	gospodin
suçlu	osuđen
jetleri	mlaznice
endeksleri	indeksi
qui	qui
tehdit	prijeteći
eylemciler	aktivisti
tutsak	zatvorenik
teşvik	potiče
birleştirilmiş	sklopljen
terminalleri	terminali
ham	Sirovi
inceler	ispituje
viking	viking
Temizlemek	počistiti
şartlı	uvjetna
saldırıya	napadnut
geldiğinde	stigne
çevirmen	prevoditelj
otomobiller	automobili
traktör	traktor
kıta	kontinent
ücretler	cijene
boylam	dužina
ümit	nadao
sokma	umetanje
kısıtlama	ograničenje
güçlendirme	jačanje
isteyen	želeći
izolasyon	izolacija
ihlal	prekršaj
kıvrılmış	savijen
öznel	subjektivan
canavarlar	čudovišta
iltica	azil
kazık	ulog
kokteyl	koktel
çeşitleri	sorte
zehir	Otrov
hakim	dominira
pahalı	skup
türevler	derivati
önler	sprječava
tüfek	puška
ırkçılık	rasizam
yorumlamak	protumačiti
anlaşma	sporazum
mütevazi	skroman
oyuncular	igračima
sınıflandırma	sortiranje
irtibat	veza
ampuller	žarulje
turistler	turisti
davranışlar	ponašanja
açıklamak	razjasniti
bel	struk
atfedilen	pripisuje
baykuş	sova
kristaller	kristali
aşan	prelazi
tamamlayıcı	dopunski
savaşlar	bitke
acı	gorak
muhtıra	memorandum
ejderha	zmajevi
gürültü	buka
inanılmaz	nevjerojatno
delegeler	delegati
psikiyatrik	psihijatrijski
gençler	tinejdžeri
avlu	dvorište
başkanlar	predsjednici
ayrılmak	odstupiti
açıkça	izričito
zambak	ljiljan
gözetim	nadzor
reçine	smola
Müttefikler	saveznici
korunmuş	očuvan
çarpı	prešao
yükselen	uzlazni
nominal	nazivni
çürüme	raspad
kuvars	kvarcni
kayıtlar	registri
sekizinci	osmi
yetkili	odobren
geliştirir	poboljšava
savunucuları	zagovara
fenomenler	pojave
eğim	nagib
granit	granit
kitleler	mase
atlet	atletičar
frank	franak
benzerlik	sličnost
sızıntı	curenje
danışman	savjetnik
kitapçık	knjižica
bekliyor	očekujući
devir	promet
idrar	urin
havlu	ručnik
zencefil	đumbir
kromozom	kromosom
als	als
sinekler	muhe
yetki	nadležnost
ağlayan	plač
amatör	amateri
vinç	dizalica
soruşturma	istražuje
çürük	pokvaren
alışkanlık	navika
Onur	čast
korur	štiti
iris	iris
yönetir	upravlja
erozyon	erozija
marangoz	stolar
Kağan	kan
yetersiz	nedovoljan
formülasyon	formuliranje
zeki	pametan
Lordlar	gospodari
zevkli	ugodna
hilâl	srp
altmış	šezdeset
konsantre	koncentriran
ayırmak	razlikovati
ei	ei
projeksiyonlar	projekcije
kıvılcım	iskra
sabitleme	osiguranje
patika	staza
dedektörler	detektori
başak	šiljak
bileşen	sastojak
perde	zavjesa
ifşa	opisana
taktik	taktički
pilotlar	piloti
sefer	ekspedicija
faal	operativan
Mizah	humor
mol	mol
damga	otisak
yardım	pomažući
kusur	mana
kötü	slabo
tanrıça	Božica
gözlemciler	promatrači
mıknatıslar	magneti
formüller	formula
geniş	prostran
savunuyor	tvrdi
topraklar	tla
organlar	organi
det	Det
bağlılık	odanost
sadık	vjeran
suç	prekršaj
lityum	litij
sıçrama	skok
kurucu	osnivanje
kuğu	labud
Ekim	sjetva
antlaşma	savez
arkeoloji	arheologija
denizci	mornar
bakımları	brige
barınak	svetilište
heykel	kip
alıntı	citat
binbaşı	većim
hile	manipulacija
çanlar	zvona
toksisite	toksičnost
verici	odašiljač
mahalleler	četvrti
ganimet	trofej
duygu	emocija
manzaraları	znamenitosti
üniformalar	uniforme
yaralı	ranjen
türev	derivat
işgal	stanovanje
dozlar	doze
Eğitmek	obrazovati
önyargı	predrasuda
teknisyenleri	tehničari
muhtemel	vjerojatan
yayınlama	izdavanje
dekorasyon	ukras
uyruklu	državljani
Truva	trojanski
yardımcıları	asistenti
danışman	savjetnik
yürürlüğe	donesen
kararsız	nestabilan
çağırdı	pozvao
yansıtan	odražavajući
kazanma	dobivanjem
kesin	konačan
seyahat	putovao
uyarlamak	prilagoditi
katılım	pristupanje
regülatör	regulator
yakıtlar	goriva
soya	soja
temiz	uredan
adlandırma	imenovanje
kıç	krma
hazırlanmış	izrađen
salak	idiot
oluşan	sastoji
uzaylılar	vanzemaljci
düzenlemeler	izmjene
kuzgun	gavran
Konut	stan
sembolik	simboličan
açılar	kutovi
basınçları	pritisci
Venüs	Venera
alevler	plamen
ilkel	primitivan
çorap	čarapa
ekosistem	ekosustav
salonları	dvorane
basitlik	jednostavnost
iblis	demon
karşıladı	dobrodošla
notasyonu	notacija
teyze	tetka
karga	vrana
anlamsal	semantički
durdurulan	ukinut
karar	odlučuje
küreselleşme	globalizacija
eşekler	magaraca
pusula	kompas
gelişti	razvio
piyade	pješaštvo
ünlü	slavan
koridor	hodnik
felsefi	filozofski
gerekçe	opravdanje
boş	prazan
sabitleme	popravljanje
gram	gram
gizleme	skrivanje
boya	boja
alfabe	abeceda
temizlenir	očišćeni
şerefli	poštovan
optik	optički
telefonlar	telefoni
günlükler	dnevnici
keder	tuga
ter	znoj
Yunus	dupin
harikaları	čuda
havalandırma	ventilacija
maskeler	maske
büst	poprsje
geçit	drvored
yolları	putevi
telgraf	telegraf
anıt	spomenik
resmen	formalno
çiy	rosa
çekilmiş	povučen
tartışmalar	rasprave
kimlikler	identiteti
eksiklik	nedostatak
sele	sedlo
sıtma	malarija
sadık	odan
eğilim	sklonost
kullanılan	koristi
ein	ein
dürbün	dvogled
başlatmak	pokrenuti
yalnızca	potpuno
canlı	živ
iddialar	navodi
tekabül	odgovara
şeytan	demon
ünlü	slavni
avcılar	lovci
hareket	djelovao
katsayı	koeficijent
kafatası	lubanja
devam	nastavljanje
hizmetçi	sluga
şahin	Sokol
ortaklaşa	zajednički
kaçınılması	izbjegavati
açıklamalar	objašnjenja
yenilenmiş	obnovljen
eleştirmen	kritičar
tortu	sediment
kareler	trgovi
minibüsler	kombija
koni	konus
hayatta	preživio
yaygınlık	rasprostranjenost
fragman	fragment
taahhüt	obvezuje
kobra	kobra
attı	bacio
hoc	hoc
sanatçılar	izvođači
tatlı	desert
tez	disertacija
dokuzuncu	deveti
coşku	entuzijazam
kutlamaları	slavlja
valiler	guverneri
atomları	atomi
Dokular	tkiva
rampa	rampa
güzelce	lijepo
della	della
egemenlik	dominacija
akor	akordi
bozulma	poremećaj
molekül	molekula
