of	di
että	a
sisään	in
varten	per
on	è
päällä	sopra
että	quella
mennessä	di
Tämä	Questo
kanssa	con
minä	io
sinä	tu
se	esso
tai	o
olla	essere
olemme	siamo
at	a
kaikki	tutti
omistaa	avere
Uusi	nuovo
me	noi
tahtoa	volere
Koti	casa
meille	noi
noin	di
jos	Se
sivu	pagina
minun	mio
on	ha
Hae	ricerca
vapaa	gratuito
mutta	ma
meidän	nostro
yksi	uno
muut	altro
tehdä	fare
tiedot	informazione
aika	tempo
hän	lui
joka	quale
heidän	loro
uutiset	notizia
käyttää	uso
siellä	Là
nähdä	vedere
niin	così
Kuka	chi
verkko	web
myös	anche
saada	ottenere
pm	pm
näkymä	vista
C	c
e	e
ensimmäinen	primo
ollut	stato
olisi	voluto
olivat	erano
s	S
Kuten	piace
x	X
kuin	di
löytö	trova
hinta	prezzo
takaisin	indietro
ylin	superiore
ihmiset	persone
oli	aveva
lista	elenco
nimi	nome
vain	appena
vuosi	anno
päivä	giorno
osaksi	in
kaksi	Due
terveys	Salute
n	n
re	ri
käytetty	Usato
mennä	partire
b	B
kestää	ultimo
tehdä	rendere
niitä	loro
pitäisi	dovrebbero
tuote	Prodotto
järjestelmä	sistema
lähettää	inviare
hänen	sua
kaupunki	città
T	t
politiikka	politica
määrä	numero
tuki	supporto
viesti	Messaggio
jälkeen	dopo
sitten	poi
tammikuu	gennaio
hyvä	bene
d	d
missä	dove
tiedot	Informazioni
oikeudet	diritti
kirjat	libri
korkea	alto
koulu	scuola
m	m
kukin	ogni
linkit	link
hän	lei
vuotta	anni
tilata	ordine
erittäin	molto
kirja	libro
kohdetta	elementi
yhtiö	azienda
R	r
lukea	leggere
ryhmä	gruppo
sukupuoli	sesso
monet	molti
käyttäjä	utente
de	de
sarja	impostato
yleinen	generale
tutkimus	ricerca
yliopisto	Università
tammikuu	gennaio
posti	posta
koko	pieno
arvostelut	recensioni
ohjelmoida	programma
tietää	conoscere
pelit	Giochi
tapa	modo
päivää	giorni
p	p
osa	parte
voisi	poteva
loistava	grande
yhdistynyt	unito
todellinen	vero
f	f
kansainvälinen	internazionale
keskusta	centro
matkustaa	viaggio
kommentit	Commenti
tehty	fatto
kehitys	sviluppo
raportti	rapporto
jäsen	membro
yksityiskohdat	dettagli
linja	linea
ehdot	condizioni
ennen	prima
hotellit	alberghi
teki	fatto
lähettää	inviare
oikea	destra
tyyppi	genere
paikallinen	Locale
nuo	quelli
tulokset	risultati
toimisto	ufficio
kansallinen	nazionale
auto	auto
design	design
ottaa	prendere
lähetetty	postato
osoite	indirizzo
Yhteisö	Comunità
sisällä	entro
valtiot	stati
haluta	volere
puhelin	Telefono
DVD	DVD
aihe	soggetto
välillä	fra
foorumi	Forum
perhe	famiglia
l	l
pitkä	lungo
w	w
show	mostrare
O	o
jopa	anche
musta	nero
erityinen	speciale
indeksi	indice
ollessa	essere
naiset	donne
paljon	tanto
merkki	cartello
tiedosto	file
linkki	collegamento
avata	Aperto
etelä	Sud
tapaus	Astuccio
projekti	progetto
sivut	pagine
versio	versione
jakso	sezione
oma	proprio
talo	Casa
turvallisuus	sicurezza
g	g
lääni	contea
amerikkalainen	americano
kuva	foto
peli	gioco
jäsenet	membri
teho	energia
verkko	Rete
tietokone	computer
järjestelmät	sistemi
kolme	tre
paikka	posto
pää	fine
h	h
häntä	lui
kohti	per
pääsy	accesso
ajatella	pensare
pohjoinen	nord
voimavarat	risorse
nykyinen	attuale
iso	grande
tiedotusvälineet	media
laki	legge
ohjaus	controllo
vesi	acqua
historia	storia
koko	dimensione
henkilökohtainen	personale
opas	guida
myymälä	negozio
hakemisto	elenco
muuttaa	modificare
valkoinen	bianca
teksti	testo
pieni	piccolo
luokitus	valutazione
nopeus	Vota
hallitus	governo
lapset	bambini
palata	ritorno
opiskelijoille	studenti
v	v
tili	account
ajat	volte
taso	livello
digitaalinen	digitale
profiili	profilo
Edellinen	precedente
muoto	modulo
Tapahtumat	eventi
rakkaus	amore
vanha	vecchio
Johannes	John
tärkein	principale
puhelu	chiamata
kuva	Immagine
osasto	Dipartimento
otsikko	titolo
ei	non
K	K
y	y
vakuutus	assicurazione
on	deve
omaisuus	proprietà
luokka	classe
CD	CD
laatu	qualità
joka	ogni
listaus	listato
pitoisuus	soddisfare
maa	nazione
vähän	piccolo
Työkalut	utensili
matala	Basso
Vastaa	rispondere
asiakas	cliente
joulukuu	dicembre
vertailla	confrontare
elokuvat	film
college	Università
arvo	valore
artikla	articolo
mies	uomo
työpaikkaa	lavori
j	j
ruoka	cibo
kirjailija	autore
eri	diverso
U	u
oppia	imparare
myynti	saldi
Tulosta	stampare
kurssi	corso
Job	lavoro
huone	camera
kalusto	azione
koulutus	formazione
liian	pure
luotto	credito
kohta	punto
tiede	scienza
miehet	uomini
luokat	categorie
länsi	ovest
Katso	Guarda
Englanti	Inglese
tiimi	squadra
omaisuus	tenuta
laatikko	scatola
olosuhteet	condizioni
Valokuvat	fotografie
homo	gay
lanka	filo
kategoria	categoria
Huomautus	Nota
elää	vivere
suuri	grande
galleria	galleria
pöytä	tavolo
kuitenkin	però
kesäkuu	giugno
lokakuu	ottobre
marraskuu	novembre
markkinoida	mercato
kirjasto	biblioteca
toiminta	azione
alkaa	inizio
sarja	serie
ominaisuudet	Caratteristiche
ilma	aria
ala	industria
suunnitelma	Piano
ihmisen	umano
Joo	sì
toinen	secondo
kuuma	caldo
kustannus	costo
elokuva	film
foorumit	forum
maaliskuu	marzo
la	la
syyskuu	settembre
sanoa	dire
menossa	andando
lääketieteellinen	medico
ystävä	amico
joulukuu	dicembre
palvelin	server
hakemus	applicazione
henkilöstö	personale
pelata	giocare
kysymykset	problemi
huhtikuu	aprile
käyttäjät	utenti
katu	strada
aihe	argomento
vastaan	contro
sai	avuto
blogi	blog
juhla	festa
maksu	pagamento
laitteet	attrezzatura
antaa	permettere
ohjelmat	programmi
oikeudellinen	legale
viimeaikainen	recente
pysäköidä	parco
toimia	atto
ongelma	problema
punainen	rosso
antaa	dare
muisti	memoria
esitys	prestazione
sosiaalinen	sociale
q	q
tarina	storia
myydä	vendere
vaihtoehtoja	opzioni
kokea	Esperienza
avain	chiave
ruumis	corpo
nuori	giovane
tärkeä	importante
ala	campo
harvat	pochi
itään	est
yksittäinen	singolo
ii	ii
ikä	età
klubi	club
esimerkki	esempio
tytöt	ragazze
z	z
tie	strada
lahja	regalo
kysymys	domanda
ca	circa
kova	difficile
maksaa	pagare
neljä	quattro
pokeri	poker
ongelma	problema
alue	gamma
rakennus	costruzione
myyjä	venditore
tuomioistuin	Tribunale
helmikuu	febbraio
tulos	risultato
valo	leggero
kirjoittaa	Scrivi
sota	guerra
tarjous	offrire
sininen	blu
ryhmät	gruppi
ai	al
helppo	facile
tietty	dato
pyyntö	richiesta
faksi	fax
Kiina	Cina
tehdä	fabbricazione
kuva	immagine
tarpeisiin	esigenze
mahdollinen	possibile
kuukausi	mese
suuri	maggiore
tähti	stella
tulevaisuus	futuro
tila	spazio
komitea	Comitato
käsi	mano
aurinko	sole
kortit	carte
Lontoo	Londra
tapaaminen	incontro
tulla	diventare
lapsi	bambino
pitää	conservare
porno	porno
Jaa	Condividere
samankaltainen	simile
puutarha	giardino
koulut	scuole
miljoona	milione
lisättyä	aggiunto
viite	riferimento
yritykset	aziende
vauva	bambino
oppiminen	apprendimento
energia	energia
juosta	correre
toimitus	consegna
suosittu	popolare
termi	termine
elokuva	film
tarinoita	storie
laittaa	mettere
päiväkirja	rivista
raporttien	rapporti
co	co
yrittää	provare
kuvien	immagini
ilmoitus	Avviso
Jumala	Dio
alkuperäinen	originale
pää	capo
radio	Radio
solu	cellula
neuvosto	consiglio
sisältää	include
seurata	traccia
keskustelu	discussione
arkisto	archivio
toiset	altri
sopimus	accordo
muoto	formato
yhteiskunta	società
kuukaudet	mesi
turvallisuus	sicurezza
ystävät	amici
varma	sicuro
painos	edizione
viestien	messaggi
markkinointi	marketing
kertoa	raccontare
yhdistys	associazione
tarjoaa	fornisce
hauska	divertimento
jo	già
vihreä	verde
opinnot	studi
kiinni	vicino
yhteinen	Comune
erityinen	specifica
useat	parecchi
elävä	vita
kokoelma	collezione
nimeltään	chiamato
lyhyt	corto
arts	arti
erä	lotto
kysyä	Chiedere
rajallinen	limitato
ratkaisut	soluzioni
johtaja	direttore
ranta	spiaggia
menneisyys	passato
luonnollinen	naturale
elektroniikka	elettronica
päälle	su
aika	periodo
suunnittelu	pianificazione
sanoo	dice
virallinen	ufficiale
maaliskuu	mar
tehty	fatto
tekninen	tecnico
ikkuna	finestra
ammattilainen	professionista
alue	regione
saari	isola
ennätys	disco
suoraan	diretto
konferenssi	conferenza
asiakirjat	record
st	st
piiri	quartiere
kalenteri	calendario
kustannukset	costi
tyyli	stile
selvitys	dichiarazione
mailia	miglia
resurssi	risorsa
sovellukset	applicazioni
asiakirja	documento
sana	parola
teokset	lavori
materiaali	Materiale
laskuttaa	conto
kirjallinen	scritto
säännöt	regole
lopullinen	finale
asia	cosa
keskusta	centro
vaatimuksista	requisiti
TOTTA	VERO
minuutit	minuti
muu	altro
merkki	marchio
rock	roccia
huono	cattivo
yksilö	individuale
plus	più
auto	auto
peite	copertina
muokata	modificare
yhdessä	insieme
Videot	video
nopeasti	veloce
toiminto	funzione
tosiasia	fatto
saada	ottenere
maailmanlaajuinen	globale
teknologia	Tech
tavata	incontrare
pitkälle	lontano
taloudellinen	economico
fi	it
pelaaja	giocatore
hankkeet	progetti
määrä	quantità
katsella	orologio
Sisältää	incluso
tuntea	sentire
pankki	banca
riski	rischio
tarjoukset	offerte
eri	vario
sanat	parole
tuotanto	produzione
kaupallinen	commerciale
paino	peso
sydän	cuore
hoito	trattamento
pistettä	punti
tuntemus	conoscenza
aikakauslehti	rivista
virhe	errore
kamera	telecamera
tyttö	ragazza
rakentaminen	costruzione
lelut	giocattoli
kirjattu	registrato
verkkotunnuksen	dominio
menetelmät	metodi
luku	capitolo
suojaus	protezione
politiikkaa	politiche
leveä	largo
kauneus	bellezza
johtaja	manager
Intia	India
asento	posizione
otettu	prese
järjestellä	ordinare
listat	annunci
tunnettu	conosciuto
puoli	metà
tapauksissa	casi
vaihe	passo
tekniikka	ingegneria
yksinkertainen	semplice
nopea	Presto
lisenssi	licenza
järvi	lago
koko	totale
vuotuinen	annuale
julkaistu	pubblicato
kirkko	Chiesa
menetelmä	metodo
aktiivinen	attivo
vastaus	risposta
kuva	figura
tarvikkeet	materiale
tarpeeksi	abbastanza
suunnitellut	progettato
keskuudessa	tra
kuolema	Morte
menetys	perdita
kasvot	viso
brändi	marca
alennus	sconto
tehosteet	effetti
luotu	creato
standardit	norme
bitti	po
poliittinen	politico
kuningaskunta	regno
pohja	base
tekemässä	fare
lainat	prestiti
kengät	scarpe
merkintä	iscrizione
pysyä	restare
tilaukset	ordini
saatavuus	disponibilità
yhteenveto	sommario
vuoro	turno
kasvu	crescita
toimisto	agenzia
kuningas	re
eurooppalainen	europeo
aktiviteetti	attività
kopio	copia
Läntinen	occidentale
pakottaa	vigore
työllisyys	occupazione
lahti	baia
joki	fiume
komissio	commissione
paketti	pacchetto
nähdään	visto
pelaajat	Giocatori
moottori	motore
portti	porta
albumi	album
alueellinen	regionale
Stop	Stop
aloitti	iniziato
antaminen	amministrazione
baari	bar
instituutti	istituto
näkymät	visualizzazioni
kaksinkertainen	Doppio
koira	cane
pian	presto
linjat	Linee
elektroninen	elettronico
hyötyjä	benefici
tarvittu	necessaria
kirjoitin	stampante
kunto	condizione
tehokas	efficace
uskoa	credere
organisaatio	organizzazione
vaikutus	effetto
mieli	mente
valinta	selezione
kasino	casinò
PDF	PDF
kiertue	giro
ylittää	attraversare
toivoa	speranza
yhtiö	società
toive	desiderio
ratkaisu	soluzione
kypsä	maturo
rooli	ruolo
viikkoa	settimane
tietty	certo
alempi	inferiore
välttämätön	necessario
liitto	unione
mon	mon
com	com
tietty	particolare
hieno	bene
tunnin	ora
kaasu	gas
taidot	abilità
kuusi	sei
Puska	cespuglio
saaret	isole
neuvot	consigli
ura	carriera
päätös	decisione
jättää	partire
pre	pre
valtava	enorme
nainen	donna
laitteisto	strutture
tarjous	offerta
keskimmäinen	mezzo
kaapeli	cavo
mahdollisuudet	opportunità
ottaen	presa
arvot	valori
jako	divisione
tuleva	venuta
esine	oggetto
lesbo	lesbica
sopiva	adeguata
kone	macchina
logo	logo
pituus	lunghezza
kiva	simpatico
pisteet	Punto
tilasto	statistica
asiakas	cliente
näyte	campione
investointi	investimento
lähetetty	inviato
esitetty	mostrato
joulu	Natale
kulttuuri	cultura
salama	veloce
neiti	Signorina
valinta	scelta
kurssit	corsi
kuluttaja	consumatore
Moi	Ciao
ulkomainen	straniero
taiteilija	artista
huonekalut	mobilia
kanava	canale
kirje	lettera
tila	modalità
puhelimet	telefoni
ideoita	idee
rakenne	struttura
aste	grado
sopimus	contrarre
Super	super
Uros	maschio
asia	importa
melkein	quasi
sijaitsevat	collocato
moninkertainen	multiplo
jakelu	distribuzione
toimittaja	editore
majatalo	Locanda
teollinen	industriale
mahdollinen	potenziale
laulu	canzone
los	los
pudota	autunno
ajatus	idea
Huoneet	camere
viestintä	comunicazioni
voittaa	vincere
ensisijainen	primario
syöpä	cancro
numerot	numeri
syy	ragionare
työkalu	strumento
kevät	primavera
perusta	fondazione
vastaus	risposta
ääni	voce
ajoittaa	programma
asiakirjat	documenti
tarkoitus	scopo
ominaisuus	caratteristica
sänky	letto
tulee	viene
Poliisi	polizia
itsenäinen	indipendente
lähestyä	approccio
ruskea	Marrone
fyysinen	fisico
mäki	collina
kartat	mappe
pitää	tenere
luokitukset	giudizi
onnellinen	contento
seppä	fabbro
kehittyneillä	sviluppato
kiittää	grazie
turvallinen	sicuro
ainutlaatuinen	unico
tutkimus	sondaggio
ennen	precedente
puhelin	telefono
Urheilu	sport
valmis	pronto
eläin	animale
lähteet	fonti
väestö	popolazione
pa	papà
säännöllinen	regolare
turvallinen	sicuro
toiminnot	operazioni
yksinkertaisesti	semplicemente
näyttö	prova
asema	stazione
ymmärtää	capire
vaihtoehto	opzione
laakso	valle
todennäköisesti	probabilmente
meri	mare
Julkaisut	pubblicazioni
parantaa	Migliorare
yhteys	connessione
kustantaja	editore
sali	sala
anti	anti
verkot	reti
maa	terra
vanhemmat	genitori
vaikutus	urto
siirtää	trasferimento
esittely	introduzione
keittiö	cucina
vahva	forte
häät	nozze
ominaisuudet	proprietà
sairaala	ospedale
maa	terra
alus	nave
majoitus	alloggio
tauti	malattia
erinomainen	eccellente
täydellinen	perfezionare
hiukset	capelli
tilaisuus	opportunità
pakki	kit
klassikko	classico
perusta	base
komento	comando
kaupungit	città
ilmaista	esprimere
myöntää	premio
etäisyys	distanza
puu	albero
arviointi	valutazione
seinä	parete
osallistuva	coinvolti
el	EL
ylimääräinen	extra
erityisesti	particolarmente
talousarvio	bilancio
oppaita	guide
menestys	successo
enimmäismäärä	massimo
äiti	mamma
operaatio	operazione
nykyinen	esistente
melko	abbastanza
valittu	selezionato
poika	ragazzo
ravintolat	ristoranti
kaunis	bellissimo
Varoitus	avvertimento
sijainnit	posizioni
hevonen	cavallo
äänestys	votazione
kukat	fiori
tähdet	stelle
luettelot	liste
omistaja	proprietario
eläimet	animali
tapoja	modi
poika	figlio
tarjoaminen	fornitura
sääntö	regola
kotelo	alloggiamento
kestää	prende
tuoda	portare
luettelo	Catalogare
max	max
äiti	madre
auktoriteetti	autorità
kertoi	detto
ohjelmoida	programma
liittyi	Iscritto
panos	ingresso
strategia	strategia
jalkaa	piedi
agentti	agente
pätevä	valido
moderni	moderno
vanhempi	anziano
seksikäs	sexy
opetus	insegnamento
ovi	porta
suuri	grande
oikeudenkäynti	prova
yksiköt	unità
viileä	freddo
normaali	normale
yritys	impresa
laivat	navi
koko	intero
positiivinen	positivo
kunto	fitness
Kiinalainen	Cinese
lausunto	opinione
jalkapallo	calcio
abstrakti	astratto
ulostulo	produzione
varat	fondi
Herra	Sig
todennäköisesti	probabile
kehittää	sviluppare
Taiteilijat	artisti
vaihtoehto	alternativa
vastuu	responsabilità
Jaava	Giava
vieras	ospite
julkaisu	pubblicazione
kulkea	passaggio
suhteet	relazioni
luottamus	fiducia
pakettiauto	furgone
sisältää	contiene
multi	Multi
tasavalta	repubblica
palkkiot	tasse
komponentit	componenti
loma	vacanza
vuosisata	secolo
akateeminen	accademico
apu	assistenza
valmistunut	completato
iho	pelle
grafiikka	grafica
intialainen	indiano
rengas	squillare
arvosana	grado
vuori	montagna
organisaatioiden	organizzazioni
suodattaa	filtro
paneeli	pannello
lattia	pavimento
ostaminen	acquisto
ottelu	incontro
ehdotettu	proposto
vaatia	richiedere
pojat	ragazzi
aamu	mattina
sallii	consente
proteiini	proteina
kasvi	pianta
raportoitu	segnalati
osuma	colpire
mm	mm
pool	piscina
mini	mini
politiikka	politica
kumppani	compagno
kirjoittajat	autori
levyt	tavole
kalastaa	pesce
jäsenyys	membri
tehtävä	missione
silmä	occhio
jono	stringa
tunne	senso
muokattu	modificata
julkaisi	rilasciato
vaihe	palcoscenico
sisäinen	interno
syntynyt	Nato
yksityiskohtainen	dettagliato
japanilainen	giapponese
rotu	gara
hyväksytty	approvato
kohde	bersaglio
paitsi	tranne
merkki	carattere
ylläpito	Manutenzione
kyky	capacità
toim	Ed
raiskata	stupro
akku	batteria
nuoret	gioventù
paine	pressione
toimitettu	presentata
velka	debito
keskikokoinen	medio
televisio	televisione
kiinnostunut	interessato
ydin	nucleo
tauko	rompere
tarkoituksiin	scopi
setit	imposta
tanssi	danza
puu	legna
määritellyt	definito
paperit	documenti
palkinnot	premi
maksu	tassa
studio	studio
lukija	lettore
laite	dispositivo
perusti	stabilito
vastauksia	risposte
vuokrata	affitto
las	las
tumma	buio
ulkoinen	esterno
omena	Mela
le	Le
ohjeet	Istruzioni
min	min
tarjotaan	offerta
teoria	teoria
poistaa	rimuovere
apu	aiuto
visuaalinen	visivo
isäntä	ospite
lajike	varietà
opettajat	insegnanti
manuaalinen	Manuale
lohko	bloccare
aiheita	soggetti
aineet	agenti
korjaus	riparazione
oikeudenmukainen	giusto
teräs	acciaio
ymmärtäminen	comprensione
lauluja	canzoni
kiinteä	fisso
väärä	sbagliato
alku	inizio
käsissä	mani
az	az
Pariisi	Parigi
saa	prende
sektori	settore
kapasiteetti	capacità
un	un
rasva	Grasso
isä	padre
sähköinen	elettrico
näin	sega
välineet	strumenti
upseeri	ufficiale
kuljettaja	autista
yritykset	aziende
kuollut	morto
tuntematon	sconosciuto
ravintola	ristorante
mikrofoni	Mike
matka	viaggio
mi	mi
huono	povero
yhteys	relazione
työntekijöiden	lavoratori
rauha	pace
perinteinen	tradizionale
osoittavat	mostrando
luova	creativo
rannikko	costa
hyöty	vantaggio
rahoitus	finanziamento
laitteet	dispositivi
herra	signore
myöntää	concedere
sub	sub
kaunokirjallisuus	finzione
kellot	orologi
uraa	carriere
menee	va
led	guidato
museo	Museo
tuuletin	fan
kuljetus	trasporto
mielenkiintoista	interessante
blogit	blog
arviointi	valutazione
entinen	ex
vyöhyke	zona
monimutkainen	complesso
th	esimo
kissa	gatto
kuolla	morire
esittelyyn	presentata
tasainen	piatto
virtaus	flusso
virastojen	agenzie
kirjallisuus	letteratura
vanhempi	genitore
asetus	ambientazione
DR	dr
asteikko	scala
talous	economia
hyödyllinen	utile
kuukausittain	mensile
kriittinen	critico
kehys	telaio
musikaali	musicale
määritelmä	definizione
sihteeri	segretario
polku	sentiero
päällikkö	capo
antaa	dà
paketit	Pacchetti
yksityiskohta	dettaglio
lait	legislazione
muutettu	cambiato
alkaa	inizio
kuninkaallinen	reale
puhdas	pulito
kaveri	tipo
otsikot	titoli
merkityksellinen	pertinente
oikeudenmukaisuus	giustizia
kytkeä	Collegare
kuppi	tazza
kori	cestino
soveltava	applicato
viikoittain	settimanalmente
vol	vol
asennus	installazione
pp	pp
huomio	Attenzione
edetä	avanzare
hyppiä	Salta
ruokavalio	dieta
armeija	esercito
vaihde	Ingranaggio
ero	differenza
sallittu	permesso
oikea	corretta
kansakunta	nazione
myynti	vendita
paljon	molte
pala	pezzo
arkki	foglio
yritys	azienda
seitsemän	Sette
elementtejä	elementi
laji	specie
hypätä	saltare
solut	cellule
moduuli	modulo
lomakeskus	ricorrere
todistus	certificato
ministeri	ministro
liike	movimento
muoti	moda
ohjeet	indicazioni
vierailijat	visitatori
dokumentointi	documentazione
kaupankäynti	commercio
metsä	foresta
puhelut	chiamate
kattavuus	copertura
pari	coppia
antaminen	dando
mahdollisuus	opportunità
näkemys	visione
pallo	palla
pääte	fine
asiakkaat	clienti
toimet	Azioni
keskustella	discutere
tavoite	obbiettivo
onnistunut	riuscito
myyty	venduto
tuuli	vento
yhteisöt	comunità
kliininen	clinico
tilanne	situazione
markkinat	mercati
kustannustoiminta	editoriale
ilmestyä	apparire
kehittämällä	sviluppando
elämää	vite
määrittää	determinare
lämpötila	temperatura
ilmoitukset	annunci
potilas	paziente
todellinen	effettivo
historiallinen	storico
kivi	pietra
Bob	peso
kaupankäynti	commercio
henkilöt	persone
vaikea	difficile
tieteellinen	scientifico
satelliitti	satellitare
testit	test
kylä	villaggio
tilit	conti
amatööri	dilettante
entinen	ex
tavannut	incontrato
kipu	dolore
tekijät	fattori
kahvi	caffè
ostaja	acquirente
juliste	manifesto
reuna	bordo
toiminnallinen	funzionale
juuri	radice
fi	fi
suljettu	chiuso
juhlapäivät	vacanze
vaaleanpunainen	rosa
saldo	equilibrio
seuranta	monitoraggio
vastaukset	risposte
laukaus	tiro
alkukirjain	iniziale
etiketti	etichetta
sec	secondo
kaanon	canone
liiga	lega
jätteet	rifiuto
minuutti	minuto
bussi	autobus
toimittaja	fornitore
sanakirja	dizionario
kirjanpito	contabilità
valmistus	produzione
osiot	sezioni
tuoli	sedia
ponnistus	sforzo
vaihe	fase
fantasia	fantasia
po	Po
va	va
professori	Professore
Asentaa	installare
paita	camicia
vaatteet	abbigliamento
jalka	piede
rinta	Seno
tekniikat	tecniche
dollaria	dollari
uskonto	religione
lupa	autorizzazione
villi	selvaggio
sukupolvi	generazione
neiti	Perdere
kemiallinen	chimico
lääkäri	medico
tehtävä	compito
vähentää	ridurre
toi	portato
liikunta	esercizio
vika	insetto
takuu	garanzia
johtaja	capo
SE	SE
prosessit	processi
pehmeä	morbido
kokoukset	incontri
sekuntia	secondi
lento	volo
kongressi	congresso
polttoaine	carburante
kävellä	camminare
valmistettu	prodotta
pyhimys	santo
Perustelu	discussione
kilpailu	concorrenza
huumeita	farmaci
yhteinen	comune
palkkio	premio
tuore	fresco
merkkiä	personaggi
asianajaja	procuratore
di	di
tekijä	fattore
tuhansia	migliaia
km	km
virta	ruscello
huoneisto	appartamenti
valita	raccogliere
kuulo	udito
itäinen	orientale
terapia	terapia
merkinnät	inserimenti
allekirjoitettu	firmato
hallinnollinen	amministrativo
vakava	grave
raja	limite
askeleet	passaggi
kaupat	negozi
orjuus	servitù
del	del
pyrkimyksiä	sforzi
ilmoitti	informato
ga	ga
ajatuksia	pensieri
puro	torrente
ft	ft
määrä	quantità
olennainen	essenziale
matkat	tour
ladata	caricare
heti	subito
koneet	macchine
nimetty	designato
raskas	pesante
katettu	coperto
elpyminen	recupero
integroitu	integrato
kokoonpano	configurazione
kukko	cazzo
kauppias	mercante
kattava	globale
asiantuntija	esperto
suojella	proteggere
vankka	solido
esittely	presentazione
tuli	divenne
oranssi	arancia
noudattaminen	conformità
teema	tema
rikas	ricco
kampanja	campagna
vs	vs
kitara	chitarra
havainto	scoperta
esimerkkejä	esempi
henki	spirito
ar	ar
vaatimukset	reclami
hyväksyminen	accettazione
strategiat	strategie
mo	momento
asioihin	affari
tarkoitettu	destinato
sa	sa
tavoitteet	obiettivi
vuokraus	assumere
vaalit	elezione
ehdottaa	suggerire
haara	ramo
palvella	servire
Kumppanit	affiliati
asentaa	montare
Latina	latino
multimedia	multimedia
hoitaa	gestire
kulma	angolo
arvo	rango
elementti	elemento
syntymä	nascita
virus	virus
interaktiivinen	interattivo
pyynnöt	richieste
erillinen	separato
neljännes	trimestre
menettely	procedura
johto	comando
määritellä	definire
uskonnollinen	religioso
tosiasiat	fatti
aamiainen	colazione
sarake	colonna
usko	fede
ketju	catena
tunnistaa	identificare
katu	viale
puuttuva	mancante
suosituksia	raccomandazioni
siirretty	mosso
saavuttaa	raggiungere
vertailu	confronto
hetki	momento
laajennettu	esteso
jakso	sequenza
tuuma	pollice
hyökkäys	attacco
keskuksissa	centri
aukko	apertura
laboratorio	laboratorio
varata	Riserva
gamma	gamma
tuottaa	produrre
totuus	verità
laskuri	contatore
vika	fallimento
seuraa	segue
dollari	dollaro
leiri	campo
des	des
elokuvat	cinema
silta	ponte
täyttää	riempire
liike	movimento
painaminen	stampa
luonnos	bozza
kartoittaa	grafico
pelataan	giocato
yhteystiedot	contatti
lukijoita	lettori
risti	club
wa	wa
seikkailu	avventura
uhri	offerta
voitto	profitto
johtajat	capi
Julisteet	manifesti
laitokset	istituzioni
avustaja	assistente
muuttuja	variabile
dj	dj
pysäköinti	parcheggio
eilen	ieri
määritetty	determinato
työpaja	laboratorio
mennyt	andato
koodit	codici
Erilaisia	tipi
laajentaminen	estensione
lausuntoja	dichiarazioni
täysin	completamente
joukkueet	squadre
linnake	forte
cm	centimetro
senaatti	senato
hauska	divertente
geeni	gene
kääntyi	trasformato
levy	disco
kuvio	modello
vene	barca
teatteri	Teatro
valmistajat	produttori
sponsori	sponsor
klassinen	classico
ikoni	icona
takuu	garanzia
omistautunut	dedito
suunta	direzione
koripallo	pallacanestro
esineet	oggetti
poistaa	Elimina
ilta	sera
kokoonpano	montaggio
ydinaseiden	nucleare
hiiri	topo
signaali	segnale
rikollinen	penale
annettu	rilasciato
voimakas	potente
unelma	sognare
VÄÄRÄ	FALSE
da	da
heittää	lanciare
kukka	fiore
henkilöstö	personale
läpäissyt	passato
toimitetaan	fornito
Falls	cascate
sielu	anima
edistää	promuovere
totesi	dichiarato
tilastot	statistiche
ammattilaisten	professionisti
näyttää	appare
kuljettaa	trasportare
lippu	bandiera
kannet	coperture
em	em
etu	vantaggio
Hei	Ciao
malleja	disegni
ylläpitää	mantenere
matkailu	turismo
prioriteetti	priorità
aikuiset	adulti
graafinen	grafico
atomi	atomo
maksut	pagamenti
sitova	rilegatura
lyhyt	breve
päättyi	conclusa
voittoisa	vincente
anonyymi	anonimo
käsikirjoitus	copione
palveli	servito
haluaa	vuole
valmis	preparato
mitätön	vuoto
tag	etichetta
haastatella	colloquio
sekoittaa	mescolare
puitteet	struttura
levy	disco
asennetut	installato
kuningatar	Regina
ov	crediti
selvästi	chiaramente
korjata	fissare
kahva	maniglia
makea	dolce
kriteeri	criteri
kumppani	socio
NE	NE
käytös	comportamento
suurentaa	Ingrandire
säde	raggio
tulot	reddito
mitata	misurare
ääntä	voti
du	du
velvollisuus	dovere
keskustelut	discussioni
karhu	orso
saada	guadagno
festivaali	Festival
laboratorio	laboratorio
valtameri	oceano
lennot	voli
asiantuntijat	esperti
merkkejä	segni
syvyys	profondità
kouluttaa	treno
kuiva	asciutto
tutkia	Esplorare
kylpylä	terme
konsepti	concetto
lähes	quasi
käsittely	maneggio
alkuperä	origine
miljardi	miliardo
älykkyys	intelligenza
ostettu	comprato
huijaus	contro
kansakunnat	nazioni
reitti	itinerario
rikki	rotto
taistelu	battaglia
puhua	parlare
protokolla	protocollo
tiedustelu	domanda
kumppanuus	associazione
ilmaisu	espressione
es	es
puhe	discorso
johdin	filo
ehdotukset	suggerimenti
korvaus	sostituzione
nauha	nastro
strateginen	strategico
tuomari	giudice
happo	acido
tavua	byte
sentti	centesimo
pakko	costretto
yhteensopiva	compatibile
huoneisto	appartamento
tyhjä	nullo
nolla	zero
kaiutin	altoparlante
konsultointi	consulenza
suunnittelija	progettista
PR	pr
avioliitto	matrimonio
rulla	rotolo
pankit	banche
FR	fr
osallistujaa	partecipanti
salaisuus	segreto
negatiivinen	negativo
suosikit	preferiti
teatteri	Teatro
jouset	molle
var	var
suorittaa	eseguire
käännös	traduzione
arvioiden	stime
vahinko	ferita
ministeriö	ministero
kuljettajat	driver
lakimies	avvocato
luvut	figure
suojattu	protetta
ehdotus	proposta
jakaminen	compartecipazione
portaali	portale
beeta	beta
ilmaiseksi	gratis
kohti	verso
hieman	leggermente
avustaa	assistere
käytös	condotta
sisälsi	contenuta
lainsäädäntö	legislazione
kutsumus	chiamata
parametrit	parametri
profiilit	profili
asioissa	questioni
talot	case
ohjaimet	controlli
Yhdistetty	combinato
perimmäinen	finale
edustaja	rappresentante
vähäinen	minore
osastot	dipartimenti
asukkaat	residenti
näyttöön	visualizzati
äiti	mamma
pelkistetty	ridotto
harvinainen	raro
suoritettu	eseguita
äärimmäinen	estremo
näytteet	campioni
baarit	barre
ennuste	previsione
poistettu	rimosso
sykli	ciclo
sisältää	contenere
tarkkuus	precisione
nukkua	dormire
mg	mg
lintu	uccello
apteekki	farmacia
luominen	creazione
staattinen	statico
metsästäjä	cacciatore
osoitteet	indirizzi
nainen	signora
kristalli	cristallo
kuuluisa	famoso
kirjailija	scrittore
puheenjohtaja	presidente
juoda	bere
akatemia	accademia
dynaaminen	dinamico
syödä	mangiare
pysyvä	permanente
puhdistus	pulizia
muodostaa	costituisce
salkku	portafoglio
käytännöllinen	pratico
toimitetaan	consegnato
infrastruktuuri	infrastruttura
väri	colore
myyjä	venditore
filosofia	filosofia
säätö	regolamento
upseerit	ufficiali
tavoite	scopo
tarjouksia	offerte
ravitsemus	nutrizione
äänite	registrazione
nuorempi	junior
les	les
viitta	mantellina
renkaat	anelli
kärki	mancia
ihana	meraviglioso
lippu	biglietto
ilmoitti	annunciato
arvaus	indovina
ketä	chi
jalkapallo	calcio
matematiikka	matematica
tuonti	importare
komennus	spedizione
läsnäolo	presenza
Automaattinen	automatico
katselu	visualizzazione
säilyy	mantenuto
ch	ch
dan	dan
koirat	cani
johtajat	registi
näkökohdat	aspetti
eteenpäin	avanti
kuu	Luna
osallistumista	partecipazione
ohjelma	schema
lentää	volare
tapa	maniera
matriisi	matrice
yhdistelmä	combinazione
muutos	emendamento
vahvuus	forza
Turkki	tacchino
kirjastot	librerie
asianmukainen	corretto
astetta	gradi
yrityksille	aziende
delta	delta
pelko	paura
etsiä	cerca
tuumaa	pollici
sopimus	convenzione
osakkeiden	azioni
pääasiallinen	principale
mukavuus	comfort
värit	colori
sodat	guerre
tilaaminen	ordinazione
säilytetään	tenuto
alfa	alfa
valitus	appello
risteily	crociera
bonus	indennità
Hei	Hey
rakennukset	edifici
tarjoukset	Speciali
lyödä	battere
akut	batterie
tulee	diventa
asemat	unità
aseet	braccia
tee	tè
parantunut	migliorata
saavuttaa	raggiungere
kannat	posizioni
pukeutua	vestito
tilaus	sottoscrizione
jakaja	commerciante
nykyajan	contemporaneo
taivas	cielo
rom	rom
kuljettaa	trasportato
valotus	esposizione
piilottaa	nascondere
allekirjoitus	firma
mylläri	mugnaio
säännös	fornitura
vaatteet	Abiti
kehyksiä	montatura
varmasti	certamente
sanomalehti	giornale
lelu	giocattolo
kerros	strato
painettu	stampato
hidas	lento
poistaminen	rimozione
vastuu	responsabilità
tulostimet	stampanti
lisäämällä	aggiungendo
täplä	individuare
viettää	trascorrere
tehdas	fabbrica
sisusta	interno
kasvaa	crescere
optinen	ottico
edistäminen	promozione
suhteellinen	parente
hämmästyttävä	Stupefacente
piste	punto
identiteetti	identità
muuntaminen	conversione
tunne	sensazione
kätketty	nascosto
kohtuullinen	ragionevole
tarkistus	revisione
vaikutus	influenza
suhde	rapporto
merkitys	importanza
sade	pioggia
planeetta	pianeta
kappaletta	copie
lupa	permesso
koska	vedendo
todiste	prova
basso	basso
resepti	prescrizione
tyhjä	vuoto
ilmentymä	esempio
reikä	buco
ratsastaa	cavalcata
toimisto	ufficio
säilyttäminen	conservazione
pari	paio
ihanteellinen	ideale
silmälasit	Specifiche
tallennettu	registrato
Don	don
kappaletta	pezzi
päättynyt	finito
puistot	parchi
lakimiehet	avvocati
stressi	stress
kerma	crema
ss	ss
ajot	piste
löytää	scoprire
ap	ap
kuviot	modelli
Hills	colline
nm	nm
neuvonantaja	consulente
tietoinen	consapevole
muoto	forma
evoluutio	Evoluzione
todistukset	certificati
tavoitteet	obiettivi
asemat	stazioni
ehdotti	suggerito
op	operazione
jäännökset	resti
yritykset	aziende
euro	Euro
operaattori	operatore
rakenteet	strutture
yleinen	generico
tietosanakirja	enciclopedia
käyttö	uso
muste	inchiostro
sekoitettu	misto
väestönlaskenta	censimento
pyörä	ruota
toimittajat	fornitori
kompakti	compatto
runous	poesia
valot	luci
seuranta	puntamento
enkeli	angelo
valmistautuminen	preparazione
yrittää	tentativo
vastaanotetaan	ricevente
Ottelut	fiammiferi
mukaisesti	conformità
leveys	larghezza
moottorit	motori
unohtaa	dimenticare
ryhmä	schieramento
keskusteltiin	discusso
tarkka	preciso
ilmasto	clima
kreikkalainen	greco
ohje	istruzione
hallinnassa	gestione
raaka	crudo
erot	differenze
selittää	spiegare
perustaa	stabilire
ilmaisi	espresso
laajuus	estensione
terävä	acuto
ben	Ben
kohta	paragrafo
tappaa	uccidere
matematiikka	matematica
korvaus	compensazione
viedä	esportare
johtajat	manager
moduulit	moduli
suoritettu	condotto
versiot	versioni
tietää	conosce
kuvata	descrivere
kansalaiset	cittadini
perintö	eredità
vaivata	guaio
valmentaja	allenatore
maatalous	agricolo
laajentaa	espandere
yleisö	pubblico
osoitettu	assegnato
kokoelmat	collezioni
iät	evo
asiantuntija	specialista
kokki	cucinare
vaikuttaa	influenzare
Neitsyt	vergine
kokenut	esperto
tutkimus	indagine
nosti	sollevato
hattu	cappello
instituutio	istituzione
suunnattu	dirette
vaikuttaa	influenzato
pyörä	bicicletta
täysin	totalmente
levy	piatto
kulut	spese
osoittaa	indicare
vaalea	bionda
menettely	procedimento
suosikki	preferito
ominaisuudet	caratteristiche
der	der
menettää	perdere
orgaaninen	biologico
etsiä	ricercare
kokemukset	esperienze
albumit	album
sopimuksia	contratti
vieraita	ospiti
isännöi	ospitato
sairaudet	malattie
koskevat	circa
vastaava	equivalente
kemia	chimica
sarjat	kit
logiikka	logica
prinssi	Principe
ympyrä	cerchio
maaperä	suolo
psykologia	psicologia
märkä	bagnato
olosuhteet	condizioni
sijoittaja	investitore
perus	elementare
sponsorit	sponsor
kettu	Volpe
rajoittamaton	illimitato
vastata	rispondere
koot	dimensioni
tavallinen	pianura
poistuminen	Uscita
käsivarsi	braccio
näppäimet	chiavi
Aalto	onda
pyhä	santo
säädökset	atti
opastus	guida
polku	pista
symboli	simbolo
valtatie	autostrada
havaitun	osservata
dekaani	decano
perustaa	impostare
äänestys	sondaggio
tyylit	stili
täynnä	pieno
side	legame
kanavat	canali
liite	appendice
suklaa	cioccolato
osa	porzione
laajuus	scopo
toimittaja	fornitore
kaapelit	cavi
puuvilla	cotone
vaatimus	Requisiti
surmattu	ucciso
reunus	confine
muinainen	antico
keskustelu	discussione
edustajia	rappresentanti
alkaa	inizia
raskaus	gravidanza
nähtävyydet	attrazioni
oppinut	imparato
liiketoimet	transazioni
tutkimusmatkailija	esploratore
historiallinen	storico
aviomies	marito
valtuutettu	autorizzato
hullu	pazzo
tuleva	imminente
konsertti	concerto
tulokset	punteggi
tehokkuus	efficienza
komedia	commedia
hyväksyttiin	adottato
tehokas	efficiente
lineaarinen	lineare
sitoutuminen	impegno
erikoisuus	specialità
karhut	orsi
hypätä	luppolo
kantaja	vettore
jatkuva	costante
Visa	Visa
suu	bocca
mittari	metro
sidoksissa	connesso
haastattelut	interviste
käsitteet	concetti
ase	pistola
heijastaa	riflettere
puhdas	puro
helvetti	inferno
hedelmä	frutta
alkaa	inizia
pätevä	qualificato
uudistaa	riforma
linssi	lente
käsitelty	trattati
löytö	scoperta
piirtää	disegnare
luokiteltu	classificato
olettaa	assumere
liitto	alleanza
vahvistaa	Confermare
insinööri	ingegnere
johdonmukainen	coerente
korvata	sostituire
raivaaminen	autorizzazione
muunnin	convertitore
organisaatio	organizzazione
tyttö	bambino
tarkastuksia	controlli
saavuttanut	raggiunto
tulossa	diventando
tavoite	obbiettivo
osoitettu	indicato
sokeri	zucchero
miehistö	equipaggio
jalat	gambe
tikku	bastone
suhde	relazione
käytössä	abilitato
laji	genere
vapaaehtoinen	volontario
takaosa	posteriore
demokraattinen	democratico
parantaa	accrescere
tarkka	esatto
sidottu	limite
parametri	parametro
suoritin	processore
solmu	nodo
muodollinen	formale
myrsky	tempesta
mikro	micro
oppilaitokset	collegi
maili	miglio
haasteet	sfide
Editors	redattori
ylin	supremo
veljet	fratelli
tunnustus	riconoscimento
viite	arbitro
arvio	stima
lapsi	ragazzo
tarkastus	ispezione
kuluttajien	consumatori
rajoja	limiti
alue	territorio
aseet	Armi
viive	ritardo
lentäjä	pilota
maksut	contributi
jatkuva	continuo
aloite	iniziativa
uusi	romanzo
suoritus	esecuzione
vammaisuus	invalidità
ultra	ultra
voittaja	vincitore
episodi	episodio
savenvalaja	vasaio
ruokalaji	piatto
pelaa	giochi
tiedotuslehti	bollettino
ia	ia
muuttaa	modificare
todella	veramente
maailmankaikkeus	universo
ehdokas	candidato
aukko	fessura
maksamatta	eccezionale
ha	ah
suunnitellut	pianificato
jättää	casetta
peili	specchio
turnaus	torneo
harkinta	considerazione
istuntoja	sessioni
ydin	nocciolo
ostajien	acquirenti
lehdet	riviste
harmaa	grigio
luettelo	Catalogare
peritään	carico
laaja	ampio
und	und
valittu	scelto
esittely	dimostrazione
vihata	odiare
pääte	terminale
julkaisijat	editori
öisin	notti
neste	liquido
riisi	riso
varaus	prenotazione
elintarvikkeet	Alimenti
vartija	guardia
tallentaa	Salvataggio
imperiumi	impero
hiljattain	recentemente
nostaa	aumentare
laiton	illegale
laajeneminen	espansione
johtava	premier
huomenna	Domani
maito	latte
draama	Dramma
vierailevat	visitare
kilpailu	concorso
koottu	raccolto
bändejä	bande
sopiva	adatto
ehdottomasti	assolutamente
tarkastaa	revisione
kammio	Camera
Guinea	Guinea
tulokset	risultati
ISO	iso
tyypillinen	tipico
summa	somma
kana	pollo
tilapäinen	temporaneo
käydä	assistere
suihku	doccia
lähettäminen	invio
riittävä	sufficiente
kuori	conchiglia
maakunta	Provincia
katolinen	cattolico
kuvernööri	governatore
olut	birra
panos	contributo
kaava	formula
perustuslaki	costituzione
pakkaus	confezione
luotettava	affidabile
epäillä	dubbio
ansaita	guadagnare
aikoja	periodi
iskut	attacchi
kauppatavara	merce
oireet	sintomi
muistomerkki	memoriale
twin	gemello
lisätä	inserire
portti	porta
piirustus	disegno
ehdokkaat	candidati
tilasi	ordinato
biologinen	biologico
taistelevat	combattente
siirtyminen	transizione
mieltymykset	preferenze
vakooja	spiare
romanssi	romanza
väline	strumento
jakaa	Diviso
teemat	temi
valtuudet	potenze
taivas	Paradiso
bitit	bit
raskaana	incinta
luokittelu	classificazione
keskittynyt	focalizzata
lääkäri	medico
pyytäminen	chiede
lohkot	blocchi
katso	Lo
hengellinen	spirituale
diabetes	diabete
ml	ml
siirtää	cambio
istua	sedersi
elinten	corpi
valokuvat	fotografie
leikkaus	taglio
kirjailijat	scrittori
joustava	flessibile
rakastettu	amato
suosikit	preferiti
kartoitus	Mappatura
useat	numerose
suhteellisesti	relativamente
edustaa	rappresenta
esimies	superiore
edullinen	preferito
tallennettu	salvato
älyllinen	intellettuale
myönnetty	concesso
hiili	carbonio
mukava	confortevole
magneettinen	magnetico
vuorovaikutus	interazione
kuuntelee	ascoltando
kriisi	crisi
näkymät	prospettiva
massiivinen	massiccio
kirkas	luminosa
muodostettu	formato
piano	pianoforte
kaiku	eco
vallankumous	rivoluzione
näytöt	visualizza
plasma	plasma
tulot	guadagni
mysteeri	mistero
maisema	paesaggio
mekaaninen	meccanico
matka	viaggio
lippu	bandiera
kuva	Figura
maakunnat	contee
hankinta	acquisizione
tunnistettu	riconosciuto
unelmat	sogni
ilmoitus	notifica
kg	kg
opettaa	insegnare
nopea	rapido
Vedä	Tirare
ut	ut
seminaari	seminario
investoinnit	investimenti
pyörät	ruote
eritellä	specificare
herkkä	sensibile
malleja	modelli
formaatit	formati
pitää	detiene
reititin	router
betoni	calcestruzzo
si	SI
kansio	cartella
valmistuminen	completamento
pulssi	impulso
tekniikka	tecnica
äänestys	voto
tuomioistuimet	tribunali
muunnettu	convertito
metro	Metro
vuosipäivä	anniversario
parannuksia	miglioramenti
kaistale	striscia
määrittely	specificazione
onnettomuus	incidente
lovi	tacca
saatavilla	accessibile
asukas	residente
juoni	tracciare
tyypillisesti	tipicamente
edustus	rappresentazione
pumppu	pompa
olemassa	esiste
järjestelyt	accordi
konferenssit	conferenze
kulutus	consumo
kapea	stretto
uhkaus	minaccia
tutkimukset	sondaggi
istuva	seduta
konsultti	consulente
ohjain	controllore
valiokunnat	comitati
penis	pene
linna	castello
puutarhat	giardini
tarrat	etichette
halukas	disposto
bio	bio
näytteleminen	recitazione
päät	teste
koe	esame
asuinpaikka	residenza
tiheys	densità
sata	centinaio
outo	strano
kestävä	sostenibile
tilastollinen	statistico
mainita	citare
innovaatio	innovazione
harmaa	grigio
rinnakkainen	parallelo
toimia	operare
setelit	fatture
vakaa	stabile
määritelmät	definizioni
von	von
lääkärit	medici
oppitunti	lezione
elokuva	cinema
vaalit	elezioni
reaktio	reazione
tyhjä	vuoto
tehostettu	migliorata
oikeutettu	intitolato
vaikea	grave
Tuottaa	creare
sanomalehdet	giornali
sairaalat	ospedali
vi	VI
huumori	umorismo
ikäinen	anziano
näytöt	monitor
poikkeus	eccezione
kesto	durata
pääosa	massa
käyntiä	visite
kyvyt	capacità
suositus	raccomandazione
synti	peccato
järjestetty	organizzato
ba	ba
kappale	parà
hyväksyminen	adozione
parantaminen	miglioramento
kallis	costoso
puhveli	bufalo
organisaatioiden	organizzazioni
kone	aereo
ohjelmat	programmi
mekanismi	meccanismo
ee	EE
merkitty	segnato
ajettu	guidato
pullo	bottiglia
innovatiivinen	innovativo
hieronta	massaggio
johtopäätös	conclusione
sulkeminen	chiusura
tuhat	mille
legenda	leggenda
huvila	villa
luu	osso
pylväät	colonne
häiriöt	disturbi
yhteistyö	collaborazione
havaitseminen	rivelazione
sisäinen	interno
muodostus	formazione
med	med
insinöörien	ingegneri
kokonaisuus	entità
risteilyt	crociere
portti	cancello
roomalainen	romano
tehtävät	doveri
eroottinen	erotico
sävy	tono
etiikka	etica
lohikäärme	Drago
kiireinen	occupato
kapteeni	Capitano
tuo	porta
lämmitys	riscaldamento
jalka	gamba
niska	collo
siipi	ala
skriptejä	script
ABC	abc
nimitetty	designato
tekemisissä	rapporti
sitoutumaan	commettere
kisko	rotaia
matkat	viaggi
aukko	divario
sivut	lati
putki	tubo
vastaava	corrispondente
kuvaukset	descrizioni
vyö	cintura
takki	giacca
animaatio	animazione
oraakkeli	oracolo
er	er
tuotannot	produzioni
ilmailu	aviazione
ylpeä	orgoglioso
katastrofi	disastro
konsoli	consolle
komennot	comandi
jr	jr
tietoliikenne	telecomunicazioni
ohjaaja	istruttore
jättiläinen	gigante
saavutettu	raggiunto
vammat	lesioni
lähestymistavat	approcci
tavallinen	solito
postimerkkejä	francobolli
kulma	angolo
ryöstää	rapinare
suunnittelijat	progettisti
vapaus	libertà
aikakausi	era
muuntaa	convertire
mahdollisuus	possibilità
analyytikko	analista
vaarallinen	pericoloso
luotettavuus	affidabilità
vastaavasti	rispettivamente
vapaaehtoiset	volontari
johdettu	derivato
ilo	piacere
kunnia	onore
suuntautunut	orientata
kotka	aquila
rukous	preghiera
työpajat	workshop
Hurrikaani	uragano
hiljainen	silenzioso
tuottaja	produttore
edustettuina	rappresentato
vastuut	responsabilità
juusto	formaggio
huolellisesti	accuratamente
tuottavuus	produttività
kruunu	corona
par	par
diagnoosi	diagnosi
valmistaja	creatore
crack	crepa
periaate	principio
poimii	picconi
jengi	banda
fetissi	feticcio
ulkomuoto	aspetto
savu	Fumo
suodattimet	filtri
yhdistetty	incorporato
alus	mestiere
kaveri	compagno
sokea	cieco
aula	sala
hullu	pazzo
algoritmi	algoritmo
voimakkaasti	fortemente
kahvila	bar
ken	comprensione
proteiineja	proteine
su	su
tuttu	familiare
kykenevä	capace
pääsy	ammissione
kenkä	scarpa
valittiin	eletto
kuljettaa	portando
terrorismi	terrorismo
ilo	gioia
painokset	edizioni
etninen	etnico
eduskunta	parlamento
näyttelijä	attore
löydöt	reperti
tiiviste	foca
tilanteita	situazioni
viides	quinto
kansalainen	cittadino
pystysuora	verticale
korjaukset	correzioni
kuvailee	descrive
vammaiset	disabilità
aine	sostanza
kielletty	proibito
putki	tubo
sotilaat	soldati
holhooja	custode
luento	conferenza
simulointi	simulazione
layout	disposizione
aloitteita	iniziative
sairas	malato
keskittyminen	concentrazione
asettaa	posare
tulkinta	interpretazione
likainen	sporco
opettanut	insegnato
työntekijä	lavoratore
optimointi	ottimizzazione
temppeli	tempio
aineet	sostanze
todistaa	dimostrare
löydetty	scoperto
siivet	Ali
geneettinen	genetico
rajoituksia	restrizioni
ohut	magro
näyttely	esposizione
harjanne	cresta
modeemi	modem
tuoden	portando
sairas	malato
arvioida	valutare
trooppinen	tropicale
kerätä	raccogliere
vektori	vettore
ehdottomasti	decisamente
kääntyminen	svolta
olemassaolo	esistenza
selostus	commento
kehitys	sviluppi
maahanmuutto	immigrazione
kohteet	destinazioni
keskinäinen	reciproco
syntaksi	sintassi
li	Li
ominaisuus	attributo
vankila	prigione
taito	abilità
tuolit	sedie
ympäröivä	circostante
vuoret	montagne
suosio	popolarità
tiedustelu	inchiesta
tarkistettu	verificato
näyttely	mostra
heittää	gettare
trendi	tendenza
kissat	gatti
aavikko	deserto
ya	ya
koordinaattori	coordinatore
elohopea	mercurio
palaa	ardente
paeta	fuga
vastaanotin	ricevitore
etenevä	progressivo
veneet	Barche
mestaruus	campionato
arkadi	portico
mahdoton	impossibile
kertoo	dice
ilmeinen	evidente
masennus	depressione
kaavio	grafico
päällyste	copertura
platina	platino
tuomio	giudizio
neuvottelut	trattativa
arkistointi	limatura
edistää	adottivo
palkittiin	premiato
tutkimuksissa	prove
Masters	maestri
patruuna	cartuccia
selitys	spiegazione
Org	org
petos	frode
sähkö	elettricità
spektri	spettro
saapuminen	arrivo
keramiikka	ceramica
painotus	enfasi
mahtava	eccezionale
vahvistettu	confermato
laskee	conta
romahdus	schianto
hissi	sollevamento
inter	Inter
korkeudet	altezza
varjo	ombra
kulu	spese
hanke	avventurarsi
klinikka	clinica
paranemista	guarigione
prinsessa	Principessa
kirjoittamalla	entrare
paketti	pacchetto
studiot	studios
osallistuminen	coinvolgimento
isä	papà
painikkeet	pulsanti
sijoitus	posizionamento
havainnot	osservazioni
voittajat	vincitori
tiet	strade
myöhempi	successivo
piha	cortile
julkistaminen	rivelazione
perustaminen	istituzione
muistoja	ricordi
te	TE
luo	crea
kasvoja	facce
turisti	turista
murhata	omicidio
riittävä	adeguato
senaattori	senatore
esitykset	presentazioni
sulattaa	digerire
pöly	polvere
wiki	wiki
vaihdettu	sostituito
tutka	radar
tappiot	perdite
taistelu	combattere
vähentäminen	riducendo
pysäytetty	fermato
ammatti	occupazione
tarkasti	strettamente
säteily	radiazione
kuninkaat	re
ammunta	tiro
korva	orecchio
liput	bandiere
leipuri	panettiere
konservatiivinen	prudente
järkyttää	shock
tehokkuuden	efficacia
solmio	cravatta
katto	tetto
osoittaa	dimostrare
ilmapiiri	atmosfera
suudella	bacio
peto	bestia
ra	RA
toimi	operato
koe	sperimentare
tavoitteet	obiettivi
ostot	acquisti
liittovaltio	federazione
pizza	Pizza
kutsuttu	invitato
toimeksianto	assegnazione
mod	mod
kyselyt	interrogazioni
poissaolo	assenza
myyjät	fornitori
jooga	yoga
palvelee	servi
yllätys	sorpresa
lamppu	lampada
vitsit	scherzi
neuvonta	consulenza
palatsi	palazzo
vakuuttunut	soddisfatto
voittoa	vittorie
varasto	magazzino
oletettu	ipotetico
tavallinen	ordinario
aave	fantasma
rikkominen	violazione
pomo	capo
ylpeys	orgoglio
odotukset	aspettative
itsenäisyys	indipendenza
tietäen	sapendo
reportteri	reporter
aineenvaihdunta	metabolismo
mestari	campione
henkilökohtaisesti	personalmente
paljon	abbondanza
soolo	assolo
kurkku	gola
rikkaus	ricchezza
tyhjiö	vuoto
tanssi	danza
tunnistaa	riconoscere
kirjoittaa	scrive
aukio	plaza
etsintä	ricerca
julkaista	pubblicare
seulonta	selezione
trans	trans
pioneeri	pioniere
unohdettu	dimenticato
akrobaatti	acrobata
levyt	piatti
esseitä	saggi
käytös	comportamento
kertominen	raccontare
melko	abbastanza
älykäs	intelligente
tilat	modalità
vaatimus	obbligo
satama	porto
matkustaja	viaggiatore
segmentti	segmento
vihollinen	nemico
palapeli	puzzle
kaivot	pozzi
rajoitettu	limitato
tasavaltalainen	repubblicano
salaisuudet	segreti
oireyhtymä	sindrome
läsnäolo	partecipazione
rangaistus	pena
rumpu	tamburo
mahdollistaa	Abilita
rakentaja	costruttore
näköala	vista
tulva	alluvione
helppous	alleviare
argumentit	argomenti
areena	arena
seikkailuja	avventure
oppilaat	allievi
ilmoitus	annuncio
tulokset	risultato
arvostaa	apprezzare
laajennettu	allargato
täysikasvuinen	cresciuto
ihana	bello
keskuksissa	centri
lauseke	clausola
hymy	Sorriso
maat	terre
joukot	truppe
aseistettu	armato
mänty	pino
jäähdytys	raffreddamento
kuilu	golfo
autot	camion
mekanismit	meccanismi
avioero	divorzio
perinne	tradizione
pillereitä	pillole
tiikeri	tigre
ihmiset	gente
sensori	sensore
avoin	esposto
metsästää	caccia
enkelit	angeli
sijainen	vice
thaimaalainen	tailandese
päästöt	emissioni
lääkärit	medici
valitus	denuncia
kohtaukset	scene
kokeiluja	esperimenti
edistää	Incremento
hallintotavan	governo
mylly	mulino
perustettu	fondato
krooninen	cronico
den	tana
sormi	dito
pitää	mantiene
punta	libbra
paikantaa	individuare
pl	pl
koulutettu	allenato
toteuttamisessa	attuazione
leipä	pane
moottorit	motori
kova	difficile
tapaus	incidente
dynamiikka	dinamica
valehdella	menzogna
keskustelu	conversazione
pienentää	diminuire
palvonta	culto
valmiudet	capacità
ak	ak
tarkkuus	precisione
vahingonkorvaus	danni
varaukset	riserve
ratkaista	risolvere
vähemmistö	minoranza
monipuolinen	diverso
ainekset	ingredienti
Ah	ah
sävyt	toni
kuntoutus	reinserimento
näky	vista
savi	argilla
heikko	debole
jaettu	diviso
vastaanotto	ricezione
viisas	saggio
todennäköisyys	probabilità
seminaarit	seminari
seuraukset	conseguenze
päättäjille	maker
maantiede	geografia
eheys	integrità
perintö	eredità
tyytyväinen	contento
vaara	Pericolo
vitamiini	vitamina
jalostettu	trasformati
fraasi	frase
nostaminen	raccolta
vaikutukset	implicazioni
toiminnallisuus	funzionalità
paratiisi	Paradiso
hybridi	ibrido
lukee	legge
tunteellinen	emotivo
kunnia	gloria
ja	ja
maantieteellinen	geografico
ylittää	superare
sauva	asta
silkki	seta
vauvat	bambini
bi	bi
romanttinen	romantico
paljastui	rivelato
asiantuntijat	specialisti
generaattori	Generatore
jousitus	sospensione
surullinen	triste
korjaus	correzione
susi	lupo
hitaasti	lentamente
täydentää	supplemento
osat	porzioni
pikkulasten	infantile
aloilla	settori
neste	fluido
perusteet	motivo
ateria	pasto
ta	ta
koneet	macchinario
yhtälö	equazione
korit	cesti
todennäköisyys	probabilità
ulottuvuus	dimensione
tutkittu	studiato
voitot	profitti
paholainen	diavolo
ruoho	erba
kuvitettu	illustrato
kirsikka	ciliegia
mannermainen	continentale
saavutus	realizzazione
rajoituksia	limitazioni
hautajaiset	funerale
luvuissa	capitoli
matkustaja	passeggeri
mukava	conveniente
Mars	Marte
kokoinen	dimensioni
muna	uovo
signaalit	segnali
suuntautuminen	orientamento
varkaus	furto
lapsuus	infanzia
symbolit	simboli
lat	lat
meta	meta
analoginen	analogico
lahjakkuus	talento
päivätty	datato
viisaus	saggezza
raja	confine
eliitti	elite
gi	gi
uskoo	crede
runoja	poesie
toimivalta	Giurisdizione
robotti	robot
näyttämällä	visualizzazione
todistaja	testimone
varustettu	fornito
vaiheet	stadi
sur	sur
hankittu	acquisita
arvioida	valutare
pestä	lavaggio
Sisäänkäynti	Ingresso
ilmoitus	dichiarazione
menettää	perdere
yrityksiä	tentativi
jalo	nobile
automaatio	automazione
vaikutukset	impatti
kierros	rev
edut	vantaggi
ritari	cavaliere
tavoitteet	obiettivi
laajennukset	estensioni
valitukset	appelli
sairaus	malattia
ho	Ho
vaihtoehtoja	alternative
sh	sh
saippua	sapone
hillo	marmellata
epätavallinen	insolito
vastasi	risponde
tuho	distruzione
muutto	migrazione
häiriö	disturbo
tavanomainen	convenzionale
yllään	indossare
akseli	asse
pyrittiin	ricercato
geenit	geni
mediaani	mediano
skanneri	scanner
tässä	qui
eloisa	animato
säätö	registrazione
sankari	eroe
hoidot	trattamenti
asenne	atteggiamento
matto	tappeto
linssit	lenti
osallistui	frequentato
vaikeus	difficoltà
punk	punk
koalitio	coalizione
rekisteröinti	iscrizione
herttua	duca
vauhti	ritmo
tuottajia	produttori
kaari	arco
rajapinnat	interfacce
kartasto	atlante
havainto	osservazione
kiduttaa	tortura
Poistetaan	cancellato
takki	cappotto
entisöinti	restauro
sopivuus	convenienza
palaavat	ritorno
oppositio	opposizione
kontti	contenitore
vastaaja	imputato
valvoja	supervisore
joukot	corpo
toimijoiden	attori
maksa	fegato
velvollinen	responsabile
adressi	petizione
antenni	antenna
poimitaan	raccolto
uskomus	credenza
tappaminen	uccisione
olkapää	spalla
sisustus	arredamento
ioni	ione
halkaisija	diametro
podcast	Podcast
vuorovaikutukset	interazioni
laulaja	cantante
airut	araldo
vanheneminen	invecchiamento
interventio	intervento
kytkeä	collegare
vetovoima	attrazione
sukellus	immersione
muutos	modifica
olettaa	supporre
ruoko	canna
sisältää	coinvolgere
kohtalainen	moderare
hiiret	topi
ymmärsi	inteso
nopeasti	rapidamente
kieltää	bandire
varmuus	garanzia
happening	avvenimento
valtava	vasto
myllyt	mulini
ääriviivat	contorno
vastaanottaa	riceve
farkut	jeans
kokoelma	compilazione
outo	dispari
sigma	sigma
gr	gr
viehättävä	attraente
tilaisuus	occasione
tallenteet	registrazioni
uhri	vittima
vaatii	richieste
varovainen	attento
palkki	fascio
puutarhanhoito	giardinaggio
velvoitteet	obblighi
saapua	arrivo
orkesteri	orchestra
lisenssi	licenza
säädettävä	regolabile
jako	assegnazione
essee	tema
osoittivat	dimostrato
vuoropuhelu	dialogo
leirit	campi
julistettu	dichiarato
jäljittää	traccia
sulkea	chiuso
pakkauksissa	confezioni
ge	ge
asennus	installazione
kytkimet	interruttori
vapaaehtoinen	volontario
sinä	tu
suuresti	molto
ng	ng
yleisesti	comunemente
pe	pe
valokuvaaja	fotografo
itkeä	piangere
kvantti	quantistico
rakennettava	costruito
lisäykset	aggiunte
edellyttävät	richiedendo
nuoli	freccia
sitoumus	Fidanzamento
karkea	ruvido
outo	strano
leijona	Leone
häät	matrimoni
happi	ossigeno
kanjoni	canyon
metriä	metri
vain	semplicemente
kalenterit	calendari
järjestely	preparativi
päätelmät	conclusioni
bibliografia	bibliografia
osoitin	pointer
yhteensopivuus	Compatibilità
venyttää	allungare
luvat	permessi
osuuskunta	cooperativa
ruokinta	alimentazione
kauppala	municipalità
rankingissa	classifiche
mittaus	misurazione
hihna	cinghia
väkijoukko	folla
siirrot	trasferimenti
olympia	olimpico
muutos	trasformazione
dir	dir
tulli	dogana
ylläpitäjät	amministratori
persoonallisuus	personalità
koukku	gancio
ruletti	roulette
aleneminen	declino
johto	cordone
pilvi	nube
helpottaa	facilitare
Val	val
selittää	spiega
edetä	procedere
tunteet	sentimenti
veitsi	coltello
hyväksyä	adottare
evätty	negato
lahjoitus	donazione
ulompi	esterno
sato	raccolto
joet	fiumi
solmut	nodi
mainittu	citato
napa	mozzo
kohdennettu	mirata
tajusi	realizzato
perustaja	fondatore
vuosikymmen	decennio
riita	controversia
väsynyt	stanco
haitallinen	avverso
ote	estratto
purkaa	scarico
juomat	bevande
ässä	asso
äänet	voci
kiipeily	arrampicata
tonnia	tonnellate
hajuvesi	profumo
vaarallinen	pericoloso
palauttaa	ristabilire
pino	pila
metodologia	metodologia
maine	reputazione
demokraatteja	democratici
ripustaa	appendere
käyrä	curva
luoja	Creatore
keltainen	ambra
museot	musei
koodaus	codifica
seuraaja	inseguitore
vaihtelu	variazione
kulku	passaggio
siirretty	trasferito
runko	tronco
valokuva	fotografia
aallot	onde
kameli	cammello
jakelija	distributore
chi	chi
keräys	raduno
projektio	proiezione
matemaattinen	matematico
looginen	logico
kastike	salsa
kuuluisuus	fama
erikoistunut	specializzato
yritykset	aziende
kritiikki	critica
auto	automobile
tuomarit	giudici
huomautukset	osservazioni
havaittu	rilevato
maalaukset	dipinti
käveli	camminava
aiheutuvat	derivante
populaatiot	popolazioni
peloissaan	impaurito
akustinen	acustico
kasetti	cassetta
indikaattori	indicatore
jpg	jpg
virhe	sbaglio
poistaa	eliminare
mineraali	minerale
rubiini	rubino
helmet	perline
onni	fortuna
kangas	tela
kynnys	soglia
seurakunta	parrocchia
näytöt	schermi
hautausmaa	cimitero
stadion	stadio
tutkiminen	esplorazione
min	min
varsi	stelo
tähtitiede	astronomia
kilpailut	concorsi
flunssa	influenza
puku	costume
polkupyörää	Bici
piispa	vescovo
veti	tirato
maissi	Mais
puristus	compressione
perustamisesta	stabilire
viljelijä	contadino
tina	lattina
orja	schiavo
heti	immediatamente
valmennus	istruire
tutkitaan	esaminato
koodaus	codifica
huomautukset	osservazioni
sankareita	eroi
maalannut	dipinto
muotokuva	ritratto
terroristi	terrorista
eettinen	etico
harjoittajat	vettori
liikkuvuus	mobilità
taistelu	lotta
järjestelmiä	schemi
kärsimys	sofferenza
neutraali	neutro
kalastaja	pescatore
rotta	ratto
keihäitä	lance
tuloaan	accoppiamento
otsikko	intestazione
keinotekoinen	artificiale
laakeri	cuscinetto
mahtava	spettacolare
maailmoja	mondi
syyllinen	colpevole
aktivointi	Attivazione
satama	porto
tabletti	tavoletta
tuomaristo	giuria
dos	dos
pyrstö	coda
viehätys	fascino
väkivaltainen	violento
mahdollisesti	potenzialmente
karjatila	ranch
rajoitteet	vincoli
ylitys	attraversamento
täydellinen	inclusivo
mökki	Cottage
humalassa	ubriaco
huomattava	considerevole
rikokset	crimini
ratkaistu	risoluto
tavu	byte
nenä	naso
oksat	rami
ulkomaalainen	alieno
prosessorit	processori
mursi	rotto
monimutkaisuus	complessità
alituisesti	costantemente
ratkaista	risolvere
alueiden	territori
tutkielma	tesi
levyt	dischi
tiheä	frequente
katto	soffitto
pikseliä	pixel
gen	gen
ruutu	quadri
laivasto	flotta
kimppu	mazzo
teoreettinen	teorico
lähete	rinvio
lopettaa	smettere
protokollat	protocolli
keuhko	polmone
korvike	sostituire
loistava	brillante
ti	ti
geeli	gel
puhuttu	verbale
omega	omega
arvioitu	valutato
jäi	rimasto
näkee	vede
päättyminen	fine
katsoi	guardato
kotitalouksien	famiglie
lunastaa	riscattare
jyvä	grano
järjestelmä	regime
sonni	Toro
arkkitehtoninen	architettonico
erota	differire
liikkeet	movimenti
korjaus	riparazione
hengitys	respiro
palveluihin	servizi
käytännössä	potenzialmente
kauppapaikka	mercato
kynttilä	candela
riippuva	sospeso
värillinen	colorato
tarina	racconto
ennen	precedentemente
projektori	proiettore
sijaitseva	situato
etsii	cerca
tiukasti	rigorosamente
psykologinen	psicologico
vitamiinit	vitamine
tyylikäs	elegante
voitto	utile
uusiminen	rinnovo
sukututkimus	genealogia
katsotaan	ritenuto
pisteytys	punteggio
menot	spesa
kriitikot	critica
algoritmit	algoritmi
hakkeri	pirata
salonki	salone
turbo	turbo
parantaa	cura
ni	ni
ajattelee	pensa
ehdotus	suggerimento
sotilas	soldato
pommi	bomba
vahingoittaa	danno
aikaväli	intervallo
peilit	specchi
tutkia	indagare
sinun	tuo
paneelit	pannelli
toistettu	ripetuto
hyökkäys	assalto
Peura	cervo
kieli	lingua
keilailu	bowling
tri	tri
apina	scimmia
osa	proporzione
hame	gonna
analyysit	analisi
piirustukset	disegni
merkitys	significato
skenaario	scenario
te	voi
arabialainen	Arabo
arvioida	valutare
suojaava	proteggere
kohtasi	affrontato
ratkaiseminen	soluzione
tuottaa	produce
intensiivinen	intensivo
kahleet	Catene
kuudes	sesto
sitoutua	impegnare
kytkentä	commutazione
kirjeenvaihto	corrispondenza
tuonti	importazioni
valvonta	supervisione
menot	spese
erottaminen	separazione
todistus	testimonianza
epäilty	sospettare
pakollinen	obbligatorio
rajoja	confini
juhla	celebrazione
suodatus	filtraggio
puoliso	Sposa
eksoottinen	esotico
katsoja	spettatore
päästäisiin	raggiungendo
nauraa	ridere
kirurginen	chirurgico
tuhota	distruggere
lainaus	citazione
yo	yo
tilat	premesse
osoittautui	dimostrato
hyökkäys	offensivo
keisarillinen	imperiale
tusina	dozzina
käyttöönotto	distribuzione
kangas	stoffa
lootus	loto
lohi	salmone
lasti	carico
direktiivi	direttiva
perämies	compagno
voi	burro
pippuri	Pepe
ase	arma
taakka	fardello
nauhat	nastri
vyöhykkeet	zone
saari	isola
hoikka	sottile
vaahtera	acero
ruokakauppa	drogheria
hallitseva	governo
varikko	deposito
alt	alt
piirakka	torta
sekoitus	miscela
päästö	emissione
näennäinen	apparente
neuvonta	didattico
käyttöoikeudet	permessi
WC	gabinetto
sijoittui	classificato
reitit	itinerari
asennus	montaggio
sidottu	legato
tasapainoinen	equilibrato
myöhässä	ritardato
laakso	vallata
laskeminen	calcolo
huvilat	ville
Tilaisuudet	occasioni
yhtälöt	equazioni
öljyt	oli
syyskuu	settembre
poikkeuksellinen	eccezionale
levottomuus	ansia
tila	spaziale
vastaajat	intervistati
näkökohdat	considerazioni
maksaa	paga
aurinkoinen	soleggiato
toimittaa	fornisce
je	je
kaulakoru	collana
yhdistelmä	composito
lang	Lang
teatterit	teatri
suunnittelu	progettazione
toivoo	speranze
arvioinnit	valutazioni
kaavio	diagramma
jalkineet	calzature
SG	sg
kansojen	popoli
voittaja	vincitore
lisenssejä	licenze
vaihtelee	intervalli
paria	coppie
herkkyys	sensibilità
säilytys	conservazione
yksittäinen	isolato
väliaikainen	provvisorio
avustaa	assistito
jumalallinen	divine
hyväksyä	approvare
yhdiste	composto
intensiteetti	intensità
teknologinen	tecnologico
abortti	aborto
dialogi	dialogo
tapahtumapaikat	sedi
räjähdys	esplosione
käsitellään	indirizzamento
napa	polo
kilpi	scudo
kalvo	membrana
epätoivoinen	disperato
äidit	madri
esittely	dimostrazione
valtiosta	governo
valmistettu	manufatto
kynttilät	candele
muunnelmat	variazioni
äidit	mamme
pyhä	sacro
riippuvuus	dipendenza
kromi	cromo
kieltäytyi	rifiutato
jarru	freno
ulkopuoli	esterno
tervehdys	saluto
ekologia	ecologia
laakso	valletta
työttömyys	disoccupazione
sijoitettiin	segnato
lisälaite	aumento
klooni	clone
nopeus	velocità
lambda	lambda
kokoonpanossa	composto
kyyneleet	lacrime
keidas	oasi
ohjaamo	taxi
fa	fa
yhteiskunnissa	società
pii	silicio
identtinen	identico
maaöljy	petrolio
kilpailla	competere
ist	ist
rakastaja	amante
kuulua	appartenere
huulet	labbra
saattaja	scorta
lampi	stagno
lautta	traghetto
kani	coniglio
ammatti	professione
pato	diga
fysiologia	fisiologia
vientiä	esportazioni
Rengas	pneumatico
osallistuja	partecipante
elektroni	elettrone
kuormat	carichi
kanerva	erica
motelli	motel
ammattiliitot	sindacati
valtiovarainministeriö	tesoreria
miehitetty	occupato
asteikot	bilancia
rasitus	sforzo
pidätetty	arrestato
tutkimuksia	indagini
sai	guadagnato
pesula	lavanderia
saattamisesta	collocazione
säätää	regolare
arvioitu	valutato
salaus	crittografia
täyte	Riempimento
määrätty	imposto
hiljaisuus	silenzio
Neuvostoliiton	sovietico
hallinta	possesso
sopimus	trattato
kouluttaja	allenatore
urut	organo
sitruuna	Limone
pimeys	buio
jänneväli	campata
vitsi	scherzo
pakkaus	Imballaggio
säädös	statuto
hylätty	respinto
suoja	riparo
kappeli	cappella
valmistus	produzione
kerroksia	strati
juhlia	celebrare
laite	apparecchio
seos	miscela
ratsastaja	ciclista
säde	raggio
vaikuttava	impressionante
lammas	pecora
arkkitehti	architetto
luennot	lezioni
viinit	vini
kupit	tazze
tuhka	cenere
avustajat	contributori
salaatti	insalata
rikkomuksia	violazioni
lämpötilat	temperature
kilpailut	concorsi
säilyttää	conserva
runo	poesia
pysyminen	stare
pääsiäinen	Pasqua
teoriat	teorie
säilytyspaikka	deposito
virtoja	flussi
lasku	atterraggio
teloitettiin	eseguito
neuvottelut	negoziati
realistinen	realistico
kysyy	chiede
tiivistelmä	sinossi
säveltäjä	compositore
papu	fagiolo
miekka	spada
muutoksia	modifiche
koralli	corallo
pikselin	pixel
polut	percorsi
kupla	bolla
por	por
hankkia	acquisire
päinvastainen	contrario
Tribune	tribuna
alus	nave
hapot	acidi
virukset	virus
tarroja	adesivi
reaktiot	reazioni
uskomukset	credenze
ryhmä	squadra
analysoida	analizzare
alueet	divisioni
uida	nuotare
nano	nano
konsertit	concerti
urokset	maschi
säilyttää	conservare
värit	colori
suorittaa	eseguire
tunneli	tunnel
tyylilajit	generi
patentit	brevetti
vehnä	Grano
aikakirjat	Cronache
saada	ottenendo
majava	castoro
lukemat	letture
laajennus	allargamento
Eagles	Aquile
emäkset	basi
syytetty	accusato
kampanjat	campagne
yhtenäisyys	unità
määritellään	definisce
tapauksissa	casi
kotoperäinen	indigeno
alkaneet	iniziato
paketit	pacchetti
ankkuri	ancora
sukat	calzini
laukaista	grilletto
kolesteroli	colesterolo
ero	differenziale
pinnat	superfici
kauhea	terribile
reitittimet	router
kellot	orologi
niveltulehdus	artrite
BIOS	bios
naaraat	femmine
heijastaa	riflette
verotus	tassazione
kuume	febbre
keittiö	cucina
varmasti	certamente
harjoittajat	professionisti
lause	teorema
inflaatio	inflazione
sinua	ti
yhdisteet	composti
rummut	batteria
kohtuullisen	ragionevolmente
paljas	spoglio
radikaali	radicale
suosittelee	raccomanda
valvontaan	controllo
aarre	Tesoro
liekki	fiamma
kuoppa	fossa
mono	mono
hiukkasia	particelle
kelluva	galleggiante
koordinoida	coordinata
yksinomaan	esclusivamente
rajoitus	limitazione
iski	colpito
kuva	illustrazione
varoitukset	avvertenze
rakentaa	costruire
sovellukset	applicazioni
kyselyt	indagini
liite	annesso
inspiraatio	ispirazione
rahti	nolo
pimennys	eclisse
vaikuttaa	colpisce
ennusteet	previsioni
havaita	individuare
aktiivisesti	attivamente
monimutkainen	complicato
loukkaantunut	ferito
ilmauksia	espressioni
tonni	tonnellata
kuriiri	Corriere
vihjeitä	suggerimenti
gif	gif
konfliktit	conflitti
juoma	bevanda
kunnianosoitus	omaggio
immuuni	immune
metsänhoito	silvicoltura
rajat	barriere
kallistus	gergo
harvoin	raramente
tarjoukset	offerte
este	barriera
polkupyörä	bicicletta
kalusteet	arredamento
nousta	sorgere
kelttiläinen	celtico
hiukkanen	particella
kosteus	umidità
pullot	bottiglie
dm	dm
renessanssi	Rinascimento
määräys	decreto
valokuvaajat	fotografi
infektiot	infezioni
shakki	scacchi
toimii	opera
festivaalit	festival
mahdollisuuksia	possibilità
Ankka	anatra
kanava	canale
myötävaikuttaa	contribuendo
lehmä	mucca
analyyttinen	analitico
puvut	costumi
tiukka	rigoroso
verenkierto	circolazione
rikkomus	offesa
olettamus	assunzione
harraste	passatempo
yrittää	cerca
keksintö	invenzione
teknikko	tecnico
johtajat	dirigenti
kyselyt	indagini
kognitiivinen	conoscitivo
tutkia	esplorando
temppu	trucco
tiedustelu	inchiesta
päättäminen	chiusura
puutavara	legname
voltti	volt
voimakas	intenso
kannattajat	sostenitori
säädökset	statuti
kirjoilla	iscritto
anturit	sensori
ruuvi	vite
ministerit	ministri
julkisesti	pubblicamente
kärsi	subito
otto	presa
perhonen	farfalla
mekaniikka	meccanica
otsikot	intestazioni
virheitä	errori
numeerinen	numerico
määrittelemällä	definizione
laskenta	conteggio
heijastus	riflessione
kutsu	invito
natrium	sodio
hormoni	ormone
lasten	bambini
tiili	mattone
pito	presa
keskiaikainen	medievale
posliini	porcellana
kaapattu	catturato
kunnollinen	decente
valu	getto
käännetty	tradotto
donna	donna
soturi	guerriero
hytti	cabina
skannaus	lettura
poolo	polo
kopiointi	copiatura
sarvi	corno
journalismi	giornalismo
sammakko	rana
kielioppi	grammatica
tarkoitus	Intenzione
renkaat	pneumatici
toteutetut	intrapreso
vaara	rischio
jaksot	Episodi
pyöreä	circolare
suututtaa	rabbia
kuvitukset	illustrazioni
mahdollisuudet	possibilità
onnellisuus	felicità
outo	bizzarro
Ur	ur
hedelmät	frutta
tunnisteen	identificatore
nauha	nastro
laskelmat	calcoli
jpeg	jpeg
aloittaa	avviare
kätevä	maneggevole
vaihtaa	scambiare
vapauttaa	esonerare
viljelykasvien	colture
vähentää	riduce
aikaan	compiuto
geometria	geometria
vaikutus	impressione
kilta	gilda
korrelaatio	correlazione
sim	sim
hermostunut	nervoso
tuoksu	fragranza
kopio	replica
heimo	tribù
kaupat	compravendite
loistava	superbo
eroon	liberare
kolminaisuus	Trinità
käsiteltävä	maneggiato
legendoja	leggende
puomi	boom
rauhoittaa	calma
Mestarien	campioni
lattiat	piani
valinnat	Selezioni
verrataan	confrontando
puhuu	parla
ammatillinen	professionale
apteekit	farmacie
ln	ln
rulla	rullo
erä	partita
järjestää	organizzare
Ymmärretään	gradito
muuttaa	alterare
reunat	bordi
sekoittaminen	miscelazione
kahvat	maniglie
harmonia	armonia
hienostunut	distinto
astma	asma
oletukset	assunzioni
säännelty	regolata
kolmio	triangolo
muuttaa	emendare
ennakoitua	anticipato
itämainen	orientale
palkinto	ricompensa
vety	idrogeno
vertailukelpoinen	comparabile
puolestapuhuja	avvocato
sekaannus	confusione
tulot	ingressi
takuut	garanzie
perimä	genoma
mitali	medaglia
valmentajat	allenatori
alukset	vasi
satama	porto
Eco	eco
haavoittuva	vulnerabile
järjestää	organizzare
taiteellinen	artistico
kunnianosoitukset	onori
heijastunut	riflessa
yhdistynyt	unificato
rotu	razza
ilmaisin	rivelatore
huomiotta	ignorato
täsmällinen	preciso
arviointiin	valutare
huuli	labbro
kerätä	raccogliere
muodostaen	formatura
toimittajat	giornalisti
hienoinen	leggero
epäsuora	indiretto
keskuudessa	tra
perustukset	fondazioni
horisontti	orizzonte
nu	nu
syvään	profondamente
velat	passivo
palkinnot	premi
vähentynyt	diminuita
kuvaava	descrivendo
optiikka	ottica
jatkaa	perseguire
salama	fulmine
ou	ou
lainaukset	citazioni
tarkastaja	ispettore
käärme	serpente
muistutus	promemoria
etsinyt	cercato
Plains	pianure
oivalluksia	approfondimenti
kyvyt	abilità
aloitettu	avviato
karaoke	karaoke
ansa	trappola
yksinäinen	solitario
ve	ve
tarkkailla	osservare
kontit	contenitori
asenteet	atteggiamenti
marja	bacca
kaulus	collare
yhdistää	integrare
sosiologia	sociologia
näytteille	mostre
kuolee	muore
terassi	terrazza
bakteerit	batteri
pitäisi	dovere
herkullinen	delizioso
perinteet	tradizioni
rajallinen	finito
lähettää	invia
kestävä	durevole
liittoutunut	alleato
kosteus	umidità
muuttaa	trasformare
ajastin	Timer
tabletit	compresse
saatu	ottenuto
kasvattajat	educatori
vihannes	verdura
jae	versetto
itsenäisesti	indipendentemente
kilpailijat	concorrenti
raketti	razzo
kyllä	sì
luoti	proiettile
tornit	torri
näkyvyys	visibilità
leveysaste	latitudine
tajunta	coscienza
kasvain	tumore
ruma	brutta
talletukset	depositi
emäntä	padrona
kohdata	incontrare
wattia	watt
neljäkymmentä	quaranta
putket	tubi
yritettiin	tentata
pappi	sacerdote
analyytikot	analisti
vasara	martello
invaasio	invasione
juoksija	corridore
riviä	righe
annettuna	somministrati
käsite	nozione
oikeinkirjoitus	ortografia
arktinen	artico
palkintoja	ricompense
alla	sotto
vahvistaa	rafforzare
puolustaa	difendere
infrapuna	infrarosso
seitsemäs	settimo
vatsa	pancia
aggressiivinen	aggressivo
mainoksia	annunci
neljäsosaa	alloggio
varastettu	rubare
määrittää	determina
veistos	scultura
poly	poli
korvat	orecchie
nyrkki	pugno
neo	neo
motivaatio	motivazione
matkustajien	viaggiatori
johdonmukaisesti	costantemente
ylijäämä	surplus
kaivaa	scavare
Taksi	Taxi
arvostus	apprezzamento
om	om
rajoitus	restrizione
kitarat	chitarre
olemus	essenza
mahtava	potente
ihmiskunta	umanità
transkriptio	trascrizione
komplikaatioita	complicazioni
tutkijat	studiosi
galaksi	galassia
huolehtiva	cura
testamentti	testamento
hallitseva	dominante
vatsa	stomaco
osittain	parzialmente
minimoida	minimizzare
rivit	ranghi
debyytti	debutto
sukupolvet	generazioni
turnaukset	tornei
kieltää	negare
anatomia	anatomia
kuulokkeet	cuffie
jae	frazione
trio	trio
menettely	procedere
kuutio	cubo
vikoja	difetti
epävarmuus	incertezza
hajota	abbattersi
ratkaistu	sistemato
rokote	vaccino
kohtalo	destino
varaukset	prenotazioni
republikaanit	repubblicani
viidakko	giungla
zen	zen
dIS	dis
ennustus	predizione
ekologinen	ecologico
soikea	ovale
viittaa	implica
ser	ser
arviointi	valutazione
näkymä	prospettiva
maantieteellinen	geografico
luovuttaja	donatore
jännitys	tensione
roska	spazzatura
muodot	forme
porras	fila
jaarli	conte
kotimaa	patria
mestaruutta	campionati
rodut	razze
disko	discoteca
aus	aus
viimeistely	finitura
tunteet	emozioni
ikuinen	eterno
kierto	rotazione
nam	nam
tuottava	produttivo
bulevardi	viale
sika	maiale
metrinen	metrico
seuraamukset	sanzioni
monipuolinen	vario
grande	Grande
näyttelijä	attrice
luovuttaa	assegnare
majoittaa	ospitare
Tiikerit	tigri
kyliä	villaggi
sävy	ombra
kertosäe	coro
rytmi	ritmo
numero	cifra
sinfonia	sinfonia
äkillinen	improvviso
hyväksymisestä	accettando
altaat	piscine
lyyrinen	lirica
eristäminen	isolamento
nopeudet	velocità
jatkuva	sostenuta
Hyväksytty	abbinato
lähentää	approssimativo
köysi	corda
järkevä	razionale
ohjelmoija	programmatore
taistelijat	combattenti
peritty	ereditato
epätäydellinen	incompleto
laulu	vocals
suihkulähde	Fontana
laillinen	legittimo
elämäkerrat	biografie
tutkija	investigatore
kantaja	attore
lempeä	dolce
arvokas	degno
arkkitehdit	architetti
pyhimykset	santi
yrittäjä	imprenditore
kuljettaa	trasporta
duo	duo
liiallinen	eccessivo
säästää	salva
pitää	considerato
arvostus	valutazione
odottamaton	inaspettato
sumu	nebbia
luonteenomainen	caratteristica
aula	atrio
hahmoteltu	delineato
valtava	enorme
karma	karma
muodostuvat	consistere
kuningattaret	regine
tutkijoita	accademici
heimot	tribù
ero	distinzione
vaarat	pericoli
vapautus	esenzione
vuokralainen	inquilino
kestävyys	sostenibilità
tatuointi	tatuaggio
algebra	algebra
varjot	ombre
typerä	sciocco
vapaasti	liberamente
lievä	mite
turkis	pelliccia
helposti	prontamente
kuuluminen	affiliazione
aita	recinto
ääretön	infinito
klaani	clan
vallankumouksellinen	rivoluzionario
ranneketta	bracciali
parannuskeino	rimedio
hengittäminen	respirazione
lyhyesti	brevemente
paksuus	spessore
graafinen	grafico
nero	genio
keskustella	discutere
taistelija	combattente
mielekäs	significativo
muokattu	adattato
säädyt	proprietà
matto	tappeto
demokraatti	democratico
kauppala	borgo
ylläpitää	mantiene
ka	ka
säilytetään	mantenuto
marmori	marmo
dem	DEM
meditaatio	meditazione
mikrofoni	microfono
Yhdistämällä	combinando
jättiläiset	giganti
organisointi	organizzazione
muistio	promemoria
kinkku	prosciutto
ratkaistu	risolto
vuorovesi	marea
väliseinä	partizione
näkymätön	invisibile
konsolit	console
magneetti	magnete
käännökset	traduzioni
jaguaari	giaguaro
hyödyke	merce
kilometriä	chilometri
takeita	garanzie
gotiikka	Gotico
sylinteri	cilindro
noita	strega
pukki	secchio
viholliset	nemici
konsultointi	consulenza
nauttii	godendo
partio	pattuglia
haju	odore
karnevaali	carnevale
karkeasti	approssimativamente
tarra	etichetta
lupauksia	promesse
riutta	scogliera
jakaa	dividere
peräkkäinen	consecutivo
Bon	bon
esitykset	rappresentazioni
chan	chan
sävelet	Tunes
mas	mas
lausekkeet	frasi
kai	kai
niemimaa	penisola
tylsää	noioso
dom	dom
puheet	discorsi
saavuttaa	raggiunge
kaavio	schema
luettelot	cataloghi
ministeriöiden	ministeri
parlamentin	parlamentare
etuliite	prefisso
savanni	savana
tynnyri	barile
hermo	nervo
dans	dans
planeetat	pianeti
alijäämä	disavanzo
uudistaa	rinnovare
kytketty	accoppiato
piirit	circuiti
rakenne	struttura
tunnustaa	riconoscere
teltta	tenda
tunnistaa	identifica
pätevyys	qualificazione
lukot	serrature
miniatyyri	miniatura
euroa	euro
merirosvot	pirati
antenni	aereo
haukka	falco
seuraus	conseguenza
systemaattinen	sistematico
koettu	percepito
alkuperä	origini
palkattu	assunti
meikki	trucco
ui	ui
painot	pesi
geologinen	geologica
kestävä	durevole
paha	malvagio
esittelee	introduce
työntää	spinto
ro	ro
rinne	pendenza
runoilija	poeta
salaliitto	cospirazione
teologia	teologia
kynnet	unghie
ilmeinen	evidente
ratsastaa	cavalcate
eeppinen	epico
järjestäjä	organizzatore
allergia	allergia
vuoksi	interesse
yhdistelmät	combinazioni
edeltävä	precedente
ansio	merito
entsyymi	enzima
lentokoneita	aerei
levyt	dischi
vahvistin	amplificatore
mielivaltainen	arbitrario
näkyvä	prominente
sans	sans
rakentaa	costruisce
yhteyttä	contattato
akseli	albero
nojata	magro
satunnainen	occasionale
innovaatiot	innovazioni
tarkistetaan	revisione
paniikki	panico
kansalaisuus	cittadinanza
tekosyy	scusa
uudistuksia	riforme
sipuli	cipolla
voileipä	Sandwich
altto	contralto
hierarkia	gerarchia
hylätty	abbandonato
piireissä	cerchi
lyöntiä	battiti
iloinen	allegro
kultti	culto
kojelauta	trattino
passiivinen	passivo
arvostettu	valutato
häkki	gabbia
rohkeus	coraggio
korkeus	elevazione
kierros	giro
käyttö	utilizzo
juomat	bevande
ping	ping
viihteellinen	divertente
edellytys	necessario
raja	frontiera
pakolaisten	rifugiati
ritarit	cavalieri
hypoteesi	ipotesi
lääkkeet	farmaci
muuttunut	alterato
oppi	dottrina
luonnonkaunis	panoramico
parannuksia	miglioramenti
leikkauspiste	intersezione
ompelu	cucire
keräilijät	collettori
tunnistettu	riconosciuto
raivo	rabbia
prix	prix
astrologia	astrologia
neuvonantajat	consulenti
paviljonki	padiglione
taktiikka	tattica
täydentäviä	supplementare
lahjakas	talentuoso
tyyny	cuscino
leviäminen	diffusione
maakunnat	province
varastaa	rubare
paketti	pacco
esiintyvyys	incidenza
pelot	paure
ennustaa	predire
maku	gusto
nälkäinen	Affamato
metallinen	metallico
häiriö	interferenza
soturit	guerrieri
ilmakehän	atmosferico
sädekehä	alone
vanhempien	parentale
viitattu	riferimento
lakkoja	attacchi
muurahainen	formica
ehdotus	proposizione
osuva	adatto
käsitelty	affrontato
kauppias	commerciante
heitetään	gettato
kriteeri	criterio
kunniamerkki	distintivo
sivistys	civiltà
nummi	brughiera
valtava	enorme
suorittaa	esegue
valtakunta	regno
korjattu	corretto
kypärä	casco
kohdanneet	incontrato
tsunami	tsunami
tutkija	studioso
ympäröimä	circondato
geologia	geologia
oliot	creature
selvitetty	eliminato
suorittaa	realizzare
kulmat	angoli
kasvissyöjä	vegetariano
hiiva	lievito
pas	pas
tutkitaan	indagato
suurlähettiläs	ambasciatore
päällystetty	rivestito
tuho	destino
rutiinit	routine
olentoja	esseri
riippuvuus	dipendenza
myytti	mito
puro	ruscello
fu	fu
ilmiö	fenomeno
kokonaisuus	insieme
varma	assicurato
tajuissaan	consapevole
aksentti	accento
vaimot	mogli
käyttää	utilizzare
pantti	impegno
vampyyri	vampiro
telakka	bacino
järjestetty	organizzato
muusikko	musicista
rajoittamalla	limitativo
palautettu	restaurato
vihje	suggerimento
panssari	armatura
huomautus	osservazione
kymmeniä	dozzine
vaihtelee	varia
perustelut	ragionamento
vartijat	guardie
aukot	aperture
korvaa	sostituzione
tutkija	ricercatore
valtuustot	consigli
Ammatit	occupazioni
tunnustettu	riconosciuto
sianliha	Maiale
zu	zu
tasapaino	equilibrio
putket	tubi
mökit	cottage
yhdistää	fondersi
etuoikeus	privilegio
kehittyy	sviluppa
alusta	telaio
arvio	stima
lato	fienile
halla	brina
laitokset	istituti
muotti	muffa
rouva	dama
jahti	yacht
mieluummin	preferisce
poraus	perforazione
yrtti	erba
rikkominen	violazione
valas	balena
matkustaja	viaggiatore
määrärahat	stanziamenti
epäillään	sospetto
tomaatit	pomodori
ohjaajien	istruttori
vauhti	impulso
evä	pinna
pastori	pastore
muta	fango
smaragdi	Smeraldo
kasvaa	cresce
alue	tratto
ul	ul
baletti	balletto
toimittaja	giornalista
uskonnot	religioni
valkosipuli	aglio
paistaa	brillare
räjähdys	esplosione
alushousut	slip
allekirjoituksia	firme
otsoni	ozono
tieteenalojen	discipline
Casa	Casa
keskustelut	conversazioni
radiot	radio
tulli	tariffa
yksinkertaistettu	semplificato
lihakset	muscoli
nopea	veloce
emätin	vagina
samppanja	Champagne
poikkeama	deviazione
samba	samba
käyttää	impiegare
pingviini	pinguino
maaginen	magico
vaikutteita	influenze
tarkastukset	ispezioni
kastelu	irrigazione
ihme	miracolo
hydraulinen	idraulico
tunkeutuminen	penetrazione
haava	ferita
kaunotar	bella
rosa	rosa
vakaumus	convinzione
laiska	pigro
ominaisuudet	qualità
isät	padri
latauksen	ricarica
merkittävästi	importante
siro	petite
laitteet	apparato
maasto	terreno
selitetään	spiegando
nauhat	strisce
nimitys	nomina
empiirinen	empirico
mato	verme
riippuvuus	dipendenza
erillinen	discreto
aloittelija	principiante
kansi	coperchio
seksuaalisuus	sessualità
safiiri	zaffiro
etuoikeudet	privilegi
erikoistunut	specializzata
merkki	marcatura
seriffi	sceriffo
vähentynyt	diminuito
vakoojia	spie
moottoripyörät	moto
valita	eletto
valtatiet	autostrade
keskittää	concentrarsi
intiimi	intimo
molekyylit	molecole
kierrosta	giri
jääkaappi	frigorifero
väliajoin	intervalli
lauseet	frasi
holokausti	olocausto
lentäjä	aviatore
herneet	piselli
annostus	dosaggio
vaihtelu	varianza
Navigator	navigatore
neula	ago
kylpylä	terme
jarrut	Freni
og	og
tyrmäys	ko
omistaa	possiede
kohtalo	destino
Maisemat	paesaggi
laskeminen	calcolo
heinä	fieno
pelastus	salvezza
ennustukset	predizioni
oppijat	discenti
symbolinen	gettone
sinkki	zinco
uhrata	sacrificio
etsijät	asilo
guru	guru
sopiva	adatto
numeerinen	numerico
antropologia	antropologia
keisari	imperatore
Grad	grad
vyöt	cinture
mustat	neri
sivistynyt	educato
ylpeänä	orgoglio
välttämättömyys	necessità
käyrät	curve
farmari	turismo
kärki	vertice
tomaatti	pomodoro
matkustaa	viaggi
kalpea	pallido
toiminta	funzionamento
talouksien	economie
sitoutuvat	intraprendere
julistaa	dichiarare
venttiilit	valvole
aukkoja	lacune
saavutukset	realizzazioni
repiä	lacrima
opettaa	insegna
nolla	zero
muukalainen	sconosciuto
pesä	nido
tuomioistuin	tribunale
sulkea	governato
eläkkeet	pensioni
rukoukset	preghiere
poliisi	poliziotto
nuori	adolescente
ehdokkaat	nomination
banaani	Banana
alustava	introduttivo
varasto	serbatoio
esiintyminen	evento
idoli	idolo
verinen	sanguinoso
muistuttaa	ricordare
viehättävä	affascinante
hammas	dente
arvostettu	rispettata
pysyy	soggiorni
asia	affare
rajoittaa	limitare
kaivokset	miniere
muotokuvia	ritratti
tulkita	interpretato
arvioinnit	valutazioni
eliminointi	eliminazione
metriä	metri
hypoteettinen	ipotetico
helikopteri	elicottero
lyijykynä	matita
esiintyjä	esecutore
palkkiot	commissioni
pallo	sfera
sammal	muschio
suhteet	rapporti
sopu	concordia
porrastettu	laureato
hyväksyttiin	omologati
yllättävä	sorprendente
peitsi	lancia
tikapuut	scala
korkki	sughero
senaattorit	senatori
verenvuoto	emorragia
luonnehdinta	caratterizzazione
todennäköisyys	probabilità
kaistat	corsie
perusteet	fondamenti
saastuminen	contaminazione
kupoli	cupola
siunata	benedire
neuvottelu	trattativa
harja	cresta
vastustajat	avversari
riemuvoitto	trionfo
nimitetty	nominato
hitsaus	saldatura
orgasmi	orgasmo
metalliseos	lega
tontteja	trame
kevyesti	delicatamente
lukitus	bloccaggio
kiistanalainen	controverso
kiinnittää	disegna
jääkaappi	frigo
terät	lame
silmukoita	loop
aalto	ondata
trauma	trauma
ilmoitus	annuncio
puolustava	difensiva
kielletty	proibito
vanilja	vaniglia
ohjelmoijat	programmatori
seurataan	monitorati
laitteistot	installazioni
sielut	anime
motivoitunut	motivata
tyhmä	muto
ontto	cavo
holvi	volta
ura	scanalatura
paljastus	rivelazione
pyrkimys	ricerca
valtuuskunta	delegazione
johdot	fili
sanakirjoja	dizionari
läpinäkyvyys	trasparenza
kiertorata	orbita
valuutat	valute
Niger	Niger
paikannus	posizionamento
siirtomaa	colonia
tykki	cannone
sirkus	circo
ylennetty	promossa
taimen	trota
saavutus	impresa
väliaikaisesti	temporaneamente
valmistettu	cucinato
lähettää	trasmettere
taajuudet	frequenze
ajatukset	riflessi
nälkä	fame
kunta	comune
etsivä	investigatore
sementti	cemento
kokee	sperimentare
takka	camino
merkintä	approvazione
tekstiilit	tessile
ohjus	missile
psykiatria	psichiatria
avustaa	assist
tilintarkastaja	uditore
viulu	violino
profeetta	profeta
oksidi	ossido
upea	magnifico
viipymättä	prontamente
sovittaminen	adattamento
haitallinen	dannoso
seksuaalisesti	sessualmente
liite	allegato
glukoosi	glucosio
normi	norma
toisto	riproduzione
kilpikonna	tartaruga
etäisyydet	distanze
imeytyminen	assorbimento
aarteita	tesori
fossiili	fossile
huonosti	male
kommunistinen	comunista
yrittäjät	imprenditori
robotit	robot
virhe	fallo
biodiversiteetti	biodiversità
jännitys	eccitazione
sanallinen	verbale
meret	mari
salaperäinen	misterioso
uutuus	novità
laatat	piastrelle
kirjastonhoitaja	bibliotecario
kytketty	commutata
ru	ru
aiheuttaa	posa
grammaa	grammi
terapeutti	terapista
budjetit	budget
vuohi	capra
tehdä	rendere
purjehtia	vela
komissaarit	commissari
tiheä	denso
urhea	coraggioso
huolinta	spedizione
hirveä	terribile
lentokone	aereo
organismit	organismi
teleskooppi	telescopio
asbesti	amianto
edistäminen	avanzamento
paju	salice
jatkuu	riprende
olemassa	esistito
generaattorit	generatori
synnyttää	genera
perunat	patate
perusteellinen	completo
reseptorit	recettori
optimaalinen	ottimale
olento	creatura
yksinäinen	solitario
hienovarainen	sottile
raidat	strisce
firmware	firmware
paimen	pastore
kehto	culla
liittokansleri	cancelliere
jauhot	Farina
kiista	controversia
legendaarinen	leggendario
kuoro	coro
välttää	evitando
kauniisti	magnificamente
odottaa	aspetta
hyppy	salto
kankaat	tessuti
polymeeri	polimero
hygienia	igiene
hyve	virtù
kirurgit	chirurghi
mandaatti	mandato
corpus	corpo
terminologia	terminologia
herrasmies	signore
tuomittu	condannato
suihkukoneet	getti
indeksit	indici
qui	qui
uhkaava	minaccioso
aktivistit	attivisti
vanki	prigioniero
kannustaa	incoraggia
koolla	assemblato
terminaalit	terminali
raaka	greggio
tutkii	esamina
viikinki	vichingo
siivota	pulire
ehdollinen	condizionale
hyökkäsi	attaccato
saapuu	arriva
kääntäjä	traduttore
autojen	automobili
traktori	trattore
maanosa	continente
hintoja	tariffe
pituusaste	longitudine
toivoneet	sperato
lisäys	inserimento
rajoite	costrizione
vahvistaminen	potenziamento
haluaa	desiderando
eristys	isolamento
rikkominen	violazione
taipunut	piegato
subjektiivinen	soggettivo
hirviöt	mostri
turvapaikka	asilo
panos	palo
cocktail	cocktail
lajikkeet	varietà
myrkyttää	veleno
hallitsi	dominato
kallis	costoso
johdannaiset	derivati
estää	impedisce
kivääri	fucile
rasismi	razzismo
tulkita	interpretare
sopimus	accordo
vaatimaton	modesto
pelaajat	giocatori
lajittelu	ordinamento
yhteys	collegamento
sipulit	bulbi
turistit	turisti
käyttäytymistä	comportamenti
selventää	chiarire
vyötärö	vita
johtuvan	attribuito
pöllö	gufo
kiteet	cristalli
ylittää	supera
täydentävä	complementare
taistelut	battaglie
katkera	amaro
muistio	memorandum
lohikäärmeitä	draghi
melu	frastuono
uskomattoman	incredibilmente
osanottajaa	delegati
psykiatrinen	psichiatrico
nuoret	adolescenti
piha	cortile
presidentit	presidenti
lähteä	partire
nimenomaan	espressamente
lilja	giglio
erehdys	svista
hartsi	resina
liittoutuneet	alleati
säilytetty	conservato
ristissä	attraversato
nouseva	ascendente
nimellinen	nominale
rappeutuminen	decadimento
kvartsi	quarzo
rekisterit	registri
kahdeksas	ottavo
valtuutettu	autorizzato
parantaa	migliora
kannattaa	sostenitori
ilmiöitä	fenomeni
kallistaa	inclinazione
graniitti	granito
massat	masse
urheilija	atleta
frangi	franco
samankaltaisuus	somiglianza
vuotaa	perdita
neuvonantaja	consigliere
kirjanen	opuscolo
odottaa	aspettandosi
liikevaihto	turnover
virtsa	urina
pyyhe	asciugamano
inkivääri	Zenzero
kromosomi	cromosoma
als	als
kärpäset	mosche
pätevyys	competenza
huutava	pianto
amatöörit	dilettanti
nosturi	gru
tutkii	indagare
mätä	marcio
tapa	abitudine
kunnia	onore
suojaa	protegge
iiris	iris
hallinnoi	gestisce
eroosio	erosione
puuseppä	falegname
kaani	caravanserraglio
riittämätön	insufficiente
muotoilu	formulazione
taitava	intelligente
ylähuone	signori
nautittava	piacevole
puolikuu	mezzaluna
kuusikymmentä	sessanta
keskitetty	concentrato
erottaa	distinguere
EI	EI
ennusteet	proiezioni
kipinä	scintilla
turvaaminen	fissaggio
polku	sentiero
ilmaisimet	rilevatori
piikki	spuntone
ainesosa	ingrediente
verho	tenda
julkaisussa	divulgato
taktinen	tattico
lentäjät	piloti
retkikunta	spedizione
operatiivinen	operativo
huumori	umorismo
mol	mol
jälki	impronta
avustaminen	assistere
vika	difetto
huonosti	male
jumalatar	dea
tarkkailijat	osservatori
magneetit	magneti
kaavat	formule
tilava	spazioso
väittää	sostiene
maaperä	suoli
elimet	organi
det	det
uskollisuus	lealtà
luotettava	fedele
rikkomus	offesa
litium	litio
harppaus	salto
perustamisen	fondazione
joutsen	cigno
istutus	piantare
liitto	patto
arkeologia	archeologia
merimies	marinaio
huolet	cure
pyhäkkö	santuario
patsas	statua
lainaus	Quotazione
suurten	major
manipulointi	manipolazione
kelloja	campane
myrkyllisyys	tossicità
lähetin	trasmettitore
lähiöissä	quartieri
palkinto	trofeo
tunne	emozione
nähtävyydet	viste
univormut	uniformi
haavoittunut	ferito
johdannainen	derivato
käyttöaste	occupazione
annokset	dosi
kouluttaa	educare
ennakkoluulo	pregiudizio
teknikot	tecnici
todennäköinen	probabile
liikkeeseen	emissione
koriste	decorazione
kansalaisten	cittadini
troijalainen	trojan
avustajat	assistenti
neuvonantaja	consulente
sääti	promulgato
epävakaa	instabile
kehotti	sollecitato
heijastava	riflettendo
saamassa	guadagnando
lopullinen	definitivo
matkusti	viaggiato
sopeuttaa	adattare
liittymistä	accessione
säädin	regolatore
polttoaineet	combustibili
soija	soia
siisti	pulito
nimeäminen	denominazione
perä	poppa
muotoillun	artigianale
idiootti	idiota
käsitti	composto
ulkomaalaisten	alieni
muokkaukset	modifiche
korppi	Corvo
asunto	dimora
symbolinen	simbolico
kulmat	angoli
paineet	pressioni
Venus	Venere
liekit	fiamme
primitiivinen	primitivo
sukka	calza
ekosysteemi	ecosistema
hallit	sale
yksinkertaisuus	semplicità
demoni	demone
tyytyväinen	accolto
merkintätapa	notazione
täti	zia
varis	corvo
semanttinen	semantico
lopetettu	interrotto
päättää	decide
globalisaatio	globalizzazione
aasit	asini
kompassi	bussola
kehittynyt	evoluto
jalkaväki	fanteria
kuuluisa	rinomato
käytävä	corridoio
filosofinen	filosofico
oikeutus	giustificazione
vapaa	vacante
vahvistamisesta	fissaggio
gramma	grammo
piilossa	bastonatura
väriaine	colorante
aakkoset	alfabeto
puhdistettu	puliti
kunnioitettava	onorato
optinen	ottico
puhelimet	telefoni
päiväkirjat	diari
suru	dolore
hiki	sudore
delfiini	delfino
ihmeitä	meraviglie
ilmanvaihto	ventilazione
maskit	maschere
rintakuva	busto
kuja	vicolo
reittejä	percorsi
lennätin	telegrafo
monumentti	monumento
muodollisesti	formalmente
kaste	rugiada
peruutettu	ritirato
keskustelut	dibattiti
identiteetit	identità
puute	carenza
satula	sella
malaria	malaria
uskollinen	leale
suuntaus	tendenza
hyödynnetty	utilizzato
ein	Ein
kiikari	binocolo
aloittaa	iniziato
puhtaasti	puramente
eloisa	vivido
väitteitä	accuse
vastaa	corrisponde
demoni	demone
juhlittu	celebre
metsästäjät	cacciatori
toimi	agito
kerroin	coefficiente
kallo	cranio
jatkaminen	continuazione
palvelija	servitore
haukka	falco
yhdessä	insieme
välttää	evitato
selitykset	spiegazioni
uudistunut	rinnovato
kriitikko	critico
sedimentti	sedimento
neliöt	piazze
pakettiautot	furgoni
kartio	cono
selviytyi	sopravvissuto
yleisyys	prevalenza
kappale	frammento
sitoutuu	impegna
kobra	cobra
heitti	gettò
hoc	hoc
esiintyjät	interpreti
jälkiruoka	dolce
väitöskirja	dissertazione
yhdeksäs	nono
innostusta	entusiasmo
juhlia	celebrazioni
kuvernöörit	governatori
atomia	atomi
kudokset	tessuti
ramppi	rampa
kauniisti	piacevolmente
della	della
ylivalta	dominio
sointuja	accordi
vajaatoiminta	menomazione
molekyyli	molecola
