of	di
to	a
in	in
for	per
is	è
on	sopra
that	quella
by	di
this	Questo
with	con
i	io
you	tu
it	esso
or	o
be	essere
are	siamo
at	a
all	tutti
have	avere
new	nuovo
we	noi
will	volere
home	casa
us	noi
about	di
if	Se
page	pagina
my	mio
has	ha
search	ricerca
free	gratuito
but	ma
our	nostro
one	uno
other	altro
do	fare
information	informazione
time	tempo
he	lui
which	quale
their	loro
news	notizia
use	uso
there	Là
see	vedere
so	così
who	chi
web	web
also	anche
get	ottenere
pm	pm
view	vista
c	c
e	e
first	primo
been	stato
would	voluto
were	erano
s	S
like	piace
x	X
than	di
find	trova
price	prezzo
back	indietro
top	superiore
people	persone
had	aveva
list	elenco
name	nome
just	appena
year	anno
day	giorno
into	in
two	Due
health	Salute
n	n
re	ri
used	Usato
go	partire
b	B
last	ultimo
make	rendere
them	loro
should	dovrebbero
product	Prodotto
system	sistema
post	inviare
her	sua
city	città
t	t
policy	politica
number	numero
support	supporto
message	Messaggio
after	dopo
then	poi
jan	gennaio
good	bene
d	d
where	dove
info	Informazioni
rights	diritti
books	libri
high	alto
school	scuola
m	m
each	ogni
links	link
she	lei
years	anni
order	ordine
very	molto
book	libro
items	elementi
company	azienda
r	r
read	leggere
group	gruppo
sex	sesso
many	molti
user	utente
de	de
set	impostato
general	generale
research	ricerca
university	Università
january	gennaio
mail	posta
full	pieno
reviews	recensioni
program	programma
know	conoscere
games	Giochi
way	modo
days	giorni
p	p
part	parte
could	poteva
great	grande
united	unito
real	vero
f	f
international	internazionale
center	centro
travel	viaggio
comments	Commenti
made	fatto
development	sviluppo
report	rapporto
member	membro
details	dettagli
line	linea
terms	condizioni
before	prima
hotels	alberghi
did	fatto
send	inviare
right	destra
type	genere
local	Locale
those	quelli
results	risultati
office	ufficio
national	nazionale
car	auto
design	design
take	prendere
posted	postato
address	indirizzo
community	Comunità
within	entro
states	stati
want	volere
phone	Telefono
dvd	DVD
subject	soggetto
between	fra
forum	Forum
family	famiglia
l	l
long	lungo
w	w
show	mostrare
o	o
even	anche
black	nero
special	speciale
index	indice
being	essere
women	donne
much	tanto
sign	cartello
file	file
link	collegamento
open	Aperto
south	Sud
case	Astuccio
project	progetto
pages	pagine
version	versione
section	sezione
own	proprio
house	Casa
security	sicurezza
g	g
county	contea
american	americano
photo	foto
game	gioco
members	membri
power	energia
network	Rete
computer	computer
systems	sistemi
three	tre
place	posto
end	fine
h	h
him	lui
per	per
access	accesso
think	pensare
north	nord
resources	risorse
current	attuale
big	grande
media	media
law	legge
control	controllo
water	acqua
history	storia
size	dimensione
personal	personale
guide	guida
shop	negozio
directory	elenco
change	modificare
white	bianca
text	testo
small	piccolo
rating	valutazione
rate	Vota
government	governo
children	bambini
return	ritorno
students	studenti
v	v
account	account
times	volte
level	livello
digital	digitale
profile	profilo
previous	precedente
form	modulo
events	eventi
love	amore
old	vecchio
john	John
main	principale
call	chiamata
image	Immagine
department	Dipartimento
title	titolo
non	non
k	K
y	y
insurance	assicurazione
shall	deve
property	proprietà
class	classe
cd	CD
quality	qualità
every	ogni
listing	listato
content	soddisfare
country	nazione
little	piccolo
tools	utensili
low	Basso
reply	rispondere
customer	cliente
december	dicembre
compare	confrontare
movies	film
college	Università
value	valore
article	articolo
man	uomo
jobs	lavori
j	j
food	cibo
author	autore
different	diverso
u	u
learn	imparare
sale	saldi
print	stampare
course	corso
job	lavoro
room	camera
stock	azione
training	formazione
too	pure
credit	credito
point	punto
science	scienza
men	uomini
categories	categorie
west	ovest
look	Guarda
english	Inglese
team	squadra
estate	tenuta
box	scatola
conditions	condizioni
photos	fotografie
gay	gay
thread	filo
category	categoria
note	Nota
live	vivere
large	grande
gallery	galleria
table	tavolo
however	però
june	giugno
october	ottobre
november	novembre
market	mercato
library	biblioteca
action	azione
start	inizio
series	serie
features	Caratteristiche
air	aria
industry	industria
plan	Piano
human	umano
yes	sì
second	secondo
hot	caldo
cost	costo
movie	film
forums	forum
march	marzo
la	la
september	settembre
say	dire
going	andando
medical	medico
friend	amico
dec	dicembre
server	server
application	applicazione
staff	personale
play	giocare
issues	problemi
april	aprile
users	utenti
street	strada
topic	argomento
against	contro
got	avuto
blog	blog
party	festa
payment	pagamento
equipment	attrezzatura
let	permettere
programs	programmi
legal	legale
recent	recente
park	parco
act	atto
problem	problema
red	rosso
give	dare
memory	memoria
performance	prestazione
social	sociale
q	q
story	storia
sell	vendere
options	opzioni
experience	Esperienza
key	chiave
body	corpo
young	giovane
important	importante
field	campo
few	pochi
east	est
single	singolo
ii	ii
age	età
club	club
example	esempio
girls	ragazze
z	z
road	strada
gift	regalo
question	domanda
ca	circa
hard	difficile
pay	pagare
four	quattro
poker	poker
issue	problema
range	gamma
building	costruzione
seller	venditore
court	Tribunale
february	febbraio
result	risultato
light	leggero
write	Scrivi
war	guerra
offer	offrire
blue	blu
groups	gruppi
al	al
easy	facile
given	dato
request	richiesta
fax	fax
china	Cina
making	fabbricazione
picture	immagine
needs	esigenze
possible	possibile
month	mese
major	maggiore
star	stella
future	futuro
space	spazio
committee	Comitato
hand	mano
sun	sole
cards	carte
london	Londra
meeting	incontro
become	diventare
child	bambino
keep	conservare
porn	porno
share	Condividere
similar	simile
garden	giardino
schools	scuole
million	milione
added	aggiunto
reference	riferimento
companies	aziende
baby	bambino
learning	apprendimento
energy	energia
run	correre
delivery	consegna
popular	popolare
term	termine
film	film
stories	storie
put	mettere
journal	rivista
reports	rapporti
co	co
try	provare
images	immagini
notice	Avviso
god	Dio
original	originale
head	capo
radio	Radio
cell	cellula
council	consiglio
includes	include
track	traccia
discussion	discussione
archive	archivio
others	altri
agreement	accordo
format	formato
society	società
months	mesi
safety	sicurezza
friends	amici
sure	sicuro
edition	edizione
messages	messaggi
marketing	marketing
tell	raccontare
association	associazione
provides	fornisce
fun	divertimento
already	già
green	verde
studies	studi
close	vicino
common	Comune
specific	specifica
several	parecchi
living	vita
collection	collezione
called	chiamato
short	corto
arts	arti
lot	lotto
ask	Chiedere
limited	limitato
solutions	soluzioni
director	direttore
beach	spiaggia
past	passato
natural	naturale
electronics	elettronica
upon	su
period	periodo
planning	pianificazione
says	dice
official	ufficiale
mar	mar
done	fatto
technical	tecnico
window	finestra
pro	professionista
region	regione
island	isola
record	disco
direct	diretto
conference	conferenza
records	record
st	st
district	quartiere
calendar	calendario
costs	costi
style	stile
statement	dichiarazione
miles	miglia
resource	risorsa
applications	applicazioni
document	documento
word	parola
works	lavori
material	Materiale
bill	conto
written	scritto
rules	regole
final	finale
thing	cosa
centre	centro
requirements	requisiti
TRUE	VERO
minutes	minuti
else	altro
mark	marchio
rock	roccia
bad	cattivo
individual	individuale
plus	più
auto	auto
cover	copertina
edit	modificare
together	insieme
videos	video
fast	veloce
function	funzione
fact	fatto
getting	ottenere
global	globale
tech	Tech
meet	incontrare
far	lontano
economic	economico
en	it
player	giocatore
projects	progetti
amount	quantità
watch	orologio
included	incluso
feel	sentire
bank	banca
risk	rischio
deals	offerte
various	vario
words	parole
production	produzione
commercial	commerciale
weight	peso
heart	cuore
treatment	trattamento
points	punti
knowledge	conoscenza
magazine	rivista
error	errore
camera	telecamera
girl	ragazza
construction	costruzione
toys	giocattoli
registered	registrato
domain	dominio
methods	metodi
chapter	capitolo
protection	protezione
policies	politiche
wide	largo
beauty	bellezza
manager	manager
india	India
position	posizione
taken	prese
sort	ordinare
listings	annunci
known	conosciuto
half	metà
cases	casi
step	passo
engineering	ingegneria
simple	semplice
quick	Presto
license	licenza
lake	lago
whole	totale
annual	annuale
published	pubblicato
church	Chiesa
method	metodo
active	attivo
response	risposta
figure	figura
materials	materiale
enough	abbastanza
designed	progettato
among	tra
death	Morte
loss	perdita
face	viso
brand	marca
discount	sconto
effects	effetti
created	creato
standards	norme
bit	po
political	politico
kingdom	regno
base	base
doing	fare
loans	prestiti
shoes	scarpe
entry	iscrizione
stay	restare
orders	ordini
availability	disponibilità
summary	sommario
turn	turno
growth	crescita
agency	agenzia
king	re
european	europeo
activity	attività
copy	copia
western	occidentale
force	vigore
employment	occupazione
bay	baia
river	fiume
commission	commissione
package	pacchetto
seen	visto
players	Giocatori
engine	motore
port	porta
album	album
regional	regionale
stop	Stop
started	iniziato
administration	amministrazione
bar	bar
institute	istituto
views	visualizzazioni
double	Doppio
dog	cane
soon	presto
lines	Linee
electronic	elettronico
benefits	benefici
needed	necessaria
printer	stampante
condition	condizione
effective	efficace
believe	credere
organization	organizzazione
effect	effetto
mind	mente
selection	selezione
casino	casinò
pdf	PDF
tour	giro
cross	attraversare
hope	speranza
corporation	società
wish	desiderio
solution	soluzione
mature	maturo
role	ruolo
weeks	settimane
certain	certo
lower	inferiore
necessary	necessario
union	unione
mon	mon
com	com
particular	particolare
fine	bene
hour	ora
gas	gas
skills	abilità
six	sei
bush	cespuglio
islands	isole
advice	consigli
career	carriera
decision	decisione
leave	partire
pre	pre
huge	enorme
woman	donna
facilities	strutture
bid	offerta
middle	mezzo
cable	cavo
opportunities	opportunità
taking	presa
values	valori
division	divisione
coming	venuta
object	oggetto
lesbian	lesbica
appropriate	adeguata
machine	macchina
logo	logo
length	lunghezza
nice	simpatico
score	Punto
statistics	statistica
client	cliente
sample	campione
investment	investimento
sent	inviato
shown	mostrato
christmas	Natale
culture	cultura
flash	veloce
ms	Signorina
choice	scelta
courses	corsi
consumer	consumatore
hi	Ciao
foreign	straniero
artist	artista
furniture	mobilia
channel	canale
letter	lettera
mode	modalità
phones	telefoni
ideas	idee
structure	struttura
degree	grado
contract	contrarre
super	super
male	maschio
matter	importa
almost	quasi
located	collocato
multiple	multiplo
distribution	distribuzione
editor	editore
inn	Locanda
industrial	industriale
potential	potenziale
song	canzone
los	los
fall	autunno
idea	idea
rooms	camere
communications	comunicazioni
win	vincere
primary	primario
cancer	cancro
numbers	numeri
reason	ragionare
tool	strumento
spring	primavera
foundation	fondazione
answer	risposta
voice	voce
schedule	programma
documents	documenti
purpose	scopo
feature	caratteristica
bed	letto
comes	viene
police	polizia
independent	indipendente
approach	approccio
brown	Marrone
physical	fisico
hill	collina
maps	mappe
hold	tenere
ratings	giudizi
happy	contento
smith	fabbro
developed	sviluppato
thank	grazie
safe	sicuro
unique	unico
survey	sondaggio
prior	precedente
telephone	telefono
sport	sport
ready	pronto
animal	animale
sources	fonti
population	popolazione
pa	papà
regular	regolare
secure	sicuro
operations	operazioni
simply	semplicemente
evidence	prova
station	stazione
understand	capire
option	opzione
valley	valle
probably	probabilmente
sea	mare
publications	pubblicazioni
improve	Migliorare
connection	connessione
publisher	editore
hall	sala
anti	anti
networks	reti
earth	terra
parents	genitori
impact	urto
transfer	trasferimento
introduction	introduzione
kitchen	cucina
strong	forte
wedding	nozze
properties	proprietà
hospital	ospedale
ground	terra
ship	nave
accommodation	alloggio
disease	malattia
excellent	eccellente
perfect	perfezionare
hair	capelli
opportunity	opportunità
kit	kit
classic	classico
basis	base
command	comando
cities	città
express	esprimere
award	premio
distance	distanza
tree	albero
assessment	valutazione
wall	parete
involved	coinvolti
el	EL
extra	extra
especially	particolarmente
budget	bilancio
guides	guide
success	successo
maximum	massimo
ma	mamma
operation	operazione
existing	esistente
quite	abbastanza
selected	selezionato
boy	ragazzo
restaurants	ristoranti
beautiful	bellissimo
warning	avvertimento
locations	posizioni
horse	cavallo
vote	votazione
flowers	fiori
stars	stelle
lists	liste
owner	proprietario
animals	animali
ways	modi
son	figlio
providing	fornitura
rule	regola
housing	alloggiamento
takes	prende
bring	portare
catalog	Catalogare
max	max
mother	madre
authority	autorità
told	detto
programme	programma
joined	Iscritto
input	ingresso
strategy	strategia
feet	piedi
agent	agente
valid	valido
modern	moderno
senior	anziano
sexy	sexy
teaching	insegnamento
door	porta
grand	grande
trial	prova
units	unità
cool	freddo
normal	normale
enterprise	impresa
ships	navi
entire	intero
positive	positivo
fitness	fitness
chinese	Cinese
opinion	opinione
football	calcio
abstract	astratto
output	produzione
funds	fondi
mr	Sig
likely	probabile
develop	sviluppare
artists	artisti
alternative	alternativa
responsibility	responsabilità
java	Giava
guest	ospite
publication	pubblicazione
pass	passaggio
relations	relazioni
trust	fiducia
van	furgone
contains	contiene
multi	Multi
republic	repubblica
fees	tasse
components	componenti
vacation	vacanza
century	secolo
academic	accademico
assistance	assistenza
completed	completato
skin	pelle
graphics	grafica
indian	indiano
ring	squillare
grade	grado
mountain	montagna
organizations	organizzazioni
filter	filtro
panel	pannello
floor	pavimento
buying	acquisto
match	incontro
proposed	proposto
require	richiedere
boys	ragazzi
morning	mattina
allows	consente
protein	proteina
plant	pianta
reported	segnalati
hit	colpire
mm	mm
pool	piscina
mini	mini
politics	politica
partner	compagno
authors	autori
boards	tavole
fish	pesce
membership	membri
mission	missione
eye	occhio
string	stringa
sense	senso
modified	modificata
released	rilasciato
stage	palcoscenico
internal	interno
born	Nato
detailed	dettagliato
japanese	giapponese
race	gara
approved	approvato
target	bersaglio
except	tranne
character	carattere
maintenance	Manutenzione
ability	capacità
ed	Ed
rape	stupro
battery	batteria
youth	gioventù
pressure	pressione
submitted	presentata
debt	debito
medium	medio
television	televisione
interested	interessato
core	nucleo
break	rompere
purposes	scopi
sets	imposta
dance	danza
wood	legna
defined	definito
papers	documenti
awards	premi
fee	tassa
studio	studio
reader	lettore
device	dispositivo
established	stabilito
answers	risposte
rent	affitto
las	las
dark	buio
external	esterno
apple	Mela
le	Le
instructions	Istruzioni
min	min
offered	offerta
theory	teoria
remove	rimuovere
aid	aiuto
visual	visivo
host	ospite
variety	varietà
teachers	insegnanti
manual	Manuale
block	bloccare
subjects	soggetti
agents	agenti
repair	riparazione
fair	giusto
steel	acciaio
understanding	comprensione
songs	canzoni
fixed	fisso
wrong	sbagliato
beginning	inizio
hands	mani
az	az
paris	Parigi
gets	prende
sector	settore
capacity	capacità
un	un
fat	Grasso
father	padre
electric	elettrico
saw	sega
instruments	strumenti
officer	ufficiale
driver	autista
businesses	aziende
dead	morto
unknown	sconosciuto
restaurant	ristorante
mike	Mike
trip	viaggio
mi	mi
poor	povero
relationship	relazione
workers	lavoratori
peace	pace
traditional	tradizionale
showing	mostrando
creative	creativo
coast	costa
benefit	vantaggio
funding	finanziamento
devices	dispositivi
lord	signore
grant	concedere
sub	sub
fiction	finzione
watches	orologi
careers	carriere
goes	va
led	guidato
museum	Museo
fan	fan
transport	trasporto
interesting	interessante
blogs	blog
evaluation	valutazione
former	ex
zone	zona
complex	complesso
th	esimo
cat	gatto
die	morire
presented	presentata
flat	piatto
flow	flusso
agencies	agenzie
literature	letteratura
parent	genitore
setting	ambientazione
dr	dr
scale	scala
economy	economia
helpful	utile
monthly	mensile
critical	critico
frame	telaio
musical	musicale
definition	definizione
secretary	segretario
path	sentiero
chief	capo
gives	dà
packages	Pacchetti
detail	dettaglio
laws	legislazione
changed	cambiato
begin	inizio
royal	reale
clean	pulito
guy	tipo
titles	titoli
relevant	pertinente
justice	giustizia
connect	Collegare
cup	tazza
basket	cestino
applied	applicato
weekly	settimanalmente
vol	vol
installation	installazione
pp	pp
attention	Attenzione
advance	avanzare
skip	Salta
diet	dieta
army	esercito
gear	Ingranaggio
difference	differenza
allowed	permesso
correct	corretta
nation	nazione
selling	vendita
lots	molte
piece	pezzo
sheet	foglio
firm	azienda
seven	Sette
elements	elementi
species	specie
jump	saltare
cells	cellule
module	modulo
resort	ricorrere
certificate	certificato
minister	ministro
motion	movimento
fashion	moda
directions	indicazioni
visitors	visitatori
documentation	documentazione
trading	commercio
forest	foresta
calls	chiamate
coverage	copertura
couple	coppia
giving	dando
chance	opportunità
vision	visione
ball	palla
ending	fine
clients	clienti
actions	Azioni
discuss	discutere
goal	obbiettivo
successful	riuscito
sold	venduto
wind	vento
communities	comunità
clinical	clinico
situation	situazione
markets	mercati
publishing	editoriale
appear	apparire
developing	sviluppando
lives	vite
determine	determinare
temperature	temperatura
announcements	annunci
patient	paziente
actual	effettivo
historical	storico
stone	pietra
bob	peso
commerce	commercio
persons	persone
difficult	difficile
scientific	scientifico
satellite	satellitare
tests	test
village	villaggio
accounts	conti
amateur	dilettante
ex	ex
met	incontrato
pain	dolore
factors	fattori
coffee	caffè
buyer	acquirente
poster	manifesto
edge	bordo
functional	funzionale
root	radice
fi	fi
closed	chiuso
holidays	vacanze
pink	rosa
balance	equilibrio
monitoring	monitoraggio
replies	risposte
shot	tiro
initial	iniziale
label	etichetta
sec	secondo
canon	canone
league	lega
waste	rifiuto
minute	minuto
bus	autobus
provider	fornitore
dictionary	dizionario
accounting	contabilità
manufacturing	produzione
sections	sezioni
chair	sedia
effort	sforzo
phase	fase
fantasy	fantasia
po	Po
va	va
professor	Professore
install	installare
shirt	camicia
apparel	abbigliamento
foot	piede
breast	Seno
techniques	tecniche
dollars	dollari
religion	religione
permission	autorizzazione
wild	selvaggio
generation	generazione
miss	Perdere
chemical	chimico
doctor	medico
task	compito
reduce	ridurre
brought	portato
exercise	esercizio
bug	insetto
guarantee	garanzia
leader	capo
se	SE
processes	processi
soft	morbido
meetings	incontri
seconds	secondi
flight	volo
congress	congresso
fuel	carburante
walk	camminare
produced	prodotta
saint	santo
argument	discussione
competition	concorrenza
drugs	farmaci
joint	comune
premium	premio
fresh	fresco
characters	personaggi
attorney	procuratore
di	di
factor	fattore
thousands	migliaia
km	km
stream	ruscello
apartments	appartamenti
pick	raccogliere
hearing	udito
eastern	orientale
therapy	terapia
entries	inserimenti
signed	firmato
administrative	amministrativo
serious	grave
limit	limite
steps	passaggi
shops	negozi
bondage	servitù
del	del
efforts	sforzi
informed	informato
ga	ga
thoughts	pensieri
creek	torrente
ft	ft
quantity	quantità
essential	essenziale
tours	tour
load	caricare
immediately	subito
machines	macchine
designated	designato
heavy	pesante
covered	coperto
recovery	recupero
integrated	integrato
configuration	configurazione
cock	cazzo
merchant	mercante
comprehensive	globale
expert	esperto
protect	proteggere
solid	solido
presentation	presentazione
became	divenne
orange	arancia
compliance	conformità
theme	tema
rich	ricco
campaign	campagna
vs	vs
guitar	chitarra
finding	scoperta
examples	esempi
spirit	spirito
ar	ar
claims	reclami
acceptance	accettazione
strategies	strategie
mo	momento
affairs	affari
intended	destinato
sa	sa
goals	obiettivi
hire	assumere
election	elezione
suggest	suggerire
branch	ramo
serve	servire
affiliates	affiliati
mount	montare
latin	latino
multimedia	multimedia
manage	gestire
corner	angolo
rank	rango
element	elemento
birth	nascita
virus	virus
interactive	interattivo
requests	richieste
separate	separato
quarter	trimestre
procedure	procedura
leadership	comando
define	definire
religious	religioso
facts	fatti
breakfast	colazione
column	colonna
faith	fede
chain	catena
identify	identificare
avenue	viale
missing	mancante
recommendations	raccomandazioni
moved	mosso
reach	raggiungere
comparison	confronto
moment	momento
extended	esteso
sequence	sequenza
inch	pollice
attack	attacco
centers	centri
opening	apertura
lab	laboratorio
reserve	Riserva
gamma	gamma
produce	produrre
truth	verità
counter	contatore
failure	fallimento
follows	segue
dollar	dollaro
camp	campo
des	des
films	cinema
bridge	ponte
fill	riempire
movement	movimento
printing	stampa
draft	bozza
chart	grafico
played	giocato
contacts	contatti
readers	lettori
clubs	club
wa	wa
adventure	avventura
offering	offerta
profit	profitto
leaders	capi
posters	manifesti
institutions	istituzioni
assistant	assistente
variable	variabile
dj	dj
parking	parcheggio
yesterday	ieri
determined	determinato
workshop	laboratorio
gone	andato
codes	codici
kinds	tipi
extension	estensione
statements	dichiarazioni
completely	completamente
teams	squadre
fort	forte
cm	centimetro
senate	senato
funny	divertente
gene	gene
turned	trasformato
disc	disco
pattern	modello
boat	barca
theatre	Teatro
manufacturers	produttori
sponsor	sponsor
classical	classico
icon	icona
warranty	garanzia
dedicated	dedito
direction	direzione
basketball	pallacanestro
objects	oggetti
delete	Elimina
evening	sera
assembly	montaggio
nuclear	nucleare
mouse	topo
signal	segnale
criminal	penale
issued	rilasciato
powerful	potente
dream	sognare
FALSE	FALSE
da	da
cast	lanciare
flower	fiore
personnel	personale
passed	passato
supplied	fornito
falls	cascate
soul	anima
promote	promuovere
stated	dichiarato
stats	statistiche
professionals	professionisti
appears	appare
carry	trasportare
flag	bandiera
covers	coperture
em	em
advantage	vantaggio
hello	Ciao
designs	disegni
maintain	mantenere
tourism	turismo
priority	priorità
adults	adulti
graphic	grafico
atom	atomo
payments	pagamenti
binding	rilegatura
brief	breve
ended	conclusa
winning	vincente
anonymous	anonimo
script	copione
served	servito
wants	vuole
prepared	preparato
void	vuoto
tag	etichetta
interview	colloquio
mix	mescolare
framework	struttura
disk	disco
installed	installato
queen	Regina
credits	crediti
clearly	chiaramente
fix	fissare
handle	maniglia
sweet	dolce
criteria	criteri
associate	socio
ne	NE
behavior	comportamento
enlarge	Ingrandire
ray	raggio
revenue	reddito
measure	misurare
votes	voti
du	du
duty	dovere
discussions	discussioni
bear	orso
gain	guadagno
festival	Festival
laboratory	laboratorio
ocean	oceano
flights	voli
experts	esperti
signs	segni
depth	profondità
train	treno
dry	asciutto
explore	Esplorare
spa	terme
concept	concetto
nearly	quasi
handling	maneggio
origin	origine
billion	miliardo
intelligence	intelligenza
bought	comprato
con	contro
nations	nazioni
route	itinerario
broken	rotto
battle	battaglia
speak	parlare
protocol	protocollo
query	domanda
partnership	associazione
expression	espressione
es	es
speech	discorso
wire	filo
suggestions	suggerimenti
replacement	sostituzione
tape	nastro
strategic	strategico
judge	giudice
acid	acido
bytes	byte
cent	centesimo
forced	costretto
compatible	compatibile
apartment	appartamento
null	nullo
zero	zero
speaker	altoparlante
consulting	consulenza
designer	progettista
pr	pr
marriage	matrimonio
roll	rotolo
banks	banche
fr	fr
participants	partecipanti
secret	segreto
negative	negativo
favorites	preferiti
theater	Teatro
springs	molle
var	var
perform	eseguire
translation	traduzione
estimates	stime
injury	ferita
ministry	ministero
drivers	driver
lawyer	avvocato
figures	figure
protected	protetta
proposal	proposta
sharing	compartecipazione
portal	portale
beta	beta
gratis	gratis
toward	verso
slightly	leggermente
assist	assistere
conduct	condotta
contained	contenuta
legislation	legislazione
calling	chiamata
parameters	parametri
profiles	profili
matters	questioni
houses	case
controls	controlli
combined	combinato
ultimate	finale
representative	rappresentante
minor	minore
departments	dipartimenti
residents	residenti
displayed	visualizzati
mom	mamma
reduced	ridotto
rare	raro
performed	eseguita
extreme	estremo
samples	campioni
bars	barre
forecast	previsione
removed	rimosso
cycle	ciclo
contain	contenere
accuracy	precisione
sleep	dormire
mg	mg
bird	uccello
pharmacy	farmacia
creation	creazione
static	statico
hunter	cacciatore
addresses	indirizzi
lady	signora
crystal	cristallo
famous	famoso
writer	scrittore
chairman	presidente
drink	bere
academy	accademia
dynamic	dinamico
eat	mangiare
permanent	permanente
cleaning	pulizia
constitutes	costituisce
portfolio	portafoglio
practical	pratico
delivered	consegnato
infrastructure	infrastruttura
colour	colore
vendor	venditore
philosophy	filosofia
regulation	regolamento
officers	ufficiali
aim	scopo
bids	offerte
nutrition	nutrizione
recording	registrazione
junior	junior
les	les
cape	mantellina
rings	anelli
tip	mancia
wonderful	meraviglioso
ticket	biglietto
announced	annunciato
guess	indovina
whom	chi
soccer	calcio
math	matematica
import	importare
posting	spedizione
presence	presenza
automatic	automatico
viewing	visualizzazione
maintained	mantenuto
ch	ch
dan	dan
dogs	cani
directors	registi
aspects	aspetti
ahead	avanti
moon	Luna
participation	partecipazione
scheme	schema
fly	volare
manner	maniera
matrix	matrice
combination	combinazione
amendment	emendamento
strength	forza
turkey	tacchino
libraries	librerie
proper	corretto
degrees	gradi
enterprises	aziende
delta	delta
fear	paura
seeking	cerca
inches	pollici
convention	convenzione
shares	azioni
principal	principale
comfort	comfort
colors	colori
wars	guerre
ordering	ordinazione
kept	tenuto
alpha	alfa
appeal	appello
cruise	crociera
bonus	indennità
hey	Hey
buildings	edifici
specials	Speciali
beat	battere
batteries	batterie
becomes	diventa
drives	unità
arms	braccia
tea	tè
improved	migliorata
achieve	raggiungere
positions	posizioni
dress	vestito
subscription	sottoscrizione
dealer	commerciante
contemporary	contemporaneo
sky	cielo
rom	rom
carried	trasportato
exposure	esposizione
hide	nascondere
signature	firma
miller	mugnaio
provision	fornitura
clothes	Abiti
frames	montatura
certainly	certamente
newspaper	giornale
toy	giocattolo
layer	strato
printed	stampato
slow	lento
removal	rimozione
liability	responsabilità
printers	stampanti
adding	aggiungendo
spot	individuare
spend	trascorrere
factory	fabbrica
interior	interno
grow	crescere
optical	ottico
promotion	promozione
relative	parente
amazing	Stupefacente
dot	punto
identity	identità
conversion	conversione
feeling	sensazione
hidden	nascosto
reasonable	ragionevole
revision	revisione
influence	influenza
ratio	rapporto
importance	importanza
rain	pioggia
planet	pianeta
copies	copie
permit	permesso
seeing	vedendo
proof	prova
bass	basso
prescription	prescrizione
empty	vuoto
instance	esempio
hole	buco
ride	cavalcata
bureau	ufficio
conservation	conservazione
pair	paio
ideal	ideale
specs	Specifiche
recorded	registrato
don	don
pieces	pezzi
finished	finito
parks	parchi
lawyers	avvocati
stress	stress
cream	crema
ss	ss
runs	piste
discover	scoprire
ap	ap
patterns	modelli
hills	colline
nm	nm
advisor	consulente
aware	consapevole
shape	forma
evolution	Evoluzione
certificates	certificati
objectives	obiettivi
stations	stazioni
suggested	suggerito
op	operazione
remains	resti
firms	aziende
euro	Euro
operator	operatore
structures	strutture
generic	generico
encyclopedia	enciclopedia
usage	uso
ink	inchiostro
mixed	misto
census	censimento
wheel	ruota
suppliers	fornitori
compact	compatto
poetry	poesia
lights	luci
tracking	puntamento
angel	angelo
preparation	preparazione
attempt	tentativo
receiving	ricevente
matches	fiammiferi
accordance	conformità
width	larghezza
engines	motori
forget	dimenticare
array	schieramento
discussed	discusso
accurate	preciso
climate	clima
greek	greco
instruction	istruzione
managing	gestione
raw	crudo
differences	differenze
explain	spiegare
establish	stabilire
expressed	espresso
extent	estensione
sharp	acuto
ben	Ben
paragraph	paragrafo
kill	uccidere
mathematics	matematica
compensation	compensazione
export	esportare
managers	manager
modules	moduli
conducted	condotto
versions	versioni
knows	conosce
describe	descrivere
citizens	cittadini
heritage	eredità
trouble	guaio
coach	allenatore
agricultural	agricolo
expand	espandere
audience	pubblico
assigned	assegnato
collections	collezioni
ages	evo
specialist	specialista
cook	cucinare
affect	influenzare
virgin	vergine
experienced	esperto
investigation	indagine
raised	sollevato
hat	cappello
institution	istituzione
directed	dirette
affected	influenzato
bike	bicicletta
totally	totalmente
plate	piatto
expenses	spese
indicate	indicare
blonde	bionda
proceedings	procedimento
favourite	preferito
characteristics	caratteristiche
der	der
lose	perdere
organic	biologico
seek	ricercare
experiences	esperienze
albums	album
contracts	contratti
guests	ospiti
hosted	ospitato
diseases	malattie
concerning	circa
equivalent	equivalente
chemistry	chimica
kits	kit
logic	logica
prince	Principe
circle	cerchio
soil	suolo
psychology	psicologia
wet	bagnato
circumstances	condizioni
investor	investitore
elementary	elementare
sponsors	sponsor
fox	Volpe
unlimited	illimitato
respond	rispondere
sizes	dimensioni
plain	pianura
exit	Uscita
arm	braccio
keys	chiavi
wave	onda
holy	santo
acts	atti
guidance	guida
trail	pista
symbol	simbolo
highway	autostrada
observed	osservata
dean	decano
setup	impostare
poll	sondaggio
styles	stili
filled	pieno
bond	legame
channels	canali
appendix	appendice
chocolate	cioccolato
portion	porzione
scope	scopo
supplier	fornitore
cables	cavi
cotton	cotone
requirement	Requisiti
killed	ucciso
border	confine
ancient	antico
debate	discussione
representatives	rappresentanti
starts	inizia
pregnancy	gravidanza
attractions	attrazioni
learned	imparato
transactions	transazioni
explorer	esploratore
historic	storico
husband	marito
authorized	autorizzato
crazy	pazzo
upcoming	imminente
concert	concerto
scores	punteggi
efficiency	efficienza
comedy	commedia
adopted	adottato
efficient	efficiente
linear	lineare
commitment	impegno
specialty	specialità
bears	orsi
hop	luppolo
carrier	vettore
constant	costante
visa	Visa
mouth	bocca
meter	metro
linked	connesso
interviews	interviste
concepts	concetti
gun	pistola
reflect	riflettere
pure	puro
hell	inferno
fruit	frutta
begins	inizia
qualified	qualificato
reform	riforma
lens	lente
treated	trattati
discovery	scoperta
draw	disegnare
classified	classificato
assume	assumere
alliance	alleanza
confirm	Confermare
engineer	ingegnere
consistent	coerente
replace	sostituire
clearance	autorizzazione
converter	convertitore
organisation	organizzazione
babe	bambino
checks	controlli
reached	raggiunto
becoming	diventando
objective	obbiettivo
indicated	indicato
sugar	zucchero
crew	equipaggio
legs	gambe
stick	bastone
relation	relazione
enabled	abilitato
genre	genere
volunteer	volontario
rear	posteriore
democratic	democratico
enhance	accrescere
exact	esatto
bound	limite
parameter	parametro
processor	processore
node	nodo
formal	formale
storm	tempesta
micro	micro
colleges	collegi
mile	miglio
challenges	sfide
editors	redattori
supreme	supremo
brothers	fratelli
recognition	riconoscimento
ref	arbitro
estimate	stima
kid	ragazzo
inspection	ispezione
consumers	consumatori
limits	limiti
territory	territorio
weapons	Armi
delay	ritardo
pilot	pilota
contributions	contributi
continuous	continuo
initiative	iniziativa
novel	romanzo
execution	esecuzione
disability	invalidità
ultra	ultra
winner	vincitore
episode	episodio
potter	vasaio
dish	piatto
plays	giochi
bulletin	bollettino
ia	ia
modify	modificare
truly	veramente
universe	universo
candidate	candidato
slot	fessura
outstanding	eccezionale
ha	ah
planned	pianificato
lodge	casetta
mirror	specchio
tournament	torneo
consideration	considerazione
sessions	sessioni
kernel	nocciolo
buyers	acquirenti
journals	riviste
gray	grigio
catalogue	Catalogare
charged	carico
broad	ampio
und	und
chosen	scelto
demo	dimostrazione
hate	odiare
terminal	terminale
publishers	editori
nights	notti
liquid	liquido
rice	riso
reservation	prenotazione
foods	Alimenti
guard	guardia
saving	Salvataggio
empire	impero
newly	recentemente
raise	aumentare
illegal	illegale
expansion	espansione
premier	premier
tomorrow	Domani
milk	latte
drama	Dramma
visiting	visitare
contest	concorso
collected	raccolto
bands	bande
suitable	adatto
absolutely	assolutamente
audit	revisione
chamber	Camera
guinea	Guinea
findings	risultati
iso	iso
typical	tipico
sum	somma
chicken	pollo
temporary	temporaneo
attend	assistere
shower	doccia
sending	invio
sufficient	sufficiente
shell	conchiglia
province	Provincia
catholic	cattolico
governor	governatore
beer	birra
contribution	contributo
formula	formula
constitution	costituzione
packaging	confezione
reliable	affidabile
doubt	dubbio
earn	guadagnare
periods	periodi
attacks	attacchi
merchandise	merce
symptoms	sintomi
memorial	memoriale
twin	gemello
insert	inserire
gateway	porta
drawing	disegno
candidates	candidati
ordered	ordinato
biological	biologico
fighting	combattente
transition	transizione
preferences	preferenze
spy	spiare
romance	romanza
instrument	strumento
split	Diviso
themes	temi
powers	potenze
heaven	Paradiso
bits	bit
pregnant	incinta
classification	classificazione
focused	focalizzata
physician	medico
asking	chiede
blocks	blocchi
lo	Lo
spiritual	spirituale
diabetes	diabete
ml	ml
shift	cambio
sit	sedersi
bodies	corpi
photographs	fotografie
cutting	taglio
writers	scrittori
flexible	flessibile
loved	amato
favourites	preferiti
mapping	Mappatura
numerous	numerose
relatively	relativamente
represents	rappresenta
superior	superiore
preferred	preferito
saved	salvato
intellectual	intellettuale
granted	concesso
carbon	carbonio
comfortable	confortevole
magnetic	magnetico
interaction	interazione
listening	ascoltando
crisis	crisi
outlook	prospettiva
massive	massiccio
bright	luminosa
formed	formato
piano	pianoforte
echo	eco
revolution	rivoluzione
displays	visualizza
plasma	plasma
earnings	guadagni
mystery	mistero
landscape	paesaggio
mechanical	meccanico
journey	viaggio
banner	bandiera
fig	Figura
counties	contee
acquisition	acquisizione
recognized	riconosciuto
dreams	sogni
notification	notifica
kg	kg
teach	insegnare
rapid	rapido
pull	Tirare
ut	ut
seminar	seminario
investments	investimenti
wheels	ruote
specify	specificare
sensitive	sensibile
templates	modelli
formats	formati
holds	detiene
router	router
concrete	calcestruzzo
si	SI
folder	cartella
completion	completamento
pulse	impulso
technique	tecnica
voting	voto
courts	tribunali
converted	convertito
metro	Metro
anniversary	anniversario
improvements	miglioramenti
strip	striscia
specification	specificazione
accident	incidente
nick	tacca
accessible	accessibile
resident	residente
plot	tracciare
typically	tipicamente
representation	rappresentazione
pump	pompa
exists	esiste
arrangements	accordi
conferences	conferenze
consumption	consumo
narrow	stretto
threat	minaccia
surveys	sondaggi
sitting	seduta
consultant	consulente
controller	controllore
committees	comitati
penis	pene
castle	castello
gardens	giardini
labels	etichette
willing	disposto
bio	bio
acting	recitazione
heads	teste
exam	esame
residence	residenza
density	densità
hundred	centinaio
strange	strano
sustainable	sostenibile
statistical	statistico
mention	citare
innovation	innovazione
grey	grigio
parallel	parallelo
operate	operare
bills	fatture
stable	stabile
definitions	definizioni
von	von
doctors	medici
lesson	lezione
cinema	cinema
elections	elezioni
reaction	reazione
blank	vuoto
enhanced	migliorata
entitled	intitolato
severe	grave
generate	creare
newspapers	giornali
hospitals	ospedali
vi	VI
humor	umorismo
aged	anziano
monitors	monitor
exception	eccezione
duration	durata
bulk	massa
visits	visite
capabilities	capacità
recommendation	raccomandazione
sin	peccato
organized	organizzato
ba	ba
para	parà
adoption	adozione
improving	miglioramento
expensive	costoso
buffalo	bufalo
organisations	organizzazioni
plane	aereo
programmes	programmi
mechanism	meccanismo
ee	EE
marked	segnato
driven	guidato
bottle	bottiglia
innovative	innovativo
massage	massaggio
conclusion	conclusione
closing	chiusura
thousand	mille
legend	leggenda
villa	villa
bone	osso
columns	colonne
disorders	disturbi
collaboration	collaborazione
detection	rivelazione
inner	interno
formation	formazione
med	med
engineers	ingegneri
entity	entità
cruises	crociere
gate	cancello
roman	romano
duties	doveri
erotic	erotico
tone	tono
ethics	etica
dragon	Drago
busy	occupato
captain	Capitano
brings	porta
heating	riscaldamento
leg	gamba
neck	collo
wing	ala
scripts	script
abc	abc
appointed	designato
dealing	rapporti
commit	commettere
rail	rotaia
trips	viaggi
gap	divario
sides	lati
tube	tubo
corresponding	corrispondente
descriptions	descrizioni
belt	cintura
jacket	giacca
animation	animazione
oracle	oracolo
er	er
productions	produzioni
aviation	aviazione
proud	orgoglioso
disaster	disastro
console	consolle
commands	comandi
jr	jr
telecommunications	telecomunicazioni
instructor	istruttore
giant	gigante
achieved	raggiunto
injuries	lesioni
approaches	approcci
usual	solito
stamps	francobolli
angle	angolo
rob	rapinare
designers	progettisti
liberty	libertà
era	era
convert	convertire
possibility	possibilità
analyst	analista
dangerous	pericoloso
reliability	affidabilità
respectively	rispettivamente
volunteers	volontari
derived	derivato
pleasure	piacere
honor	onore
oriented	orientata
eagle	aquila
prayer	preghiera
workshops	workshop
hurricane	uragano
quiet	silenzioso
producer	produttore
represented	rappresentato
responsibilities	responsabilità
cheese	formaggio
carefully	accuratamente
productivity	produttività
crown	corona
par	par
diagnosis	diagnosi
maker	creatore
crack	crepa
principle	principio
picks	picconi
gang	banda
fetish	feticcio
appearance	aspetto
smoke	Fumo
filters	filtri
incorporated	incorporato
craft	mestiere
fellow	compagno
blind	cieco
lounge	sala
mad	pazzo
algorithm	algoritmo
strongly	fortemente
cafe	bar
ken	comprensione
proteins	proteine
su	su
familiar	familiare
capable	capace
admission	ammissione
shoe	scarpa
elected	eletto
carrying	portando
terrorism	terrorismo
joy	gioia
editions	edizioni
ethnic	etnico
parliament	parlamento
actor	attore
finds	reperti
seal	foca
situations	situazioni
fifth	quinto
citizen	cittadino
vertical	verticale
corrections	correzioni
describes	descrive
disabilities	disabilità
substance	sostanza
prohibited	proibito
pipe	tubo
soldiers	soldati
guardian	custode
lecture	conferenza
simulation	simulazione
layout	disposizione
initiatives	iniziative
ill	malato
concentration	concentrazione
lay	posare
interpretation	interpretazione
dirty	sporco
taught	insegnato
worker	lavoratore
optimization	ottimizzazione
temple	tempio
substances	sostanze
prove	dimostrare
discovered	scoperto
wings	Ali
genetic	genetico
restrictions	restrizioni
thin	magro
exhibition	esposizione
ridge	cresta
modem	modem
bringing	portando
sick	malato
evaluate	valutare
tropical	tropicale
collect	raccogliere
vector	vettore
definitely	decisamente
turning	svolta
existence	esistenza
commentary	commento
developments	sviluppi
immigration	immigrazione
destinations	destinazioni
mutual	reciproco
syntax	sintassi
li	Li
attribute	attributo
prison	prigione
skill	abilità
chairs	sedie
surrounding	circostante
mountains	montagne
popularity	popolarità
inquiry	inchiesta
checked	verificato
exhibit	mostra
throw	gettare
trend	tendenza
cats	gatti
desert	deserto
ya	ya
coordinator	coordinatore
mercury	mercurio
burning	ardente
escape	fuga
receiver	ricevitore
progressive	progressivo
boats	Barche
championship	campionato
arcade	portico
impossible	impossibile
tells	dice
obvious	evidente
depression	depressione
graph	grafico
covering	copertura
platinum	platino
judgment	giudizio
talks	trattativa
filing	limatura
foster	adottivo
awarded	premiato
trials	prove
masters	maestri
cartridge	cartuccia
explanation	spiegazione
org	org
fraud	frode
electricity	elettricità
spectrum	spettro
arrival	arrivo
pottery	ceramica
emphasis	enfasi
awesome	eccezionale
confirmed	confermato
counts	conta
crash	schianto
lift	sollevamento
inter	Inter
heights	altezza
shadow	ombra
expense	spese
venture	avventurarsi
clinic	clinica
healing	guarigione
princess	Principessa
entering	entrare
packet	pacchetto
studios	studios
involvement	coinvolgimento
dad	papà
buttons	pulsanti
placement	posizionamento
observations	osservazioni
winners	vincitori
roads	strade
subsequent	successivo
yard	cortile
disclosure	rivelazione
establishment	istituzione
memories	ricordi
te	TE
creates	crea
faces	facce
tourist	turista
murder	omicidio
adequate	adeguato
senator	senatore
presentations	presentazioni
digest	digerire
dust	polvere
wiki	wiki
replaced	sostituito
radar	radar
losses	perdite
combat	combattere
reducing	riducendo
stopped	fermato
occupation	occupazione
closely	strettamente
radiation	radiazione
kings	re
shooting	tiro
ear	orecchio
flags	bandiere
baker	panettiere
conservative	prudente
shock	shock
effectiveness	efficacia
tie	cravatta
roof	tetto
demonstrate	dimostrare
atmosphere	atmosfera
kiss	bacio
beast	bestia
ra	RA
operated	operato
experiment	sperimentare
targets	obiettivi
purchases	acquisti
federation	federazione
pizza	Pizza
invited	invitato
assignment	assegnazione
mod	mod
queries	interrogazioni
absence	assenza
vendors	fornitori
yoga	yoga
serves	servi
surprise	sorpresa
lamp	lampada
jokes	scherzi
counseling	consulenza
palace	palazzo
satisfied	soddisfatto
wins	vittorie
warehouse	magazzino
supposed	ipotetico
ordinary	ordinario
ghost	fantasma
violation	violazione
boss	capo
pride	orgoglio
expectations	aspettative
independence	indipendenza
knowing	sapendo
reporter	reporter
metabolism	metabolismo
champion	campione
personally	personalmente
plenty	abbondanza
solo	assolo
throat	gola
wealth	ricchezza
vacuum	vuoto
dancing	danza
recognize	riconoscere
writes	scrive
plaza	plaza
quest	ricerca
publish	pubblicare
screening	selezione
trans	trans
pioneer	pioniere
forgotten	dimenticato
acrobat	acrobata
plates	piatti
essays	saggi
behaviour	comportamento
telling	raccontare
fairly	abbastanza
intelligent	intelligente
modes	modalità
obligation	obbligo
harbor	porto
traveler	viaggiatore
segment	segmento
enemy	nemico
puzzle	puzzle
wells	pozzi
restricted	limitato
republican	repubblicano
secrets	segreti
syndrome	sindrome
attendance	partecipazione
penalty	pena
drum	tamburo
enables	Abilita
builder	costruttore
vista	vista
flood	alluvione
ease	alleviare
arguments	argomenti
arena	arena
adventures	avventure
pupils	allievi
announcement	annuncio
outcome	risultato
appreciate	apprezzare
expanded	allargato
grown	cresciuto
lovely	bello
centres	centri
clause	clausola
smile	Sorriso
lands	terre
troops	truppe
armed	armato
pine	pino
cooling	raffreddamento
gulf	golfo
trucks	camion
mechanisms	meccanismi
divorce	divorzio
tradition	tradizione
pills	pillole
tiger	tigre
folks	gente
sensor	sensore
exposed	esposto
hunt	caccia
angels	angeli
deputy	vice
thai	tailandese
emissions	emissioni
physicians	medici
complaint	denuncia
scenes	scene
experiments	esperimenti
boost	Incremento
governance	governo
mill	mulino
founded	fondato
chronic	cronico
den	tana
finger	dito
keeps	mantiene
pound	libbra
locate	individuare
pl	pl
trained	allenato
implementing	attuazione
bread	pane
motors	motori
tough	difficile
incident	incidente
dynamics	dinamica
lie	menzogna
conversation	conversazione
decrease	diminuire
worship	culto
capability	capacità
ak	ak
precision	precisione
damages	danni
reserves	riserve
solve	risolvere
minority	minoranza
diverse	diverso
ingredients	ingredienti
ah	ah
tones	toni
rehabilitation	reinserimento
sight	vista
clay	argilla
weak	debole
divided	diviso
reception	ricezione
wise	saggio
odds	probabilità
seminars	seminari
consequences	conseguenze
makers	maker
geography	geografia
integrity	integrità
legacy	eredità
pleased	contento
danger	Pericolo
vitamin	vitamina
processed	trasformati
phrase	frase
raising	raccolta
implications	implicazioni
functionality	funzionalità
paradise	Paradiso
hybrid	ibrido
reads	legge
emotional	emotivo
glory	gloria
ja	ja
geographic	geografico
exceed	superare
rod	asta
silk	seta
babies	bambini
bi	bi
romantic	romantico
revealed	rivelato
specialists	specialisti
generator	Generatore
suspension	sospensione
sad	triste
correction	correzione
wolf	lupo
slowly	lentamente
supplement	supplemento
portions	porzioni
infant	infantile
sectors	settori
fluid	fluido
grounds	motivo
meal	pasto
ta	ta
machinery	macchinario
equation	equazione
baskets	cesti
probability	probabilità
dimension	dimensione
studied	studiato
profits	profitti
devil	diavolo
grass	erba
illustrated	illustrato
cherry	ciliegia
continental	continentale
achievement	realizzazione
limitations	limitazioni
funeral	funerale
chapters	capitoli
passenger	passeggeri
convenient	conveniente
mars	Marte
sized	dimensioni
egg	uovo
signals	segnali
orientation	orientamento
theft	furto
childhood	infanzia
symbols	simboli
lat	lat
meta	meta
analog	analogico
talent	talento
dated	datato
wisdom	saggezza
boundary	confine
elite	elite
gi	gi
believes	crede
poems	poesie
jurisdiction	Giurisdizione
robot	robot
displaying	visualizzazione
witness	testimone
equipped	fornito
stages	stadi
sur	sur
acquired	acquisita
assess	valutare
wash	lavaggio
entrance	Ingresso
declaration	dichiarazione
losing	perdere
attempts	tentativi
noble	nobile
automation	automazione
impacts	impatti
rev	rev
advantages	vantaggi
knight	cavaliere
aims	obiettivi
extensions	estensioni
appeals	appelli
illness	malattia
ho	Ho
alternatives	alternative
sh	sh
soap	sapone
jam	marmellata
unusual	insolito
answered	risponde
destruction	distruzione
migration	migrazione
disorder	disturbo
conventional	convenzionale
wearing	indossare
axis	asse
sought	ricercato
genes	geni
median	mediano
scanner	scanner
herein	qui
animated	animato
adjustment	registrazione
hero	eroe
treatments	trattamenti
attitude	atteggiamento
carpet	tappeto
lenses	lenti
attended	frequentato
difficulty	difficoltà
punk	punk
coalition	coalizione
enrollment	iscrizione
duke	duca
pace	ritmo
producers	produttori
arc	arco
interfaces	interfacce
atlas	atlante
observation	osservazione
torture	tortura
deleted	cancellato
coat	cappotto
restoration	restauro
convenience	convenienza
returning	ritorno
opposition	opposizione
container	contenitore
defendant	imputato
supervisor	supervisore
corps	corpo
actors	attori
liver	fegato
liable	responsabile
petition	petizione
antenna	antenna
picked	raccolto
belief	credenza
killing	uccisione
shoulder	spalla
decor	arredamento
ion	ione
diameter	diametro
podcast	Podcast
interactions	interazioni
singer	cantante
herald	araldo
aging	invecchiamento
intervention	intervento
plugin	collegare
attraction	attrazione
diving	immersione
modification	modifica
suppose	supporre
reed	canna
involve	coinvolgere
moderate	moderare
mice	topi
understood	inteso
rapidly	rapidamente
ban	bandire
assurance	garanzia
happening	avvenimento
vast	vasto
mills	mulini
outline	contorno
receives	riceve
jeans	jeans
compilation	compilazione
odd	dispari
sigma	sigma
gr	gr
attractive	attraente
occasion	occasione
recordings	registrazioni
victim	vittima
demands	richieste
careful	attento
beam	fascio
gardening	giardinaggio
obligations	obblighi
arrive	arrivo
orchestra	orchestra
licence	licenza
adjustable	regolabile
allocation	assegnazione
essay	tema
demonstrated	dimostrato
dialogue	dialogo
camps	campi
declared	dichiarato
trace	traccia
shut	chiuso
packs	confezioni
