of	od
to	do
in	u
for	za
is	je
on	na
that	da
by	po
this	ovaj
with	s
i	ja
you	vas
it	to
or	ili
be	biti
are	su
at	na
all	svi
have	imati
new	novi
we	mi
will	htjeti
home	Dom
us	nas
about	oko
if	ako
page	stranica
my	moj
has	ima
search	traži
free	besplatno
but	ali
our	naše
one	jedan
other	drugo
do	čini
information	informacija
time	vrijeme
he	on
which	koji
their	njihov
news	vijesti
use	koristiti
there	tamo
see	vidjeti
so	tako
who	tko
web	mreža
also	također
get	dobiti
pm	pm
view	pogled
c	c
e	e
first	prvi
been	bila
would	bi
were	su
s	a
like	Kao
x	x
than	od
find	pronaći
price	cijena
back	leđa
top	vrh
people	narod
had	imala
list	popis
name	Ime
just	samo
year	godina
day	dan
into	u
two	dva
health	zdravlje
n	n
re	ponovno
used	koristi
go	ići
b	b
last	posljednji
make	napraviti
them	ih
should	treba
product	proizvod
system	sistem
post	pošta
her	nju
city	Grad
t	t
policy	politika
number	broj
support	podrška
message	poruka
after	nakon
then	zatim
jan	siječanj
good	dobro
d	d
where	gdje
info	Informacije
rights	prava
books	knjige
high	visok
school	škola
m	m
each	svaki
links	linkovi
she	ona
years	godine
order	narudžba
very	vrlo
book	knjiga
items	stavke
company	društvo
r	r
read	čitati
group	skupina
sex	seks
many	mnogi
user	korisnik
de	de
set	set
general	general
research	istraživanje
university	sveučilište
january	siječanj
mail	pošta
full	puni
reviews	recenzije
program	program
know	znati
games	igre
way	put
days	dana
p	p
part	dio
could	mogao
great	Sjajno
united	ujedinjen
real	stvaran
f	f
international	međunarodna
center	centar
travel	putovati
comments	komentari
made	napravljen
development	razvoj
report	izvješće
member	član
details	detalji
line	crta
terms	Pojmovi
before	prije
hotels	hoteli
did	učinio
send	poslati
right	pravo
type	tip
local	lokalne
those	oni
results	rezultati
office	ured
national	nacionalna
car	automobil
design	dizajn
take	uzeti
posted	objavljeno
address	adresa
community	zajednica
within	unutar
states	Države
want	željeti
phone	telefon
dvd	DVD
subject	predmet
between	između
forum	forum
family	obitelj
l	l
long	dugo
w	w
show	pokazati
o	o
even	čak
black	crno
special	poseban
index	indeks
being	biće
women	žene
much	mnogo
sign	znak
file	datoteka
link	veza
open	otvoren
south	jug
case	slučaj
project	projekt
pages	stranica
version	verzija
section	odjeljak
own	vlastiti
house	kuća
security	sigurnosti
g	g
county	okrug
american	američki
photo	foto
game	igra
members	članovi
power	vlast
network	mreža
computer	Računalo
systems	sustavi
three	tri
place	mjesto
end	kraj
h	h
him	mu
per	po
access	pristup
think	razmišljati
north	sjeverno
resources	resursi
current	Trenutno
big	velik
media	media
law	zakon
control	kontrolirati
water	voda
history	povijest
size	veličina
personal	osobni
guide	vodič
shop	dućan
directory	imenik
change	promijeniti
white	bijela
text	tekst
small	mali
rating	klijenata
rate	stopa
government	vlada
children	djeca
return	povratak
students	studenti
v	v
account	račun
times	puta
level	nivo
digital	digitalni
profile	profil
previous	prijašnji
form	oblik
events	događaji
love	ljubav
old	star
john	Ivan
main	glavni
call	poziv
image	slika
department	odjel
title	titula
non	ne
k	k
y	y
insurance	osiguranje
shall	treba
property	svojstvo
class	klasa
cd	CD
quality	kvaliteta
every	svaki
listing	spisak
content	sadržaj
country	zemlja
little	malo
tools	alat
low	nizak
reply	odgovor
customer	kupac
december	prosinac
compare	usporediti
movies	filmovi
college	koledž
value	vrijednost
article	članak
man	čovjek
jobs	poslovi
j	j
food	hrana
author	Autor
different	drugačiji
u	u
learn	naučiti
sale	prodaja
print	otisak
course	tečaj
job	posao
room	soba
stock	zaliha
training	trening
too	isto
credit	Kreditna
point	točka
science	znanost
men	muškarci
categories	kategorije
west	Zapad
look	izgled
english	Engleski
team	tim
estate	imanje
box	kutija
conditions	Uvjeti
photos	fotografije
gay	homoseksualac
thread	nit
category	kategorija
note	Bilješka
live	uživo
large	veliki
gallery	galerija
table	stol
however	međutim
june	lipanj
october	listopad
november	studeni
market	tržište
library	knjižnica
action	akcijski
start	početak
series	niz
features	značajke
air	zrak
industry	industrija
plan	plan
human	ljudski
yes	Da
second	drugi
hot	vruće
cost	cijena
movie	film
forums	forumi
march	ožujak
la	la
september	rujan
say	reći
going	odlazak
medical	medicinski
friend	prijatelj
dec	prosinca
server	server
application	primjena
staff	osoblje
play	igra
issues	pitanja
april	travanj
users	Korisnici
street	ulica
topic	tema
against	protiv
got	dobio
blog	blog
party	Zabava
payment	plaćanje
equipment	oprema
let	pustiti
programs	programi
legal	pravni
recent	nedavni
park	park
act	čin
problem	problem
red	Crvena
give	dati
memory	memorija
performance	izvođenje
social	socijalni
q	q
story	priča
sell	prodavati
options	opcije
experience	iskustvo
key	ključ
body	tijelo
young	mladi
important	važno
field	polje
few	nekoliko
east	istočno
single	singl
ii	ii
age	dob
club	klub
example	primjer
girls	djevojke
z	z
road	cesta
gift	dar
question	pitanje
ca	ca
hard	teško
pay	platiti
four	četiri
poker	poker
issue	problem
range	opseg
building	zgrada
seller	prodavač
court	sud
february	veljača
result	proizlaziti
light	svjetlo
write	pisati
war	rat
offer	ponuda
blue	plava
groups	grupe
al	al
easy	lako
given	dan
request	zahtjev
fax	faks
china	Kina
making	izrađivanje
picture	slika
needs	potrebe
possible	moguće
month	mjesec
major	glavni
star	zvijezda
future	budućnost
space	prostor
committee	odbor
hand	ruka
sun	Sunce
cards	kartice
london	London
meeting	sastanak
become	postati
child	dijete
keep	zadržati
porn	pornografija
share	udio
similar	sličan
garden	vrt
schools	škola
million	milijuna
added	dodano
reference	upućivanje
companies	tvrtke
baby	dijete
learning	učenje
energy	energija
run	trčanje
delivery	dostava
popular	popularan
term	termin
film	film
stories	priče
put	staviti
journal	časopis
reports	izvještaji
co	ko
try	probati
images	slika
notice	obavijest
god	bog
original	izvornik
head	glava
radio	radio
cell	ćelija
council	vijeće
includes	uključuje
track	staza
discussion	rasprava
archive	arhiva
others	drugi
agreement	sporazum
format	format
society	društvo
months	mjeseci
safety	sigurnosni
friends	prijatelji
sure	Naravno
edition	izdanje
messages	poruke
marketing	Marketing
tell	reći
association	asocijacija
provides	pruža
fun	zabava
already	već
green	zelena
studies	studije
close	Zatvoriti
common	uobičajen
specific	specifično
several	nekoliko
living	život
collection	kolekcija
called	zvao
short	kratak
arts	umjetnost
lot	mnogo
ask	pitati
limited	ograničen
solutions	rješenja
director	direktor
beach	plaža
past	prošlost
natural	prirodni
electronics	elektronika
upon	na
period	razdoblje
planning	planiranje
says	kaže
official	službeno
mar	pokvariti
done	učinio
technical	tehnička
window	prozor
pro	profesionalac
region	regija
island	otoka
record	snimiti
direct	direktno
conference	konferencija
records	ploče
st	st
district	okrug
calendar	kalendar
costs	troškovi
style	stil
statement	izjava
miles	milja
resource	resurs
applications	aplikacije
document	dokument
word	riječ
works	djela
material	materijal
bill	račun
written	napisan
rules	pravila
final	konačni
thing	stvar
centre	centar
requirements	zahtjevi
TRUE	PRAVI
minutes	minuta
else	drugo
mark	ocjena
rock	stijena
bad	loše
individual	pojedinac
plus	plus
auto	auto
cover	pokriti
edit	Uredi
together	zajedno
videos	video
fast	brzo
function	funkcija
fact	činjenica
getting	uzimajući
global	globalno
tech	tech
meet	sastati
far	daleko
economic	ekonomski
en	hr
player	igrač
projects	projekti
amount	iznos
watch	Gledati
included	uključen
feel	osjetiti
bank	banka
risk	rizik
deals	Popularna
various	raznovrstan
words	riječi
production	proizvodnja
commercial	trgovački
weight	težina
heart	srce
treatment	liječenje
points	bodova
knowledge	znanje
magazine	časopis
error	greška
camera	fotoaparat
girl	djevojka
construction	izgradnja
toys	igračke
registered	zabilježen
domain	domena
methods	metode
chapter	poglavlje
protection	zaštita
policies	politika
wide	širok
beauty	ljepota
manager	menadžer
india	Indija
position	položaj
taken	poduzete
sort	vrsta
listings	oglasi
known	znan
half	pola
cases	slučajevi
step	korak
engineering	inženjering
simple	jednostavan
quick	brz
license	licenca
lake	jezero
whole	čitav
annual	godišnji
published	Objavljeno
church	crkva
method	način
active	aktivan
response	odgovor
figure	lik
materials	materijali
enough	dovoljno
designed	konstruiran
among	među
death	smrt
loss	gubitak
face	lice
brand	marka
discount	popust
effects	efekti
created	stvorio
standards	standardi
bit	bit
political	politički
kingdom	kraljevstvo
base	baza
doing	rade
loans	krediti
shoes	cipele
entry	ulaz
stay	boravak
orders	narudžbe
availability	dostupnost
summary	Sažetak
turn	skretanje
growth	rast
agency	agencija
king	kralj
european	europska
activity	aktivnost
copy	kopirati
western	zapadni
force	sila
employment	zapošljavanje
bay	zaljev
river	Rijeka
commission	komisija
package	paket
seen	vidio
players	igrači
engine	motor
port	luka
album	album
regional	Regionalni
stop	Stop
started	počeo
administration	uprava
bar	bar
institute	institut
views	pregleda
double	dvostruko
dog	pas
soon	uskoro
lines	linije
electronic	elektronička
benefits	prednosti
needed	potreban
printer	printer
condition	stanje
effective	djelotvoran
believe	vjerovati
organization	organizacija
effect	posljedica
mind	um
selection	izbor
casino	kasino
pdf	pdf
tour	obilazak
cross	križ
hope	nada
corporation	korporacija
wish	želja
solution	riješenje
mature	zreo
role	uloga
weeks	tjedni
certain	siguran
lower	niži
necessary	potreban
union	unija
mon	mon
com	com
particular	posebno
fine	fino
hour	sat
gas	plin
skills	vještine
six	šest
bush	grm
islands	otoci
advice	savjet
career	karijera
decision	odluka
leave	napustiti
pre	prije
huge	ogroman
woman	žena
facilities	postrojenja
bid	ponuda
middle	srednji
cable	kabel
opportunities	prilike
taking	uzimanje
values	vrijednosti
division	podjela
coming	dolazak
object	objekt
lesbian	lezbijka
appropriate	prikladan
machine	mašina
logo	logo
length	dužina
nice	Lijepo
score	postići
statistics	statistika
client	klijent
sample	uzorak
investment	ulaganje
sent	poslao
shown	prikazan
christmas	Božić
culture	Kultura
flash	bljesak
ms	ms
choice	izbor
courses	tečajevi
consumer	potrošač
hi	bok
foreign	strana
artist	umjetnik
furniture	namještaj
channel	kanal
letter	pismo
mode	način
phones	telefoni
ideas	ideje
structure	struktura
degree	stupanj
contract	ugovor
super	super
male	muški
matter	stvar
almost	skoro
located	nalazi
multiple	višekratnik
distribution	distribucija
editor	urednik
inn	gostionica
industrial	industrijski
potential	potencijal
song	pjesma
los	los
fall	pad
idea	ideja
rooms	sobe
communications	komunikacije
win	pobijediti
primary	osnovni
cancer	Rak
numbers	brojevi
reason	razlog
tool	alat
spring	Proljeće
foundation	temelj
answer	odgovor
voice	glas
schedule	raspored
documents	dokumenti
purpose	Svrha
feature	svojstvo
bed	krevet
comes	dolazi
police	policija
independent	samostalan
approach	pristup
brown	smeđ
physical	fizička
hill	brdo
maps	Karte
hold	držati
ratings	ocjene
happy	sretan
smith	kovač
developed	razvijen
thank	zahvaliti
safe	sef
unique	jedinstvena
survey	pregled
prior	prije
telephone	telefon
sport	sport
ready	spreman
animal	životinja
sources	izvori
population	populacija
pa	godišnje
regular	redovan
secure	siguran
operations	operacije
simply	jednostavno
evidence	dokaz
station	stanica
understand	razumjeti
option	opcija
valley	dolina
probably	vjerojatno
sea	more
publications	publikacije
improve	poboljšati
connection	veza
publisher	izdavač
hall	dvorana
anti	anti
networks	mreže
earth	Zemlja
parents	roditelji
impact	udarac
transfer	prijenos
introduction	Uvod
kitchen	kuhinja
strong	jak
wedding	vjenčanje
properties	nekretnine
hospital	bolnica
ground	tlo
ship	brod
accommodation	smještaj
disease	bolest
excellent	izvrstan
perfect	savršen
hair	dlaka
opportunity	prilika
kit	oprema
classic	klasik
basis	osnova
command	naredba
cities	gradovi
express	izraziti
award	dodijeliti
distance	udaljenost
tree	drvo
assessment	procjena
wall	zid
involved	umiješan
el	el
extra	ekstra
especially	posebno
budget	budžet
guides	vodiči
success	uspjeh
maximum	maksimum
ma	majka
operation	operacija
existing	postojanje
quite	dosta
selected	odabran
boy	dječak
restaurants	restorani
beautiful	lijep
warning	upozorenje
locations	lokacije
horse	konj
vote	glasanje
flowers	cvijeće
stars	zvijezde
lists	arena
owner	vlasnik
animals	životinje
ways	načine
son	sin
providing	pružanje
rule	Pravilo
housing	kućište
takes	traje
bring	donijeti
catalog	katalog
max	maksimum
mother	majka
authority	vlast
told	rekao
programme	program
joined	spojen
input	ulazni
strategy	strategija
feet	noge
agent	agent
valid	vrijedi
modern	moderan
senior	stariji
sexy	seksi
teaching	nastava
door	vrata
grand	veličanstven
trial	suđenje
units	jedinice
cool	svjež
normal	normalan
enterprise	poduzeće
ships	brodovi
entire	čitav
positive	pozitivan
fitness	sposobnost
chinese	kineski
opinion	mišljenje
football	nogomet
abstract	sažetak
output	izlaz
funds	fondovi
mr	mr
likely	Vjerojatno
develop	razviti
artists	izvođači
alternative	alternativa
responsibility	odgovornost
java	Java
guest	gost
publication	objavljivanje
pass	proći
relations	odnosi
trust	povjerenje
van	kombi
contains	sadrži
multi	multi
republic	republika
fees	naknada
components	komponente
vacation	odmor
century	stoljeće
academic	akademski
assistance	pomoć
completed	dovršen
skin	koža
graphics	grafika
indian	Indijanac
ring	prsten
grade	razred
mountain	planina
organizations	organizacija
filter	filtar
panel	ploča
floor	kat
buying	kupovina
match	utakmica
proposed	zaprosio
require	zahtijevati
boys	dječaci
morning	jutro
allows	omogućuje
protein	protein
plant	biljka
reported	izvijestio
hit	pogoditi
mm	mm
pool	bazen
mini	mini
politics	politika
partner	partner
authors	autori
boards	ploče
fish	riba
membership	članstvo
mission	misija
eye	oko
string	niz
sense	osjećaj
modified	promijenjen
released	oslobođen
stage	faza
internal	interni
born	rođen
detailed	detaljan
japanese	japanski
race	utrka
approved	odobren
target	cilj
except	osim
character	lik
maintenance	održavanje
ability	sposobnost
ed	ed
rape	silovanje
battery	baterija
youth	mladež
pressure	pritisak
submitted	podnijeti
debt	dug
medium	srednji
television	televizija
interested	zainteresiran
core	srž
break	pauza
purposes	svrhe
sets	setovi
dance	ples
wood	drvo
defined	definiran
papers	novine
awards	nagrade
fee	pristojba
studio	studio
reader	čitač
device	uređaj
established	osnovan
answers	odgovori
rent	najam
las	las
dark	mrak
external	vanjski
apple	jabuka
le	le
instructions	instrukcije
min	min
offered	ponudio
theory	teorija
remove	ukloniti
aid	pomoć
visual	vidni
host	domaćin
variety	raznolikost
teachers	učitelji
manual	priručnik
block	blok
subjects	teme
agents	agenti
repair	popravak
fair	pravedan
steel	željezo
understanding	razumijevanje
songs	Pjesme
fixed	fiksni
wrong	pogrešno
beginning	početak
hands	ruke
az	AZ
paris	Pariz
gets	dobiva
sector	sektor
capacity	kapacitet
un	uN
fat	mast
father	otac
electric	električni
saw	pila
instruments	instrumenti
officer	časnik
driver	vozač
businesses	poduzeća
dead	mrtav
unknown	nepoznat
restaurant	restoran
mike	mikrofon
trip	putovanje
mi	mi
poor	siromašan
relationship	odnos
workers	radnici
peace	mir
traditional	tradicionalan
showing	pokazivanje
creative	kreativan
coast	obala
benefit	korist
funding	financiranje
devices	uređaji
lord	gospodar
grant	odobriti
sub	pod
fiction	fikcija
watches	satovi
careers	karijere
goes	ide
led	vodio
museum	muzej
fan	ventilator
transport	prijevoz
interesting	zanimljiv
blogs	blogovi
evaluation	procjena
former	prijašnji
zone	zona
complex	kompleks
th	th
cat	mačka
die	umrijeti
presented	predstavili
flat	ravan
flow	teći
agencies	agencije
literature	književnost
parent	roditelj
setting	postavljanje
dr	doktor
scale	ljestvica
economy	Ekonomija
helpful	koristan
monthly	mjesečno
critical	kritično
frame	okvir
musical	mjuzikl
definition	definicija
secretary	tajnica
path	staza
chief	glavni
gives	daje
packages	paketi
detail	detalj
laws	zakoni
changed	promijenjen
begin	početi
royal	kraljevski
clean	čist
guy	momak
titles	naslovi
relevant	relevantan
justice	pravda
connect	Spojiti
cup	kupa
basket	košara
applied	primijenjen
weekly	tjedni
vol	vol
installation	montaža
pp	str
attention	pažnja
advance	napredovati
skip	preskočiti
diet	dijeta
army	vojska
gear	zupčanik
difference	razlika
allowed	dopušteno
correct	ispravan
nation	narod
selling	prodaja
lots	mnogo
piece	komad
sheet	list
firm	firma
seven	sedam
elements	elementi
species	vrsta
jump	skok
cells	Stanice
module	modul
resort	pribjeći
certificate	potvrda
minister	ministar
motion	pokret
fashion	moda
directions	smjerovi
visitors	posjetitelji
documentation	dokumentacija
trading	trgovački
forest	šuma
calls	pozivi
coverage	pokrivenost
couple	par
giving	davanje
chance	prilika
vision	vizija
ball	lopta
ending	završni
clients	klijenti
actions	akcije
discuss	raspravljati
goal	cilj
successful	uspješan
sold	prodan
wind	vjetar
communities	zajednice
clinical	klinički
situation	situacija
markets	tržišta
publishing	objavljivanje
appear	pojaviti
developing	razvoju
lives	život
determine	odrediti
temperature	temperatura
announcements	najave
patient	pacijent
actual	stvaran
historical	povijesni
stone	kamen
bob	bob
commerce	trgovina
persons	osobe
difficult	težak
scientific	znanstvena
satellite	satelit
tests	testovi
village	selo
accounts	računi
amateur	amater
ex	ex
met	sastali
pain	bol
factors	čimbenici
coffee	kava
buyer	kupac
poster	poster
edge	rub
functional	funkcionalna
root	korijen
fi	fi
closed	zatvoreno
holidays	Praznici
pink	ružičasta
balance	ravnoteža
monitoring	nadgledanje
replies	odgovora
shot	šut
initial	početni
label	označiti
sec	sek
canon	kanon
league	liga
waste	gubljenje
minute	minuta
bus	autobus
provider	usluga
dictionary	rječnik
accounting	računovodstvo
manufacturing	proizvodnja
sections	dijelovi
chair	stolica
effort	napor
phase	faza
fantasy	fantazija
po	PO
va	va
professor	profesor
install	instalirati
shirt	košulja
apparel	odjeća
foot	noga
breast	grudi
techniques	Tehnike
dollars	dolara
religion	religija
permission	dopuštenje
wild	divlji
generation	generacija
miss	propustiti
chemical	kemijski
doctor	liječnik
task	zadatak
reduce	smanjiti
brought	donio
exercise	vježba
bug	buba
guarantee	jamčiti
leader	vođa
se	sebi
processes	procesi
soft	mekan
meetings	sastanci
seconds	sekundi
flight	let
congress	kongres
fuel	gorivo
walk	hodati
produced	izrađen
saint	svetac
argument	argument
competition	konkurencija
drugs	lijekovi
joint	zajednički
premium	premija
fresh	svježe
characters	likovi
attorney	pravnik
di	di
factor	faktor
thousands	tisuća
km	km
stream	potok
apartments	apartmani
pick	odabrati
hearing	sluh
eastern	istočni
therapy	terapija
entries	unosi
signed	potpisan
administrative	upravni
serious	ozbiljan
limit	ograničiti
steps	koraci
shops	trgovine
bondage	ropstvo
del	del
efforts	napori
informed	informiran
ga	gA
thoughts	misli
creek	potok
ft	ft
quantity	količina
essential	osnovni
tours	ture
load	opterećenje
immediately	odmah
machines	strojevi
designated	određen
heavy	teško
covered	pokriven
recovery	oporavak
integrated	integriran
configuration	konfiguracija
cock	penis
merchant	trgovac
comprehensive	opsežan
expert	stručnjak
protect	zaštititi
solid	solidan
presentation	prezentacija
became	postao
orange	narančasta
compliance	usklađenost
theme	tema
rich	bogat
campaign	kampanja
vs	vs
guitar	gitara
finding	nalaz
examples	primjeri
spirit	duh
ar	ar
claims	zahtjevi
acceptance	prihvaćanje
strategies	strategije
mo	mj
affairs	poslovi
intended	namijenjen
sa	sa
goals	ciljevi
hire	najam
election	izbor
suggest	predložiti
branch	podružnica
serve	poslužiti
affiliates	podružnice
mount	montiranje
latin	latinski
multimedia	multimedijalni
manage	upravljati
corner	ugao
rank	rang
element	element
birth	rođenja
virus	virus
interactive	interaktivni
requests	zahtjevi
separate	odvojen
quarter	četvrtina
procedure	postupak
leadership	rukovodstvo
define	definirati
religious	vjerski
facts	činjenicama
breakfast	doručak
column	kolona
faith	vjera
chain	lanac
identify	identificirati
avenue	avenija
missing	nedostaje
recommendations	preporuke
moved	pomaknuto
reach	dohvatiti
comparison	usporedba
moment	trenutak
extended	produžen
sequence	slijed
inch	palac
attack	napad
centers	centri
opening	otvor
lab	laboratorija
reserve	rezerva
gamma	gama
produce	proizvoditi
truth	istina
counter	brojač
failure	neuspjeh
follows	slijedi
dollar	dolar
camp	kamp
des	des
films	filmovi
bridge	most
fill	ispuniti
movement	pokret
printing	tiskanje
draft	Nacrt
chart	grafikon
played	igrao
contacts	kontakti
readers	čitači
clubs	klubovi
wa	wa
adventure	avantura
offering	ponuda
profit	dobit
leaders	čelnici
posters	plakati
institutions	institucije
assistant	asistent
variable	varijabla
dj	dj
parking	parkiralište
yesterday	jučer
determined	odlučan
workshop	radionica
gone	otišao
codes	kodovi
kinds	vrste
extension	nastavak
statements	izjava
completely	potpuno
teams	timovi
fort	tvrđava
cm	cm
senate	senat
funny	smiješno
gene	gen
turned	okrenut
disc	disk
pattern	uzorak
boat	čamac
theatre	kazalište
manufacturers	proizvođači
sponsor	sponzor
classical	klasična
icon	ikona
warranty	garancija
dedicated	posvećen
direction	smjer
basketball	košarka
objects	objekti
delete	izbrisati
evening	večer
assembly	skupština
nuclear	nuklearni
mouse	miš
signal	signal
criminal	kriminalac
issued	izdaje
powerful	snažan
dream	san
FALSE	NETOČNO
da	da
cast	baciti
flower	cvijet
personnel	osoblje
passed	prošao
supplied	isporučuje
falls	Slapovi
soul	duša
promote	unaprijediti
stated	navedeno
stats	statistika
professionals	profesionalci
appears	Čini
carry	nositi
flag	zastava
covers	korice
em	em
advantage	prednost
hello	zdravo
designs	dizajna
maintain	održavati
tourism	turizam
priority	prioritet
adults	odrasli
graphic	grafički
atom	atom
payments	plaćanja
binding	vezivanje
brief	kratak
ended	završeno
winning	osvajanjem
anonymous	anoniman
script	skripta
served	služio
wants	želi
prepared	pripremljen
void	poništiti
tag	označiti
interview	intervju
mix	miješati
framework	okvir
disk	disk
installed	instaliran
queen	kraljica
credits	krediti
clearly	jasno
fix	popraviti
handle	rukovati
sweet	slatko
criteria	kriteriji
associate	suradnik
ne	NE
behavior	ponašanje
enlarge	uvećati
ray	zraka
revenue	prihod
measure	mjera
votes	glasova
du	du
duty	dužnost
discussions	rasprave
bear	snositi
gain	dobit
festival	festival
laboratory	laboratorija
ocean	ocean
flights	letovi
experts	stručnjaci
signs	znakovi
depth	dubina
train	vlak
dry	suho
explore	istražiti
spa	banja
concept	koncept
nearly	skoro
handling	rukovanje
origin	podrijetlo
billion	milijardi
intelligence	inteligencija
bought	kupio
con	protiv
nations	nacije
route	put
broken	slomljen
battle	bitka
speak	govoriti
protocol	protokol
query	pitanje
partnership	partnerstvo
expression	izraz
es	es
speech	govor
wire	žica
suggestions	prijedlozi
replacement	zamjena
tape	traka
strategic	strateški
judge	suditi
acid	kiselina
bytes	bajtova
cent	cent
forced	prisiljeni
compatible	kompatibilan
apartment	apartman
null	nula
zero	nula
speaker	zvučnik
consulting	savjetodavni
designer	dizajner
pr	pr
marriage	brak
roll	svitak
banks	banke
fr	fr
participants	sudionici
secret	tajna
negative	negativan
favorites	favoriti
theater	kazalište
springs	izvori
var	var
perform	izvesti
translation	prijevod
estimates	procjene
injury	ozljeda
ministry	ministarstvo
drivers	vozači
lawyer	odvjetnik
figures	figure
protected	zaštićen
proposal	prijedlog
sharing	dijeljenje
portal	portal
beta	beta
gratis	besplatno
toward	prema
slightly	malo
assist	pomoći
conduct	ponašanje
contained	sadržane
legislation	zakonodavstvo
calling	zvanje
parameters	parametri
profiles	profili
matters	pitanja
houses	kuća
controls	kontrole
combined	kombinirana
ultimate	ultimativno
representative	predstavnik
minor	manji
departments	odjeli
residents	stanovnici
displayed	prikazati
mom	mama
reduced	smanjen
rare	rijedak
performed	izvedena
extreme	krajnost
samples	uzorci
bars	barovi
forecast	prognoza
removed	ukloniti
cycle	ciklus
contain	sadržati
accuracy	točnost
sleep	spavati
mg	mg
bird	ptica
pharmacy	ljekarna
creation	stvaranje
static	statički
hunter	Lovac
addresses	adrese
lady	dama
crystal	kristal
famous	poznat
writer	pisac
chairman	predsjednik
drink	piće
academy	akademija
dynamic	dinamičan
eat	jesti
permanent	trajan
cleaning	čišćenje
constitutes	tvori
portfolio	portfelj
practical	praktičan
delivered	isporučena
infrastructure	infrastruktura
colour	boja
vendor	prodavač
philosophy	filozofija
regulation	regulacija
officers	službenici
aim	cilj
bids	ponude
nutrition	ishrana
recording	snimanje
junior	mlađi
les	les
cape	rt
rings	prstenovi
tip	Savjet
wonderful	predivan
ticket	ulaznica
announced	najavio
guess	nagađati
whom	kome
soccer	nogomet
math	matematika
import	uvoz
posting	postavljanje
presence	prisutnost
automatic	automatski
viewing	gledanja
maintained	održavati
ch	CH
dan	Dan
dogs	psi
directors	direktori
aspects	aspekti
ahead	naprijed
moon	mjesec
participation	sudjelovanje
scheme	shema
fly	letjeti
manner	držanje
matrix	matrica
combination	kombinacija
amendment	amandman
strength	snaga
turkey	purica
libraries	knjižnice
proper	ispravan
degrees	stupnjeva
enterprises	poduzeća
delta	delta
fear	strah
seeking	traži
inches	inča
convention	konvencija
shares	dionice
principal	glavni
comfort	udobnost
colors	boje
wars	ratovi
ordering	naručivanje
kept	čuva
alpha	alfa
appeal	apel
cruise	krstarenje
bonus	bonus
hey	ej
buildings	građevine
specials	specijalaca
beat	pobijediti
batteries	baterije
becomes	postaje
drives	diskovi
arms	oružje
tea	čaj
improved	poboljšan
achieve	postići
positions	pozicije
dress	haljina
subscription	pretplata
dealer	prodavač
contemporary	suvremeni
sky	nebo
rom	ROM
carried	prenosi
exposure	izlaganje
hide	sakriti
signature	potpis
miller	mlinar
provision	opskrba
clothes	odjeća
frames	okviri
certainly	sigurno
newspaper	novine
toy	igračka
layer	sloj
printed	tiskan
slow	usporiti
removal	uklanjanje
liability	odgovornost
printers	pisači
adding	dodajući
spot	mjesto
spend	potrošiti
factory	tvornica
interior	unutrašnjost
grow	rasti
optical	optički
promotion	promocija
relative	rođak
amazing	nevjerojatan
dot	točka
identity	identitet
conversion	pretvaranje
feeling	osjećaj
hidden	skriven
reasonable	razuman
revision	revizija
influence	utjecaj
ratio	omjer
importance	važnost
rain	kiša
planet	planeta
copies	kopije
permit	dozvola
seeing	vidim
proof	dokaz
bass	bas
prescription	recept
empty	prazan
instance	primjer
hole	rupa
ride	vožnja
bureau	zavod
conservation	konzervacija
pair	par
ideal	idealan
specs	naočale
recorded	zabilježena
don	Don
pieces	komada
finished	gotov
parks	parkovi
lawyers	odvjetnici
stress	stres
cream	krema
ss	ss
runs	radi
discover	otkriti
ap	ap
patterns	obrasci
hills	brda
nm	nm
advisor	savjetnik
aware	svjestan
shape	oblik
evolution	evolucija
certificates	potvrde
objectives	ciljevi
stations	stanice
suggested	predložio
op	op
remains	ostaci
firms	tvrtke
euro	euro
operator	operater
structures	strukture
generic	opći
encyclopedia	enciklopedija
usage	upotreba
ink	tinta
mixed	mješovit
census	popis
wheel	kotač
suppliers	dobavljači
compact	kompaktan
poetry	poezija
lights	svjetla
tracking	praćenje
angel	anđeo
preparation	priprema
attempt	pokušaj
receiving	primanje
matches	šibice
accordance	suglasnost
width	širina
engines	motori
forget	zaboraviti
array	red
discussed	raspravljati
accurate	točan
climate	klima
greek	grčki
instruction	instrukcija
managing	upravljanje
raw	sirov
differences	Razlike
explain	objasniti
establish	uspostaviti
expressed	izrazio
extent	opseg
sharp	oštar
ben	Ben
paragraph	stav
kill	ubiti
mathematics	matematika
compensation	kompenzacija
export	izvoz
managers	menadžeri
modules	moduli
conducted	provedena
versions	verzije
knows	zna
describe	opisati
citizens	građani
heritage	nasljeđe
trouble	nevolja
coach	trener
agricultural	poljoprivredni
expand	proširiti
audience	publika
assigned	dodijeljena
collections	zbirke
ages	dobi
specialist	specijalista
cook	kuhati
affect	utjecati
virgin	Djevica
experienced	iskusan
investigation	istraga
raised	uzdignut
hat	šešir
institution	institucija
directed	usmjerene
affected	pogođeni
bike	bicikl
totally	potpuno
plate	ploča
expenses	troškovi
indicate	naznačiti
blonde	plavuša
proceedings	postupak
favourite	ljubimac
characteristics	karakteristike
der	der
lose	izgubiti
organic	organski
seek	tražiti
experiences	iskustva
albums	albuma
contracts	ugovori
guests	gosti
hosted	domaćin
diseases	oboljenja
concerning	o
equivalent	ekvivalent
chemistry	kemija
kits	setove
logic	logika
prince	princ
circle	krug
soil	tlo
psychology	psihologija
wet	mokar
circumstances	okolnosti
investor	investitor
elementary	osnovni
sponsors	sponzori
fox	lisica
unlimited	neograničen
respond	odgovarati
sizes	veličine
plain	običan
exit	Izlaz
arm	ruka
keys	ključevi
wave	val
holy	svet
acts	djela
guidance	vođenje
trail	trag
symbol	simbol
highway	autocesta
observed	promatranom
dean	dekan
setup	postaviti
poll	anketa
styles	stilovi
filled	ispunjen
bond	veza
channels	kanali
appendix	dodatak
chocolate	čokolada
portion	dio
scope	djelokrug
supplier	dobavljač
cables	kabeli
cotton	pamuk
requirement	zahtjev
killed	ubijen
border	granica
ancient	antički
debate	debata
representatives	predstavnici
starts	počinje
pregnancy	trudnoća
attractions	atrakcije
learned	naučeno
transactions	transakcije
explorer	istraživač
historic	povijesni
husband	suprug
authorized	odobren
crazy	lud
upcoming	Nadolazeći
concert	koncert
scores	rezultate
efficiency	efikasnost
comedy	komedija
adopted	usvojen
efficient	učinkovit
linear	linearan
commitment	opredjeljenje
specialty	specijalitet
bears	medvjedi
hop	hmelj
carrier	prijevoznik
constant	konstantno
visa	Visa
mouth	usta
meter	metar
linked	povezan
interviews	razgovori
concepts	pojmovi
gun	puška
reflect	odraziti
pure	čist
hell	pakao
fruit	voće
begins	počinje
qualified	kvalificiran
reform	reforma
lens	leće
treated	liječi
discovery	otkriće
draw	crtati
classified	svrstan
assume	pretpostaviti
alliance	savez
confirm	potvrditi
engineer	inženjer
consistent	dosljedan
replace	zamijeniti
clearance	odobrenje
converter	konverter
organisation	organizacija
babe	dijete
checks	provjere
reached	postignut
becoming	postaje
objective	cilj
indicated	naznačeno
sugar	šećer
crew	posada
legs	noge
stick	štap
relation	odnos
enabled	omogućeno
genre	žanr
volunteer	dobrovoljac
rear	stražnji
democratic	demokratski
enhance	povećati
exact	točno
bound	granica
parameter	parametar
processor	procesor
node	čvor
formal	formalan
storm	oluja
micro	mikro
colleges	fakulteti
mile	milja
challenges	izazovi
editors	urednici
supreme	vrhovni
brothers	braća
recognition	priznanje
ref	Najbolje
estimate	procjena
kid	dijete
inspection	inspekcija
consumers	potrošači
limits	granice
territory	teritorija
weapons	oružje
delay	odgoditi
pilot	pilot
contributions	doprinosi
continuous	stalan
initiative	inicijativa
novel	roman
execution	izvršenje
disability	invalidnost
ultra	ultra
winner	pobjednik
episode	epizoda
potter	lončar
dish	jelo
plays	igra
bulletin	bilten
ia	ia
modify	izmijeniti
truly	uistinu
universe	svemir
candidate	kandidat
slot	prorez
outstanding	izvanredan
ha	Ha
planned	planirani
lodge	loža
mirror	ogledalo
tournament	turnir
consideration	obzir
sessions	sjednice
kernel	zrno
buyers	kupci
journals	časopisi
gray	siva
catalogue	katalog
charged	optužen
broad	širok
und	und
chosen	odabran
demo	demo
hate	mrziti
terminal	terminal
publishers	izdavači
nights	noću
liquid	tekući
rice	riža
reservation	rezervacija
foods	hrana
guard	straža
saving	ušteda
empire	carstvo
newly	novo
raise	podići
illegal	nezakonit
expansion	ekspanzija
premier	premijer
tomorrow	sutra
milk	mlijeko
drama	drama
visiting	gostujući
contest	Natjecanje
collected	prikupljeni
bands	bendovi
suitable	pogodan
absolutely	apsolutno
audit	revizija
chamber	komora
guinea	Gvineja
findings	nalazi
iso	izo
typical	tipičan
sum	iznos
chicken	piletina
temporary	privremen
attend	prisustvovati
shower	tuš
sending	slanje
sufficient	dovoljan
shell	ljuska
province	pokrajina
catholic	katolički
governor	guverner
beer	pivo
contribution	doprinos
formula	formula
constitution	ustav
packaging	ambalaža
reliable	pouzdan
doubt	sumnjati
earn	zaraditi
periods	razdoblja
attacks	napadi
merchandise	roba
symptoms	simptomi
memorial	spomen
twin	blizanac
insert	umetnuti
gateway	prolaz
drawing	crtanje
candidates	kandidati
ordered	naredio
biological	biološki
fighting	borba
transition	tranzicija
preferences	postavke
spy	špijun
romance	romantika
instrument	instrument
split	podjela
themes	teme
powers	sile
heaven	raj
bits	komadići
pregnant	trudna
classification	klasifikacija
focused	usmjerena
physician	liječnik
asking	traži
blocks	blokovi
lo	gle
spiritual	duhovni
diabetes	dijabetes
ml	ml
shift	smjena
sit	sjediti
bodies	tjelesa
photographs	fotografije
cutting	rezanje
writers	pisci
flexible	fleksibilno
loved	voljen
favourites	favoriti
mapping	kartografija
numerous	brojan
relatively	relativno
represents	predstavlja
superior	superioran
preferred	poželjna
saved	spremaju
intellectual	intelektualac
granted	odobreno
carbon	ugljen
comfortable	udobno
magnetic	magnetski
interaction	interakcija
listening	slušanje
crisis	kriza
outlook	pogled
massive	masivan
bright	svijetao
formed	formirana
piano	klavir
echo	jeka
revolution	revolucija
displays	prikazuje
plasma	plazma
earnings	zarada
mystery	misterija
landscape	pejzaž
mechanical	mehanički
journey	putovanje
banner	zastava
fig	smokva
counties	županije
acquisition	akvizicija
recognized	priznat
dreams	snovi
notification	obavijest
kg	kg
teach	učiti
rapid	brz
pull	Vuci
ut	Juta
seminar	seminar
investments	investicije
wheels	kotači
specify	odrediti
sensitive	osjetljiv
templates	predlošci
formats	formati
holds	drži
router	usmjerivač
concrete	beton
si	si
folder	mapa
completion	završetak
pulse	puls
technique	tehnika
voting	glasanje
courts	sudovi
converted	pretvaraju
metro	metro
anniversary	godišnjica
improvements	poboljšanja
strip	traka
specification	specifikacija
accident	nesreća
nick	zarez
accessible	dostupan
resident	Rezidencija
plot	zemljište
typically	tipično
representation	prikaz
pump	pumpa
exists	postoji
arrangements	aranžmani
conferences	konferencije
consumption	potrošnja
narrow	suziti
threat	prijetnja
surveys	ankete
sitting	sjedenje
consultant	konzultant
controller	kontrolor
committees	odbori
penis	penis
castle	dvorac
gardens	vrtovi
labels	etikete
willing	spreman
bio	bio
acting	gluma
heads	glave
exam	ispit
residence	prebivalište
density	gustoća
hundred	stotina
strange	čudan
sustainable	održiv
statistical	statistički
mention	spomenuti
innovation	inovacija
grey	siva
parallel	paralelno
operate	raditi
bills	novčanice
stable	stabilan
definitions	definicije
von	von
doctors	liječnici
lesson	lekcija
cinema	kino
elections	izbori
reaction	reakcija
blank	prazan
enhanced	poboljšane
entitled	pravo
severe	ozbiljan
generate	generirati
newspapers	novine
hospitals	bolnice
vi	vi
humor	humor
aged	star
monitors	monitori
exception	izuzetak
duration	trajanje
bulk	Glavnina
visits	posjeta
capabilities	sposobnosti
recommendation	preporuka
sin	grijeh
organized	organizirani
ba	ba
para	stavak
adoption	posvajanje
improving	poboljšanje
expensive	skup
buffalo	bizon
organisations	organizacija
plane	avion
programmes	programi
mechanism	mehanizam
ee	ee
marked	obilježen
driven	upravljan
bottle	boca
innovative	inovativan
massage	masaža
conclusion	zaključak
closing	zatvaranje
thousand	tisuću
legend	legenda
villa	vila
bone	kost
columns	stupovi
disorders	poremećaji
collaboration	kolaboracija
detection	otkrivanje
inner	unutrašnji
formation	formacija
med	med
engineers	inženjeri
entity	osoba
cruises	krstarenja
gate	vrata
roman	rimski
duties	dužnosti
erotic	erotski
tone	ton
ethics	etika
dragon	zmaj
busy	zaposlen
captain	kapetan
brings	donosi
heating	grijanje
leg	noga
neck	vrat
wing	krilo
scripts	skripta
abc	abeceda
appointed	postavljen
dealing	bavljenje
commit	počiniti
rail	željeznički
trips	putovanja
gap	praznina
sides	strane
tube	cijev
corresponding	odgovara
descriptions	opisi
belt	pojas
jacket	jakna
animation	animacija
oracle	proročanstvo
er	er
productions	produkcija
aviation	zrakoplovstvo
proud	ponos
disaster	katastrofa
console	konzola
commands	naredbe
jr	jr
telecommunications	telekomunikacija
instructor	instruktor
giant	gigantski
achieved	postići
injuries	ozljede
approaches	pristupi
usual	uobičajen
stamps	marke
angle	kut
rob	opljačkati
designers	dizajneri
liberty	sloboda
era	doba
convert	Pretvoriti
possibility	mogućnost
analyst	analitičar
dangerous	opasno
reliability	pouzdanost
respectively	odnosno
volunteers	volonteri
derived	izveden
pleasure	zadovoljstvo
honor	čast
oriented	orijentiran
eagle	orao
prayer	molitva
workshops	radionice
hurricane	uragan
quiet	miran
producer	proizvođač
represented	zastupljeni
responsibilities	odgovornosti
cheese	sir
carefully	pažljivo
productivity	produktivnost
crown	kruna
par	jednakost
diagnosis	dijagnoza
maker	tvorac
crack	pukotina
principle	načelo
picks	motika
gang	banda
fetish	fetiš
appearance	izgled
smoke	dim
filters	filteri
incorporated	inkorporiran
craft	čamac
fellow	kolega
blind	slijep
lounge	salon
mad	lud
algorithm	algoritam
strongly	snažno
cafe	kafić
ken	znanje
proteins	proteini
su	Su
familiar	upoznat
capable	sposoban
admission	ulaz
shoe	cipela
elected	izabran
carrying	nošenje
terrorism	terorizam
joy	radost
editions	izdanja
ethnic	etnički
parliament	parlament
actor	glumac
finds	nalazi
seal	pečat
situations	situacije
fifth	peti
citizen	građanin
vertical	vertikala
corrections	ispravke
describes	opisuje
disabilities	invaliditetom
substance	supstanca
prohibited	zabranjen
pipe	cijev
soldiers	vojnici
guardian	čuvar
lecture	predavanje
simulation	simuliranje
layout	raspored
initiatives	inicijative
ill	bolestan
concentration	koncentracija
lay	položiti
interpretation	tumačenje
dirty	prljav
taught	učio
worker	radnik
optimization	optimizacija
temple	hram
substances	tvari
prove	dokazati
discovered	otkriven
wings	krila
genetic	genetski
restrictions	ograničenja
thin	tanak
exhibition	izložba
ridge	greben
modem	modem
bringing	donošenje
sick	bolestan
evaluate	procijeniti
tropical	tropski
collect	prikupiti
vector	vektor
definitely	definitivno
turning	tokarenje
existence	postojanje
commentary	komentar
developments	razvoj
immigration	imigracija
destinations	destinacije
mutual	zajednički
syntax	sintaksa
li	li
attribute	atribut
prison	zatvor
skill	vještina
chairs	stolice
surrounding	okolni
mountains	planine
popularity	popularnost
inquiry	pitanje
checked	provjeren
exhibit	izložak
throw	bacanje
trend	trend
cats	mačke
desert	pustinja
ya	ya
coordinator	koordinator
mercury	Merkur
burning	spaljivanje
escape	pobjeći
receiver	prijamnik
progressive	progresivan
boats	brodovi
championship	prvenstvo
arcade	arkada
impossible	nemoguće
tells	govori
obvious	očigledan
depression	depresija
graph	grafikon
covering	pokrivati
platinum	platina
judgment	osuda
talks	razgovori
filing	podnošenje
foster	gajiti
awarded	nagrađen
trials	ispitivanja
masters	majstori
cartridge	kaseta
explanation	obrazloženje
org	org
fraud	prevara
electricity	elektricitet
spectrum	spektar
arrival	dolazak
pottery	posuđe
emphasis	isticanje
awesome	super
confirmed	potvrđen
counts	broji
crash	sudar
lift	lift
inter	između
heights	visine
shadow	sjena
expense	trošak
venture	pothvat
clinic	Klinika
healing	liječenje
princess	princeza
entering	ulazak
packet	paket
studios	studio
involvement	učešće
dad	tata
buttons	tipke
placement	plasman
observations	zapažanja
winners	pobjednici
roads	ceste
subsequent	sljedeći
yard	dvorište
disclosure	otkriće
establishment	osnivanje
memories	sjećanja
te	TE
creates	stvara
faces	lica
tourist	turist
murder	ubiti
adequate	adekvatan
senator	senator
presentations	prezentacije
digest	probaviti
dust	prah
wiki	wiki
replaced	zamijeniti
radar	radar
losses	gubici
combat	borba
reducing	smanjivanje
stopped	prestao
occupation	okupacija
closely	tijesno
radiation	radijacija
kings	kraljevi
shooting	pucanje
ear	uho
flags	zastave
baker	pekar
conservative	konzervativan
shock	šok
effectiveness	efikasnost
tie	kravata
roof	krov
demonstrate	pokazati
atmosphere	atmosfera
kiss	poljubac
beast	zvijer
ra	ra
operated	operiran
experiment	eksperiment
targets	ciljevi
purchases	kupi
federation	federacija
pizza	pizza
invited	pozvan
assignment	zadatak
mod	modni
queries	upita
absence	odsutnost
vendors	dobavljači
yoga	joga
serves	služi
surprise	iznenađenje
lamp	svjetiljka
jokes	vicevi
counseling	savjetovanje
palace	palača
satisfied	zadovoljan
wins	pobjeda
warehouse	skladište
supposed	trebala
ordinary	običan
ghost	duh
violation	povreda
boss	šef
pride	ponos
expectations	očekivanja
independence	nezavisnost
knowing	poznavanje
reporter	reporter
metabolism	metabolizam
champion	prvak
personally	lično
plenty	mnogo
solo	solo
throat	grlo
wealth	bogatstvo
vacuum	vakuum
dancing	ples
recognize	prepoznati
writes	piše
plaza	trg
quest	traganje
publish	objaviti
screening	probir
trans	trans
pioneer	pionir
forgotten	zaboravljen
acrobat	akrobata
plates	ploče
essays	eseji
behaviour	ponašanje
telling	reći
fairly	pošteno
intelligent	inteligentan
modes	načini
obligation	obaveza
harbor	luka
traveler	putnik
segment	segment
enemy	neprijatelj
puzzle	puzzle
wells	bunara
restricted	ograničen
republican	republikanac
secrets	tajne
syndrome	sindrom
attendance	pohađanje
penalty	kazna
drum	bubanj
enables	omogućuje
builder	graditelj
vista	vidik
flood	poplava
ease	olakšati
arguments	argumenti
arena	arena
adventures	avanture
pupils	zjenice
announcement	Obavijest
outcome	ishod
appreciate	cijeniti
expanded	proširen
grown	odrastao
lovely	lijep
centres	centri
clause	klauzula
smile	osmijeh
lands	zemljišta
troops	trupe
armed	naoružan
pine	bor
cooling	hlađenje
gulf	zaljev
trucks	kamioni
mechanisms	mehanizmi
divorce	razvod
tradition	tradicija
pills	tablete
tiger	tigar
folks	ljudi
sensor	senzor
exposed	izložen
hunt	lov
angels	anđeli
deputy	zamjenik
thai	thai
emissions	emisija
physicians	liječnici
complaint	prigovor
scenes	scene
experiments	pokusi
boost	pojačati
governance	vladavina
mill	mlin
founded	osnovan
chronic	kroničan
den	jazbina
finger	prst
keeps	drži
pound	funta
locate	pronaći
pl	pl
trained	obučen
implementing	provođenje
bread	kruh
motors	motori
tough	tvrd
incident	incident
dynamics	dinamika
lie	laž
conversation	razgovor
decrease	smanjenje
worship	obožavanje
capability	sposobnost
ak	ak
precision	preciznost
damages	štete
reserves	rezerve
solve	riješiti
minority	manjina
diverse	drugačiji
ingredients	Sastojci
ah	Ah
tones	tonovi
rehabilitation	rehabilitacija
sight	vid
clay	glina
weak	slab
divided	podijeljen
reception	recepcija
wise	mudar
odds	izgledi
seminars	seminari
consequences	posljedice
makers	odluka
geography	geografija
integrity	integritet
legacy	nasljedstvo
pleased	zadovoljan
danger	opasnost
vitamin	vitamin
processed	obrađen
phrase	fraza
raising	podizanje
implications	implikacije
functionality	funkcionalnost
paradise	raj
hybrid	hibrid
reads	čita
emotional	emotivan
glory	slava
ja	ja
geographic	geografski
exceed	prekoračiti
rod	štap
silk	svila
babies	bebe
bi	dvo
romantic	romantičan
revealed	objavi
specialists	stručnjaci
generator	generator
suspension	suspenzija
sad	tužan
correction	korekcija
wolf	vuk
slowly	polako
supplement	dopuniti
portions	dijelovi
infant	dječji
sectors	sektori
fluid	tekućina
grounds	teren
meal	obrok
ta	tA
machinery	strojevi
equation	jednadžba
baskets	košare
probability	vjerojatnost
dimension	dimenzija
studied	studirao
profits	dobit
devil	vrag
grass	trava
illustrated	ilustrirano
cherry	trešnja
continental	kontinentalni
achievement	dostignuće
limitations	ograničenja
funeral	pogreb
chapters	poglavlja
passenger	putnik
convenient	zgodan
mars	Mars
sized	veličine
egg	jaje
signals	signali
orientation	orijentacija
theft	krađa
childhood	djetinjstvo
symbols	simboli
lat	lat
meta	meta
analog	analog
talent	talenat
dated	datiran
wisdom	mudrost
boundary	granica
elite	elita
gi	vojnik
believes	vjeruje
poems	pjesme
jurisdiction	nadležnost
robot	robot
displaying	prikazivanje
witness	svjedok
equipped	opremljen
stages	faze
sur	sur
acquired	stečena
assess	procijeniti
wash	pranje
entrance	ulaz
declaration	izjava
losing	gubljenje
attempts	pokušaji
noble	plemenite
automation	automatizacija
impacts	utjecaji
rev	revolucija
advantages	prednosti
knight	vitez
aims	ciljevi
extensions	ekstenzije
appeals	žalbe
illness	bolest
ho	Ho
alternatives	alternative
sh	sh
soap	sapun
jam	pekmez
unusual	neuobičajen
answered	odgovorio
destruction	razaranje
migration	migracija
disorder	poremećaj
conventional	konvencionalne
wearing	nošenje
axis	os
sought	traži
genes	geni
median	srednja
scanner	skener
herein	ovdje
animated	animirani
adjustment	podešavanje
hero	junak
treatments	tretmani
attitude	stav
carpet	tepih
lenses	leće
attended	prisustvovao
difficulty	teškoća
punk	punk
coalition	koalicija
enrollment	upis
duke	vojvoda
pace	tempo
producers	proizvođači
arc	luk
interfaces	sučelja
atlas	atlas
observation	zapažanje
torture	mučenje
deleted	izbrisana
coat	kaput
restoration	obnova
convenience	pogodnost
returning	povratak
opposition	opozicija
container	kontejner
defendant	tuženik
supervisor	nadglednik
corps	korpus
actors	glumci
liver	jetra
liable	odgovoran
petition	peticija
antenna	antena
picked	izabran
belief	vjerovanje
killing	ubijanje
shoulder	rame
decor	dekor
ion	ion
diameter	promjer
podcast	podcast
interactions	interakcije
singer	pjevač
herald	glasnik
aging	starenje
intervention	intervencija
plugin	uključiti
attraction	privlačnost
diving	ronjenje
modification	modifikacija
suppose	pretpostaviti
reed	trska
involve	obuhvatiti
moderate	umjeren
mice	miševi
understood	razumjeti
rapidly	brzo
ban	zabrana
assurance	uvjerenje
happening	događa
vast	ogroman
mills	mlinovi
outline	obris
receives	prima
jeans	traperice
compilation	kompilacija
odd	neparan
sigma	sigma
gr	gr
attractive	atraktivan
occasion	prilika
recordings	snimke
victim	žrtva
demands	zahtjevi
careful	pažljiv
beam	snop
gardening	vrtlarstvo
obligations	obveze
arrive	stići
orchestra	orkestar
licence	licenca
adjustable	prilagodljiv
allocation	namjena
essay	esej
demonstrated	pokazao
dialogue	dijalog
camps	kampovi
declared	proglašen
trace	trag
shut	zatvoriti
packs	omot
