arasında	из
için	в
içinde	в
için	для
olduğu	является
üzerinde	на
o	что
tarafından	от
bu	это
ile	с
ben	я
sen	вы
o	Это
veya	или
olmak	быть
Hangi	находятся
en	в
herşey	все
var	иметь
yeni	новый
Biz	мы
irade	будем
ev	Главная
bize	нас
hakkında	около
Eğer	если
sayfa	страница
benim	мой
vardır	имеет
arama	поиск
ücretsiz	свободно
fakat	но
bizim	наш
bir	один
diğer	Другие
yap	делать
bilgi	Информация
zaman	время
o	он
hangi	который
onların	их
haber	Новости
kullanım	использование
Orada	там
görmek	видеть
yani	так
kim	кто
ağ	Web
Ayrıca	также
almak	получить
pm	вечера
görünüm	Посмотреть
c	с
e	е
ilk	первый
olmuştur	было
olur	бы
idi	мы
s	s
sevmek	как
x	Икс
göre	чем
bulmak	найти
fiyat	цена
geri	назад
üst	Вверх
insanlar	люди
vardı	имел
liste	список
isim	имя
sadece	просто
yıl	год
gün	день
içine	в
iki	два
sağlık	здоровье
n	N
yeniden	ре
Kullanılmış	используемый
gitmek	идти
b	б
son	последний
Yapmak	делать
onları	их
meli	должен
ürün	продукт
sistem	система
posta	после
ona	ее
Kent	город
t	T
politika	политика
numara	номер
destek	поддержка
mesaj	сообщение
sonra	после
sonra	тогда
Ocak	январь
iyi	хорошо
d	d
nerede	где
bilgi	Информация
haklar	права
kitaplar	книги
yüksek	высокая
okul	школа
m	м
her	каждый
bağlantılar	связи
o	она
yıl	лет
sipariş	заказ
çok	очень
kitap	книга
ürün	Предметы
şirket	Компания
r	р
okumak	читать
grup	группа
seks	секс
çok	многие
kullanıcı	пользователь
de	де
set	задавать
genel	Генеральная
Araştırma	исследование
Üniversite	Университет
Ocak	январь
posta	почта
tam	полный
yorumlar	отзывы
program	программа
bilmek	знать
oyunlar	игры
yol	путь
günler	дней
p	п
Bölüm	часть
could	мог
harika	Великий
birleşmiş	единый
gerçek	реальный
f	е
Uluslararası	Международный
merkez	центр
seyahat	путешествовать
yorumlar	Комментарии
yapılmış	сделал
gelişme	развитие
rapor	доклад
üye	член
ayrıntılar	Детали
hat	линия
şartlar	сроки
önce	до
oteller	отели
did	сделал
göndermek	Отправить
sağ	правильно
tip	тип
yerel	местный
bu	те
Sonuçlar	Результаты
ofis	офис
Ulusal	национальный
araba	автомобиль
dizayn	дизайн
almak	принимать
gönderildi	отправил
adres	адрес
topluluk	сообщество
içinde	в
devletler	состояния
istemek	хотеть
telefon	Телефон
DVD	DVD
konu	предмет
arasında	между
forum	Форум
aile	семья
l	L
uzun	длинный
w	вес
göstermek	показать
O	о
Üstelik	даже
siyah	черный
özel	особый
indeks	индекс
olmak	являющийся
KADIN	женщины
çok	много
işaret	знак
dosya	файл
bağlantı	ссылка
açık	открытый
güney	юг
dava	дело
proje	проект
sayfalar	страницы
versiyon	версия
Bölüm	раздел
kendi	своя
ev	дом
güvenlik	безопасность
g	г
kontluk	округ
Amerikan	американский
Fotoğraf	Фото
oyun	игра
üyeler	члены
güç	мощность
ağ	сеть
bilgisayar	компьютер
sistemler	системы
üç	три
yer	место
son	конец
h	час
onu	его
başına	в
erişim	доступ
düşünmek	думать
kuzeyinde	север
kaynaklar	Ресурсы
şimdiki	текущий
büyük	большой
medya	СМИ
kanun	закон
kontrol	контроль
Su	воды
Tarihçe	история
boyut	размер
kişisel	личный
kılavuz	руководство
Dükkan	магазин
rehber	каталог
değişiklik	изменение
beyaz	белый
Metin	текст
küçük	маленький
değerlendirme	рейтинг
oran	ставка
hükümet	правительство
çocuklar	дети
dönüş	вернуть
öğrencilerin	студенты
v	v
hesap	Счет
zamanlar	раз
seviye	уровень
dijital	цифровой
profil	профиль
önceki	предыдущий
form	форма
olaylar	Мероприятия
Aşk	люблю
eski	старый
John	Джон
ana	главный
aramak	вызов
görüntü	образ
Bölüm	отдел
Başlık	заглавие
olmayan	не
k	К
y	Y
sigorta	страхование
acak	должен
özellik	имущество
sınıf	класс
CD	CD
kalite	качественный
her	каждый
listeleme	список
içerik	содержание
ülke	страна
küçük	немного
araçlar	инструменты
düşük	низкий
cevap	Ответить
müşteri	клиент
Aralık	Декабрь
karşılaştırmak	сравнить
filmler	кино
kolej	колледж
değer	стоимость
makale	статья
adam	человек
Meslekler	работы
j	J
Gıda	питание
yazar	автор
farklı	другой
u	U
öğrenmek	учить
satış	продажа
baskı	Распечатать
kurs	курс
iş	работа
oda	комната
Stok	акции
Eğitim	обучение
çok	слишком
kredi	кредит
puan	точка
Bilim	наука
erkekler	люди
kategoriler	категории
batı	запад
bak	смотреть
ingilizce	английский
takım	команда
arazi	имущество
Kutu	коробка
koşullar	условия
fotoğraflar	фото
eşcinsel	гей
iplik	нить
kategori	категория
Not	заметка
canlı	жить
büyük	большой
galeri	галерея
tablo	Таблица
ancak	Однако
Haziran	июнь
Ekim	октябрь
Kasım	ноябрь
Market	рынок
kütüphane	библиотека
aksiyon	действие
başla	Начало
dizi	серии
Özellikler	функции
hava	воздух
sanayi	промышленность
plan	план
insan	человек
Evet	да
ikinci	второй
Sıcak	горячий
maliyet	Стоимость
film	кино
forumlar	форумы
Mart	Март
la	ля
Eylül	сентябрь
söylemek	сказать
gidiyor	собирается
tıbbi	медицинская
arkadaş	друг
Aralık	декабрь
sunucu	сервер
uygulama	заявление
Personel	сотрудники
oyun	играть
sorunlar	вопросы
Nisan	апрель
kullanıcılar	пользователи
sokak	улица
konu	тема
karşısında	против
var	получил
Blog	блог
Parti	вечеринка
ödeme	оплата
ekipman	оборудование
let	позволять
programlar	программы
yasal	правовой
son	недавний
park	парк
davranmak	акт
sorun	проблема
kırmızı	красный
vermek	дайте
bellek	Память
performans	представление
sosyal	Социальное
q	Q
Öykü	история
satmak	продавать
seçenekleri	опции
deneyim	опыт
anahtar	ключ
vücut	тело
genç	молодой
önemli	важный
alan	поле
az	мало
Doğu	восток
tek	Один
ii	б
yaş	возраст
kulüp	клуб
örnek	пример
kızlar	девочки
z	Z
yol	Дорога
hediye	подарок
soru	вопрос
CA	Калифорния
zor	жесткий
ödeme	платить
dört	четыре
poker	покер
konu	вопрос
menzil	ассортимент
bina	здание
satıcı	продавец
mahkeme	суд
Şubat	февраль
sonuç	результат
ışık	легкий
yazmak	записывать
savaş	война
teklif	предлагает
mavi	синий
gruplar	группы
ark	аль
kolay	легко
verilmiş	данный
istek	запрос
faks	факс
Çin	Китай
yapma	изготовление
resim	картина
ihtiyaçlar	потребности
mümkün	возможное
ay	месяц
majör	главный
star	звезда
gelecek	будущее
uzay	пространство
Kurul	комитет
el	рука
Güneş	солнце
kartları	карты
Londra	Лондон
toplantı	встреча
olmak	стали
çocuk	ребенок
Tut	держать
porno	порно
pay	доля
benzer	аналогичный
Bahçe	сад
okullar	школы
milyon	миллиона
katma	добавленной
referans	Справка
şirketler	компании
bebek	детка
öğrenme	обучение
enerji	энергия
koşmak	бег
teslim	Доставка
popüler	популярный
terim	срок
film	фильм
hikayeleri	истории
koymak	положил
dergi	журнал
raporlar	отчеты
ko	Колорадо
Deneyin	пытаться
Görüntüler	изображений
ihbar	уведомление
Allah	Бог
orijinal	оригинал
kafa	глава
radyo	радио
hücre	клетка
konsey	совет
içerir	включает
Izlemek	трек
tartışma	обсуждение
Arşiv	архив
diğerleri	другие
anlaşma	соглашение
biçim	формат
toplum	общество
ay	месяцы
Emniyet	безопасность
Arkadaş	друзья
emin	конечно
baskı	издание
mesajları	Сообщения
pazarlama	маркетинг
söylemek	рассказать
birleşme	ассоциация
sağlar	обеспечивает
eğlence	весело
zaten	уже
yeşil	зеленый
çalışmalar	исследования
kapat	Закрыть
ortak	общий
özel	конкретный
birkaç	несколько
yaşam	живой
Toplamak	коллекция
denilen	называется
kısa	короткая
sanat	искусства
çok	много
Sor	просить
sınırlı	ограниченное
çözeltiler	решения
yönetmen	директор
plaj	пляж
geçmiş	мимо
doğal	натуральный
elektronik	электроника
üzerine	на
dönem	период
planlama	планирование
diyor	говорит
resmi	официальный
mar	март
tamam	сделанный
teknik	технический
pencere	окно
profesyonel	профессионал
bölge	область
ada	остров
kayıt	запись
direkt	непосредственный
konferans	конференция
kayıtlar	учет
st	улица
ilçe	район
takvim	календарь
maliyetler	расходы
stil	стиль
Beyan	заявление
mil	миль
kaynak	ресурс
uygulamaları	Приложения
belge	документ
sözcük	слово
Eserleri	работает
malzeme	материал
fatura	законопроект
yazılı	написано
kurallar	правила
nihai	окончательный
şey	вещь
merkez	центр
Gereksinimler	требования
DOĞRU	ПРАВДА
dakika	минут
Başka	еще
işaret	отметка
Kaya	камень
kötü	Плохо
bireysel	индивидуальный
artı	плюс
Oto	авто
kapak	обложка
Düzenle	редактировать
birlikte	вместе
videolar	видео
hızlı	быстро
fonksiyon	функция
gerçek	факт
alma	получение
global	Глобальный
teknoloji	тек
karşılamak	встретить
uzak	далеко
ekonomik	экономической
tr	ан
oyuncu	игрок
projeler	проектов
Miktar	количество
izlemek	смотреть
dahil	включены
hissetmek	Чувствовать
banka	банка
risk	риск
fırsatlar	предложения
çeşitli	различный
kelimeler	слова
üretim	производство
ticari	коммерческая
ağırlık	вес
kalp	сердце
tedavi	лечение
makas	точки
bilgi	знание
dergi	журнал
hata	ошибка
kamera	камера
kız	девушка
inşaat	строительство
oyuncaklar	игрушки
kayıtlı	зарегистрированный
domain	домен
yöntemleri	методы
bölüm	глава
koruma	защита
politikaları	полисы
geniş	широкий
güzellik	красота
müdür	менеджер
Hindistan	Индия
pozisyon	должность
alınmış	взятый
çeşit	Сортировать
listeleri	объявления
bilinen	известен
yarım	половина
vakalar	случаи
adım	шаг
mühendislik	инжиниринг
basit	просто
hızlı	быстро
lisans	лицензия
göl	озеро
bütün	все
yıllık	годовой
yayınlanan	опубликованный
kilise	церковь
yöntem	метод
aktif	активный
tepki	ответ
şekil	фигура
malzemeler	материалы
yeterli	достаточно
tasarlanmış	предназначенный
arasında	среди
ölüm	смерть
kayıp	потеря
yüz	лицо
marka	марка
indirim	скидка
Etkileri	последствия
oluşturulan	созданный
standartlar	стандарты
bit	немного
siyasi	политическая
krallık	Королевство
baz	база
iş	дела
krediler	кредитование
ayakkabı	обувь
giriş	запись
kalmak	оставаться
emirler	заказы
kullanılabilirlik	доступность
özet	резюме
dönüş	очередь
büyüme	рост
Ajans	агентство
kral	король
Avrupa	Европейская
aktivite	Мероприятия
kopya	копия
batı	вестерн
Kuvvet	сила
iş	занятость
Defne	залив
nehir	река
komisyon	комиссия
paket	пакет
görüldü	видели
oyuncu	игроки
motor	двигатель
Liman	порт
albüm	альбом
bölgesel	региональный
durdurmak	стоп
başladı	начал
yönetim	администрация
bar	бар
enstitü	институт
görünümler	Просмотры
çift	двойной
köpek	собака
yakında	скоро
hatlar	линии
elektronik	электронный
faydaları	выгоды
gerekli	необходимый
yazıcı	принтер
şart	состояние
etkili	эффективный
inanmak	верить
organizasyon	организация
Efekt	эффект
us	разум
seçim	выбор
kumarhane	казино
pdf	PDF
tur	тур
çapraz	пересекать
umut	надежда
şirket	корпорация
dilek	желание
çözüm	решение
olgun	зрелый
rol	роль
haftalar	недель
belli	определенный
alt	ниже
gerekli	необходимо
Birlik	союз
Pazartesi	понедельник
com	ком
belirli	конкретный
ince	отлично
saat	час
gaz	газ
becerileri	навыки
altı	шесть
çalı	куст
adaları	острова
tavsiye	совет
kariyer	карьера
karar	решение
ayrılmak	оставлять
önceden	до
Kocaman	огромный
Kadın	женщина
tesisler	оборудование
teklif	предложение
orta	средний
kablo	кабель
fırsatlar	возможности
alma	принятие
değerler	значения
bölünme	деление
gelecek	приход
nesne	объект
lezbiyen	лесбиянка
uygun	подходящее
makine	машина
logo	логотип
uzunluk	длина
Güzel	хороший
Gol	Гол
istatistik	статистика
müşteri	клиент
Numune	образец
yatırım	инвестиции
gönderilen	послал
gösterilen	показанный
Noel	рождество
kültür	культура
flaş	вспышка
MS	Миз
seçim	выбор
dersler	курсы
tüketici	потребитель
Merhaba	Здравствуй
yabancı	иностранные
sanatçı	художник
mobilya	мебель
kanal	канал
mektup	письмо
kip	Режим
telefonlar	телефоны
fikirler	идеи
yapı	состав
derece	степень
sözleşme	контракт
Süper	супер
erkek	мужской
madde	дело
neredeyse	почти
bulunan	располагается
çoklu	множественный
dağıtım	распределение
editör	редактор
Han	гостиница
Sanayi	промышленные
potansiyel	потенциал
şarkı	песня
los	лос
düşmek	падать
Fikir	идея
Odalar	номера
iletişim	связь
kazanmak	выиграть
birincil	первичный
kanser	рак
sayılar	чисел
neden	причина
araç	инструмент
bahar	весна
vakıf	Фонд
Cevap	ответ
ses	голос
program	график
evraklar	документы
amaç	цель
özellik	особенность
yatak	постель
geliyor	выходит
polis	полиция
bağımsız	независимый
yaklaşım	подход
kahverengi	коричневый
fiziksel	физическое
Tepe	холм
haritalar	карты
ambar	держать
derecelendirme	рейтинги
mutlu	счастливый
demirci	кузнец
gelişmiş	развитая
teşekkür	спасибо
kasa	безопасно
benzersiz	уникальный
anket	опрос
önceki	предшествующий
telefon	телефон
spor	спорт
hazır	готов
hayvan	животное
kaynaklar	источники
nüfus	Население
baba	папа
düzenli	регулярный
güvenli	безопасный
operasyonlar	операции
basitçe	просто
kanıt	доказательства
istasyon	станция
anlama	Понимаю
seçenek	вариант
vadi	долина
muhtemelen	вероятно
deniz	море
yayınlar	публикации
iyileştirmek	улучшать
bağ	соединение
Yayımcı	издатель
salon	зал
anti	анти
ağlar	сети
toprak	Земля
ebeveyn	родители
darbe	влияние
Aktar	перевод
Giriş	введение
mutfak	кухня
kuvvetli	сильный
düğün	свадьба
özellikleri	свойства
hastane	больница
zemin	земля
gemi	корабль
Konaklama	жилье
hastalık	болезнь
mükemmel	отлично
mükemmel	идеально
saç	волосы
fırsat	возможность
malzeme	Комплект
klasik	классический
temel	основа
komuta	команда
şehirler	города
ekspres	экспресс
ödül	награда
mesafe	расстояние
ağaç	дерево
değerlendirme	оценка
duvar	стена
ilgili	участвует
el	эль
ekstra	дополнительный
özellikle	особенно
bütçe	бюджет
kılavuzlar	направляющие
başarı	успех
maksimum	максимальная
anne	мама
operasyon	операция
mevcut	существующий
oldukça	довольно
seçilmiş	выбранный
oğlan	мальчик
restoranlar	ресторан
güzel	красивая
uyarı	предупреждение
yerleri	места
at	лошадь
oy	голос
Çiçekler	цветы
yıldızlar	звезды
listeleri	списки
sahip	владелец
hayvanlar	животные
yolları	пути
oğul	сын
sağlama	обеспечение
kural	правило
Konut	Корпус
alır	принимает
getirmek	приносить
katalog	каталог
maksimum	Максимум
anne	мама
yetki	власть
söyledi	сказал
program	программа
katıldı	присоединился
giriş	вход
strateji	стратегия
ayaklar	ноги
ajan	агент
geçerli	действительный
modern	современное
kıdemli	старшая
seksi	сексуальный
öğretim	обучение
kapı	дверь
büyük	большой
Deneme	испытание
birimler	единицы
güzel	круто
normal	нормальный
kuruluş	предприятие
gemiler	судов
tüm	все
pozitif	положительный
Fitness	фитнес
Çince	Китайский
görüş	мнение
Futbol	футбол
soyut	Абстрактные
çıktı	вывод
para	фонды
Bay	Мистер
muhtemelen	вероятно
geliştirmek	развивать
sanatçılar	художники
alternatif	альтернатива
sorumluluk	обязанность
java	Ява
konuk	гость
yayın	публикация
pas	проходить
ilişkiler	связи
güven	доверять
kamyonet	фургон
içeren	содержит
çok	много
cumhuriyet	республика
harç	сборы
bileşenler	компоненты
tatil	отпуск
yüzyıl	века
akademik	академический
yardım	помощь
tamamlanan	завершено
cilt	кожа
grafik	графика
Hintli	индийский
halka	кольцо
sınıf	класс
dağ	гора
organizasyonlar	организации
filtre	фильтр
panel	панель
zemin	пол
alış	покупка
maç	совпадение
önerilen	предложенный
gerektirir	требовать
çocuklar	мальчиков
sabah	утро
verir	позволяет
protein	белок
bitki	растение
rapor	сообщается
vurmak	удар
aa	мм
havuz	бассейн
mini	мини
siyaset	политика
ortak	партнер
yazarlar	авторы
panoları	доски
balık	рыба
üyelik	членство
misyon	миссия
göz	глаз
sicim	строка
duyu	смысл
değiştirilmiş	модифицированный
yayınlandı	выпущенный
evre	сцена
iç	внутренний
doğmuş	Родился
detaylı	подробный
Japonca	Японский
yarış	раса
onaylı	утвержденный
hedef	цель
dışında	Кроме
karakter	персонаж
bakım	поддержание
kabiliyet	способность
ed	издание
kolza	изнасилование
pil	аккумулятор
gençlik	молодежь
basınç	давление
gönderilen	Отправлено
borç	долг
orta	средний
televizyon	телевидение
Ilgilenen	заинтересованный
çekirdek	ядро
mola	ломать
amaçlar	цели
kümeler	наборы
dans	танец
ahşap	дерево
tanımlanmış	определенный
kâğıtlar	документы
ödülleri	награды
ücret	плата
stüdyo	студия
okuyucu	читатель
cihaz	устройство
kurulmuş	установленный
cevaplar	ответы
kira	аренда
las	лас
karanlık	темно
dış	внешний
elma	яблоко
le	ле
Talimatlar	инструкции
min	мин
sunulan	предложенный
teori	теория
Kaldır	Удалить
yardım	помощь
görsel	визуальный
evsahibi	хозяин
Çeşitlilik	разнообразие
öğretmenler	учителей
Manuel	руководство
blok	блок
konular	предметы
ajanları	агенты
onarım	ремонт
adil	Справедливая
çelik	стали
anlayış	понимание
şarkılar	песни
sabit	исправлено
yanlış	неправильно
başlangıç	начало
eller	Руки
az	Аризона
Paris	Париж
alır	получает
sektör	сектор
kapasite	вместимость
un	ООН
şişman	жир
baba	отец
elektrik	электрический
testere	увидел
enstrümanlar	инструменты
subay	сотрудник
sürücü	Водитель
işletmeler	бизнес
ölü	мертвый
Bilinmeyen	неизвестный
restoran	ресторан
mikrofon	Майк
gezi	поездка
mi	ми
fakir	бедные
ilişki	отношения
işçiler	рабочие
Barış	мир
geleneksel	традиционный
gösterme	показ
yaratıcı	творческий
sahil	берег
yarar	выгода
finansman	финансирование
cihazlar	приборы
Kral	господин
hibe	даровать
alt	суб
kurgu	фантастика
saatler	часы
kariyer	карьера
gider	идет
Led	светодиод
müze	музей
yelpaze	поклонник
taşıma	транспорт
ilginç	интересно
bloglar	блоги
değerlendirme	оценка
eski	бывший
bölge	зона
karmaşık	сложный
inci	го
kedi	Кот
ölmek	умереть
sunulan	представленный
düz	квартира
akış	течь
ajanslar	агентства
Edebiyat	литература
ebeveyn	родитель
ayar	установка
dr	доктор
ölçek	масштаб
ekonomi	экономика
faydalı	полезный
aylık	ежемесячно
kritik	критический
çerçeve	Рамка
müzikal	музыкальный
tanım	определение
Sekreter	секретарь
yol	дорожка
şef	главный
verir	дает
paketler	пакеты
detay	подробно
yasalar	законы
değişmiş	изменено
başla	начать
royal	королевский
temiz	чистый
adam	парень
başlıkları	названия
uygun	Соответствующий
adalet	справедливость
bağlamak	соединять
Fincan	кружка
sepet	корзина
uygulamalı	прикладная
haftalık	еженедельно
cilt	об
Kurulum	монтаж
s	стр
Dikkat	внимание
ilerlemek	продвижение
atlamak	пропускать
diyet	диета
ordu	армия
vites	шестерня
fark	разница
izin	позволил
doğru	верный
ulus	нация
satış	продажа
çok	много
parça	кусок
tabaka	лист
firma	фирма
Yedi	Семь
elementler	элементы
Türler	вид
atlama	Прыгать
hücreler	ячейки
modül	модуль
çare	курорт
sertifika	сертификат
bakan	министр
hareket	движение
moda	мода
talimatlar	направления
Ziyaretçi	посетители
belgeleme	документация
ticari	торговый
orman	лес
aramalar	звонки
kapsama	покрытие
çift	пара
vererek	дающий
şans	шанс
vizyon	видение
top	мяч
bitirme	окончание
istemciler	клиенты
eylemler	действия
tartışmak	обсуждать
hedef	Цель
başarılı	успешный
satıldı	продан
rüzgar	ветер
topluluklar	сообщества
klinik	клиническая
durum	ситуация
piyasalar	рынки
yayıncılık	издательский
görünmek	появиться
gelişen	развивающийся
hayatları	жизни
belirlemek	определить
sıcaklık	температура
duyurular	объявления
hasta	пациент
gerçek	фактический
tarihi	исторический
taş	камень
şilin	боб
ticaret	коммерция
kişiler	лиц
zor	сложно
ilmi	научный
uydu	спутник
testler	тесты
köy	деревня
hesapları	Счета
amatör	любитель
eski	бывший
met	встретил
Ağrı	боль
faktörler	факторы
Kahve	кофе
alıcı	покупатель
afiş	плакат
kenar	край
fonksiyonel	функциональная
kök	корень
fi	фи
kapalı	закрыто
Bayram	каникулы
pembe	розовый
denge	баланс
izleme	мониторинг
cevaplar	ответы
atış	выстрел
ilk	начальная
etiket	метка
sek	сек
kanon	канон
lig	лига
atık	отходы
dakika	минут
otobüs	автобус
sağlayan	поставщик
sözlük	Словарь
muhasebe	учет
imalat	производство
bölümler	разделы
sandalye	стул
çaba	усилие
faz	фаза
fantezi	фантазия
po	ро
va	в
profesör	профессор
kurmak	устанавливать
gömlek	Рубашка
giysi	одежда
ayak	фут
meme	грудь
teknikleri	методы
dolar	долларов
din	религия
izin	разрешение
vahşi	дикий
nesil	поколение
bayan	Мисс
kimyasal	химическая
doktor	врач
görev	задача
azaltmak	уменьшить
getirdi	привел
egzersiz	упражнение
böcek	ошибка
garanti	гарантия
lider	лидер
se	се
süreçler	процессы
yumuşak	мягкий
toplantılar	встречи
saniye	секунд
uçuş	рейс
kongre	конгресс
yakıt	топливо
yürümek	ходить
üretilmiş	произведенный
aziz	святой
tartışma	аргумент
yarışma	соревнование
ilaçlar	наркотики
ortak	совместный
ödül	премия
taze	свежий
karakterler	персонажи
avukat	адвокат
di	ди
faktör	фактор
binlerce	тысячи
km	км
Akış	поток
daireler	апартаменты
almak	выбирать
işitme	слух
doğu	восточный
terapi	терапия
girdileri	записи
imzalı	подписанный
idari	административный
ciddi	серьезный
sınır	предел
adımlar	меры
dükkanlar	магазины
esaret	зависимость
del	дель
çabaları	усилия
bilgili	проинформировал
ga	Джорджия
düşünceler	мысли
dere	ручей
ft	фут
miktar	количество
gerekli	существенный
turlar	туры
yük	нагрузка
hemen	немедленно
makineler	машины
belirlenmiş	назначенный
ağır	тяжелый
kapalı	покрытый
kurtarma	восстановление
entegre	интегрированный
yapılandırma	конфигурация
horoz	петух
tüccar	торговец
kapsamlı	комплексный
uzman	эксперт
korumak	защищать
katı	твердый
sunum	презентация
oldu	стал
Portakal	оранжевый
uyma	соблюдение
tema	тема
zengin	богатые
kampanya	кампания
vs	против
gitar	гитара
bulgu	обнаружение
örnekler	Примеры
ruh	дух
ar	Арканзас
iddialar	требования
kabul	принятие
stratejiler	стратегии
mo	мо
işler	дела
istenilen	предназначена
sa	са
hedefleri	цели
kiralama	Наем
seçim	выборы
önermek	предлагать
şube	филиал
servis	обслуживать
bağlı	филиалы
dağ	крепление
Latince	латинский
multimedya	мультимедиа
yönetmek	управлять
köşe	угол
rütbe	ранг
eleman	элемент
doğum	рождение
virüs	вирус
interaktif	интерактивный
istekler	Запросы
ayrı	отдельный
çeyrek	четверть
prosedür	процедура
liderlik	руководство
tanımlamak	определять
dini	религиозная
Gerçekler	факты
kahvaltı	завтрак
kolon	колонка
inanç	вера
Zincir	цепь
belirlemek	идентифицировать
cadde	проспект
eksik	отсутствует
tavsiyeler	рекомендации
taşındı	переехал
ulaşmak	достичь
karşılaştırma	сравнение
an	момент
Genişletilmiş	расширенный
sıra	последовательность
inç	дюймовый
saldırı	атака
merkezleri	центры
açılış	открытие
laboratuvar	лаборатория
rezerv	резерв
gama	гамма
üretmek	производить
hakikat	правда
sayaç	счетчик
başarısızlık	отказ
şu	следует
dolar	доллар
kamp	лагерь
des	дез
filmler	фильмы
köprü	мост
doldurmak	заполнить
hareket	движение
baskı	печать
taslak	проект
grafik	диаграмма
Oyunun	играл
kontaklar	контакты
okuyucular	читатели
kulüpleri	клубы
WA	Вашингтон
macera	приключение
teklif	предложение
kâr	прибыль
liderler	лидеры
afişler	плакаты
kurumlar	учреждения
asistan	помощник
değişken	переменная
dj	диджей
otopark	стоянка
dün	вчера
belirlenen	определенный
atölye	мастерская
gitmiş	прошло
kodlar	коды
çeşit	виды
uzantı	расширение
ifadeleri	заявления
tamamen	полностью
takımlar	команды
kale	форт
santimetre	см
senato	сенат
komik	веселая
gen	ген
dönük	оказалось
disk	диск
Desen	шаблон
tekne	лодка
tiyatro	театр
üreticileri	производители
sponsor	спонсор
klasik	классический
ikon	значок
garanti	гарантия
adanmış	преданный
yön	направление
Basketbol	баскетбол
nesneleri	объекты
silmek	Удалить
akşam	вечер
montaj	сборка
nükleer	ядерной
fare	мышь
işaret	сигнал
adli	преступник
Veriliş	выпущен
güçlü	мощный
rüya	мечта
YANLIŞ	ЛОЖНЫЙ
da	да
oyuncular	бросать
çiçek	цветок
personel	персонал
geçti	прошло
verilen	поставляется
düşme	падения
ruh	душа
desteklemek	содействовать
belirtilen	заявил
istatistikler	статистика
profesyoneller	профессионалов
belirir	появляется
Taşımak	нести
bayrak	флаг
kapaklar	крышки
em	Эм
avantaj	преимущество
Merhaba	Здравствуйте
tasarımlar	конструкции
sürdürmek	поддерживать
turizm	туризм
öncelik	приоритет
yetişkinler	Взрослые
grafik	графический
atom	атом
ödemeler	платежи
bağlayıcı	переплет
kısa	краткое
Bitti	закончился
kazanan	выигрыш
anonim	анонимный
senaryo	скрипт
hizmet	служил
istiyor	хочет
hazırlanmış	подготовленный
geçersiz	недействительным
etiket	тег
röportaj	интервью
karıştırmak	смешивание
iskelet	фреймворк
disk	диск
Kurulmuş	установлен
kraliçe	Королева
kredi	кредиты
Açıkça	явно
düzeltmek	фиксировать
sap	ручка
tatlı	милая
kriterleri	критерии
ortak	ассоциировать
ne	Небраска
davranış	поведение
büyütmek	увеличить
ışın	луч
gelir	доход
ölçmek	измерение
oy	голосов
du	дю
görev	обязанность
tartışmalar	обсуждение
ayı	медведь
kazanç	усиление
Festival	фестиваль
laboratuvar	лаборатория
okyanus	океан
uçuşlar	рейсы
uzmanlar	эксперты
işaretler	знаки
derinlik	глубина
tren	поезд
kuru	сухой
keşfetmek	исследовать
spa	спа
kavram	концепция
neredeyse	около
kullanma	обращение
Menşei	происхождения
milyar	миллиард
zeka	интеллект
satın	купил
aleyhte	против
milletler	нации
rota	маршрут
kırık	сломанный
savaş	боевой
konuşmak	говорить
protokol	протокол
sorgu	запрос
ortaklık	партнерство
ifade	выражение
es	эс
konuşma	речь
tel	провод
öneri	предложения
değiştirme	замена
bant	лента
stratejik	стратегическое
hakim	судья
asit	кислота
bayt	байтов
sent	цент
zorunlu	принудительный
uyumlu	совместимый
apartman	квартира
boş	ноль
sıfır	нуль
konuşmacı	оратор
Danışmanlık	консалтинг
tasarımcı	дизайнер
pr	пр
evlilik	брак
rulo	рулон
bankalar	банки
fr	фр
katılımcılar	участники
gizli	секрет
negatif	отрицательный
Favoriler	избранное
tiyatro	театр
yaylar	пружины
var	вар
yapmak	выполнять
çeviri	перевод
tahminler	оценки
hasar	травма
bakanlık	министерство
sürücüler	водители
avukat	адвокат
rakamlar	цифры
korumalı	защищенный
öneri	предложение
paylaşım	разделение
kapı	портал
beta	бета
bedava	бесплатно
karşı	к
hafifçe	немного
yardım	помощь
davranış	поведение
içeriyordu	содержащиеся
mevzuat	законодательство
çağrı	призвание
parametreler	параметры
profiller	профили
hususlar	вопросы
evler	дома
kontroller	управления
kombine	комбинированный
nihai	окончательный
temsilci	представитель
küçük	незначительный
bölümler	ведомства
sakinleri	жители
görüntülenen	отображается
anne	Мама
indirimli	уменьшенный
nadir	редкий
gerçekleştirilen	выполнено
aşırı	экстремальный
örnekler	образцы
Barlar	брусья
tahmin	прогноз
çıkarıldı	удален
Çevrim	цикл
içermek	содержать
doğruluk	точность
uyku	спать
mg	мг
kuş	птица
eczane	аптека
oluşturma	создание
statik	статический
avcı	охотник
adresler	адреса
bayan	леди
kristal	кристалл
ünlü	известный
yazar	писатель
başkan	председатель
içki	напиток
akademi	академия
dinamik	динамический
yemek	есть
kalıcı	постоянный
temizlik	уборка
teşkil	составляет
portföy	портфолио
pratik	практическое
teslim	доставлен
altyapı	инфраструктура
renk	цвет
satıcı	продавец
Felsefe	философия
düzenleme	регулирование
görevlileri	офицеры
amaç	цель
teklifleri	предложения
beslenme	питание
kayıt	запись
genç	младший
les	ле
pelerin	мыс
halkalar	кольца
bahşiş	наконечник
olağanüstü	замечательно
bilet	билет
açıkladı	объявленный
tahmin	Угадай
kime	кого
Futbol	футбольный
matematik	математический
ithalat	Импортировать
gönderme	проводка
varlık	присутствие
otomatik	автоматический
görüntüleme	просмотр
muhafaza	поддерживается
ch	ч
dan	Дан
köpekler	собаки
yönetmenler	директора
yönleri	аспекты
önde	впереди
ay	Луна
katılım	участие
düzen	схема
sinek	летать
tavır	манера
matris	матрица
kombinasyon	сочетание
düzeltme	поправка
kuvvet	прочность
Türkiye	Турция
kütüphaneler	библиотеки
uygun	правильный
derece	степени
işletmelerin	предприятия
delta	дельта
korku	страх
arayan	Ищу
inç	дюймов
Kongre	условность
hisseleri	акции
asıl	главный
konfor	комфорт
renkler	цвета
savaşlar	войны
sipariş	заказ
tuttu	хранится
alfa	альфа
temyiz	обращение
seyir	круиз
bonus	бонус
Hey	Привет
binalar	здания
özel	скидки
dövmek	бить
piller	батареи
olur	становится
sürücüler	диски
silâh	оружие
Çay	чай
gelişmiş	улучшен
başarmak	достигать
pozisyonları	позиции
elbise	платье
abone	подписка
satıcı	дилер
çağdaş	современный
gökyüzü	небо
ROM	ПЗУ
taşınan	осуществляется
poz	воздействие
saklamak	скрывать
imza	подпись
değirmenci	мельник
hüküm	обеспечение
çamaşırlar	одежда
çerçeveler	кадры
kesinlikle	безусловно
gazete	газета
oyuncak	игрушка
tabaka	слой
basılı	печатные
yavaş	медленный
uzaklaştırma	удаление
yükümlülük	ответственность
yazıcılar	принтеры
ekleme	добавление
yer	место
harcamak	проводить
fabrika	завод
iç	интерьер
büyümek	расти
optik	оптический
tanıtım	продвижение
bağıl	относительный
şaşırtıcı	удивительно
nokta	точка
Kimlik	идентичность
dönüştürme	преобразование
duygu	чувство
gizli	скрытый
makul	разумный
revizyon	пересмотр
etki	влияние
oran	соотношение
önem	важность
yağmur	дождь
gezegen	планета
kopyalar	копии
izin	разрешать
görme	видя
kanıt	доказательство
bas	бас
reçete	рецепт
boş	пустой
örnek	пример
delik	дыра
binmek	поездка
büro	бюро
koruma	сохранение
çift	пара
ideal	идеальный
gözlük	функции
kaydedilmiş	записанный
don	дон
parçalar	куски
bitmiş	законченный
parklar	парки
avukatları	адвокаты
stres	стресс
krem	крем
ss	сс
koşar	работает
keşfetmek	обнаружить
ap	ар
desenler	узоры
tepeler	холмы
mil	нм
danışman	консультант
farkında	знать
şekil	форма
evrim	эволюция
sertifikalar	сертификаты
hedefleri	цели
istasyonlar	станций
önerdi	предложенный
op	оп
kalıntılar	остатки
firmalar	фирмы
euro	евро
Şebeke	оператор
yapıları	сооружения
genel	общий
ansiklopedi	энциклопедия
kullanım	Применение
mürekkep	чернила
karışık	смешанный
sayım	перепись
tekerlek	колесо
tedarikçileri	поставщики
kompakt	компактный
şiir	поэзия
ışıklar	огни
izleme	отслеживание
melek	ангел
hazırlık	подготовка
girişim	попытка
kabul	получение
maçlar	Матчи
uyum	соответствие
Genişlik	ширина
motorlar	двигатели
unutmak	забывать
dizi	массив
tartışılan	обсуждается
doğru	точный
iklim	климат
Yunan	греческий
talimat	инструкция
yönetme	управление
çiğ	сырье
farklar	различия
açıklamak	объяснять
kurmak	установить
ifade	выраженный
derece	степень
keskin	острый
ben	Бен
paragraf	параграф
öldürmek	убийство
matematik	математика
tazminat	компенсация
ihracat	экспорт
yöneticileri	менеджеры
modüller	модули
yürütülen	проведены
versiyonları	версии
bilir	знает
tanımlamak	описывать
vatandaşlar	граждане
miras	наследие
sorun	беда
Koç	тренер
tarım	сельскохозяйственное
genişletmek	расширять
seyirci	аудитория
atanmış	назначенный
koleksiyonları	коллекции
yaşlar	возраст
uzman	специалист
pişirmek	готовить
etkilemek	аффект
bakire	девственница
deneyimli	опытный
soruşturma	расследование
kalkık	поднятый
şapka	шапка
kurum	учреждение
yönlendirilmiş	направленный
etkilenmiş	пострадавших
bisiklet	велосипед
bütünüyle	полностью
plaka	пластина
giderler	затраты
belirtmek	указывать
sarışın	блондинка
kovuşturma	производство
favori	любимый
karakteristikleri	характеристики
der	дер
kaybetmek	потерять
organik	органический
aramak	искать
deneyimler	опыт
albüm	альбомы
sözleşmeler	контракты
misafir	гости
barındırılan	состоялся
hastalıklar	болезни
ilişkin	относительно
eşdeğer	эквивалент
kimya	химия
kitleri	комплекты
mantık	логика
prens	принц
daire	круг
toprak	почва
Psikoloji	психология
ıslak	влажный
koşullar	обстоятельства
yatırımcı	инвестор
temel	элементарный
sponsorlar	спонсоры
tilki	лиса
sınırsız	неограниченный
yanıtlamak	отвечать
boyutları	размеры
sade	гладкий
çıkış	Выход
kol	рука
anahtarlar	ключи
dalga	волна
kutsal	святой
eylemler	акты
rehberlik	руководство
iz	след
sembol	символ
karayolu	шоссе
gözlenen	наблюдаемый
dekan	декан
kurmak	настроить
anket	голосование
stilleri	стили
dolu	заполненный
bağ	связь
kanallar	каналы
apandis	приложение
çikolata	шоколад
kısım	часть
kapsam	объем
satıcı	поставщик
kablolar	кабели
pamuk	хлопок
gereklilik	требование
öldürdü	убитый
sınır	граница
eski	древний
tartışma	обсуждение
temsilcileri	представители
başlar	начинается
gebelik	беременность
konumlar	достопримечательности
bilgili	научился
işlemler	операции
kâşif	исследователь
tarihi	исторический
koca	муж
yetkili	уполномоченный
çılgın	псих
yaklaşan	предстоящий
konser	концерт
Skorlar	множество
verim	эффективность
komedi	комедия
benimsenen	принят
verimli	эффективное
doğrusal	линейный
taahhüt	обязательство
uzmanlık	специальность
ayılar	медведи
atlama	хмель
taşıyıcı	перевозчик
sabit	постоянная
Visa	виза
ağız	рот
metre	метр
bağlantılı	связанный
görüşmeler	интервью
kavramlar	концепции
tabanca	пистолет
yansıtmak	отражать
saf	чистый
cehennem	ад
meyve	фрукты
başlar	начинается
nitelikli	квалифицированный
reform	реформа
lens	объектив
işlenmiş	обрабатывали
keşif	открытие
çekmek	привлечь
sınıflandırılmış	объявление
üstlenmek	предполагать
ittifak	союз
onaylamak	подтвердить
mühendis	инженер
tutarlı	последовательный
değiştirmek	замещать
Boşluk	зазор
dönüştürücü	конвертер
organizasyon	организация
bebek	младенец
çekler	проверки
ulaştı	достиг
olma	становление
amaç	задача
belirtilen	указанный
şeker	сахар
mürettebat	экипаж
bacaklar	ноги
Çubuk	придерживаться
ilişki	связь
etkin	включен
Tür	жанр
gönüllü	доброволец
arka	задний
demokratik	демократической
artırmak	усилить
kesin	точный
ciltli	связанный
parametre	параметр
işlemci	процессор
düğüm	узел
biçimsel	формальный
fırtına	буря
mikro	микро
kolejler	колледжи
mil	мили
zorluklar	проблемы
editörler	редакторы
yüce	высший
Kardeşler	братья
tanıma	признание
ref	ссылка
tahmin	оценить
çocuk	дитя
teftiş	осмотр
tüketicilerin	потребители
sınırları	пределы
bölge	территория
silahlar	оружие
gecikme	задержка
pilot	пилот
katkıları	взносы
sürekli	непрерывный
girişim	инициатива
yeni	роман
icra	выполнение
sakatlık	инвалидность
ultra	ультра
kazanan	победитель
bölüm	эпизод
çömlekçi	гончар
tabak	блюдо
oyunlar	игры
bülten	бюллетень
ia	Айова
değiştirmek	модифицировать
gerçekten	действительно
Evren	вселенная
aday	кандидат
yarık	слот
ödenmemiş	выдающийся
Ha	ха
planlı	планируемый
loca	домик
ayna	зеркало
turnuva	турнир
düşünce	рассмотрение
oturumları	сессий
çekirdek	ядро
alıcılar	покупатели
dergi	журналы
gri	серый
katalog	каталог
yüklü	заряженный
geniş	широкий
und	унд
seçilmiş	выбранный
gösteri	демонстрация
nefret	ненавидеть
terminal	Терминал
yayıncılar	издатели
gece	ночью
sıvı	жидкость
pirinç	рис
rezervasyon	бронирование
gıdalar	продукты
bekçi	охрана
tasarruf	экономия
imparatorluk	империя
yeni	вновь
yükseltmek	повышение
yasadışı	нелегальный
genişleme	расширение
başbakan	премьер
yarın	завтра
Süt	молоко
dram	драма
ziyaret	посещение
yarışma	конкурс
toplanmış	собранный
bantları	группы
uygun	подходящее
kesinlikle	абсолютно
denetim	аудит
bölme	камера
Gine	Гвинея
bulgular	Выводы
iso	ISO
tipik	типичный
toplam	сумма
tavuk	курица
geçici	временный
katılmak	посещать
duş	душ
gönderme	отправка
yeterli	достаточно
kabuk	оболочка
il	провинция
liberal	католик
Vali	губернатор
bira	пиво
katkı	вклад
formül	формула
anayasa	конституции
paketleme	упаковка
dürüst	надежный
şüphe	сомнение
kazanmak	зарабатывать
dönemleri	периодов
saldırılar	нападки
mal	товар
semptomlar	симптомы
anıt	мемориал
ikiz	близнец
eklemek	вставить
geçit	шлюз
çizim	Рисование
adaylar	кандидаты
düzenli	приказал
biyolojik	биологический
kavga	борьба
geçiş	переход
tercihleri	предпочтения
casus	шпион
romantik	романс
enstrüman	инструмент
Bölünmüş	Трещина
temalar	темы
güçler	полномочия
cennet	небо
bit	биты
hamile	беременная
sınıflandırma	классификация
odaklı	сосредоточены
doktor	врач
sormak	просить
bloklar	блоки
bak	вот
manevi	духовный
diyabet	диабет
mi	мл
vardiya	сдвиг
oturmak	сидеть
bedenler	тела
fotoğraflar	фотографии
kesim	резка
yazarlar	писатели
esnek	гибкий
sevilen	любимый
Favoriler	избранное
haritalama	отображение
sayısız	многочисленные
Nispeten	относительно
temsil	представляет
üstün	превосходящий
tercihli	предпочтительным
kaydedilmiş	сохранены
entellektüel	интеллектуальной
verilmiş	предоставляется
karbon	углерод
rahat	удобный
manyetik	магнитные
etkileşim	взаимодействие
dinleme	прослушивание
kriz	кризис
görünüm	прогноз
masif	массивный
parlak	яркий
oluşturulan	сформированный
piyano	пианино
Eko	эхо
devrim	революция
görüntüler	дисплеи
plazma	плазма
kazanç	прибыль
gizem	тайна
peyzaj	пейзаж
mekanik	механический
seyahat	поездка
afiş	баннер
incir	инжир
ilçeler	графств
edinme	получение
tanınan	признанное
rüyalar	мечты
bildirim	уведомление
kilogram	кг
öğretmek	учат
hızlı	быстрый
Çek	вытащить
ut	Юта
seminer	семинар
yatırımlar	вложения
tekerlekler	колеса
belirtmek	указывать
hassas	чувствительный
şablonları	шаблоны
formatları	форматы
tutar	держит
yönlendirici	маршрутизатор
beton	бетон
si	си
Klasör	папка
tamamlama	завершение
nabız	пульс
teknik	техника
oylama	голосование
mahkemeler	суды
dönüştürülmüş	переоборудованный
metro	метро
yıldönümü	Годовщина
iyileştirmeler	улучшения
şerit	полоса
Şartname	Спецификация
kaza	авария
Nick	Ник
ulaşılabilir	доступной
oturan	резидент
arsa	сюжет
tipik	типично
temsil	представление
pompa	насос
var	существует
düzenlemeler	договоренности
konferanslar	конференций
tüketim	потребление
dar	узкий
tehdit	угроза
anketler	опросы
oturma	сидящий
danışman	консультант
kontrolör	контроллер
komiteler	комитеты
penis	пенис
kale	замок
bahçeleri	сады
etiketler	этикетки
istekli	готовы
biyo	био
oyunculuk	действующий
kafaları	руководители
sınav	экзамен
Konut	резиденция
yoğunluk	плотность
yüz	сто
garip	странный
sürdürülebilir	устойчивый
istatistiksel	статистический
Anma	упомянуть
yenilik	инновация
gri	серый
paralel	параллельно
işletmek	работать
fatura	банкноты
kararlı	стабильный
tanımlar	определения
von	фон
doktorlar	врачи
ders	урок
sinema	кино
seçimler	выборы
reaksiyon	реакция
boş	пустой
gelişmiş	повышенная
adlı	озаглавленный
şiddetli	серьезный
üretmek	генерировать
gazeteler	газеты
hastaneler	больницы
vi	VI
Mizah	юмор
yaşlı	престарелый
monitör	мониторы
istisna	исключение
süre	продолжительность
kütle	насыпной
ziyaret	посещения
yetenekleri	возможности
tavsiye	рекомендация
günah	грех
örgütlü	организованная
ba	ба
paragraf	пункт
Benimseme	принятие
geliştirme	улучшение
pahalı	дорогая
bizon	буйвол
organizasyonlar	организации
uçak	самолет
programlar	программы
mekanizma	механизм
ee	й
işaretlenmiş	отмеченный
tahrik	управляемый
şişe	бутылка
yenilikçi	инновационный
masaj	массаж
Sonuç	вывод
kapanış	закрытие
bin	тысяча
efsane	легенда
villa	вилла
kemik	кость
sütunlar	столбцы
bozukluklar	расстройства
işbirliği	сотрудничество
bulma	обнаружение
iç	внутренний
formasyon	образование
med	мед
mühendisler	инженеры
varlık	организация
yolculukları	круизы
kapı	Ворота
Roma	Римский
görevleri	обязанности
erotik	эротический
ton	тон
ahlâk	этика
Ejderha	Дракон
meşgul	занятый
Kaptan	капитан
getiriyor	приносит
ısıtma	обогрев
bacak	ножка
boyun	шея
kanat	крыло
senaryo	скрипты
ABC	азбука
döşenmiş	назначенный
muamele	дело
işlemek	совершить
Demiryolu	рельс
gezileri	поездки
boşluk	разрыв
taraf	стороны
tüp	трубка
uyan	соответствующий
açıklamaları	описания
kemer	ремень
ceket	куртка
animasyon	анимация
torpil	оракул
er	эр
yapımları	производства
havacılık	авиация
gururlu	гордый
afet	катастрофа
konsol	консоль
komutlar	команды
jr	младший
telekomünikasyon	связь
eğitmen	инструктор
dev	гигант
elde	достигнутый
yaralanmalar	травмы
yaklaşımlar	подходы
olağan	обычный
pullar	Марки
açı	угол
soymak	грабить
tasarımcılar	дизайнеры
özgürlük	свобода
çağ	эпоха
dönüştürmek	конвертировать
olasılık	возможность
analist	аналитик
tehlikeli	опасно
güvenilirlik	надежность
sırasıyla	соответственно
gönüllüler	добровольцы
türetilmiş	полученный
Zevk	удовольствие
Onur	честь
yönlü	ориентированного
kartal	орел
namaz	молитва
atölyeler	мастерские
kasırga	ураган
sessiz	тихо
yapımcı	режиссер
temsil	представленный
sorumluluklar	обязанности
peynir	сыр
dikkatlice	внимательно
verimlilik	производительность
taç	корона
eşitlik	паритет
Teşhis	диагностика
yapıcı	производитель
çatlak	трещина
prensip	принцип
seçtikleri	кирки
çete	банда
fetiş	фетиш
görünüm	появление
duman	дым
filtreler	фильтры
Anonim	включенный
zanaat	ремесло
adam	человек
kör	слепой
salon	гостиная
deli	Сумасшедший
algoritma	алгоритм
şiddetle	сильно
kafe	кафе
ken	кругозор
proteinler	белки
su	су
tanıdık	знакомые
yetenekli	способный
kabul	вход
ayakkabı	башмак
seçildi	избран
taşıma	проведение
terörizm	терроризм
sevinç	радость
sürümleri	издания
etnik	этнической
parlamento	парламент
aktör	актер
buluntular	находки
mühür	печать
durumlar	ситуации
beşinci	пятый
vatandaş	гражданин
dikey	вертикальный
düzeltmeler	поправки
açıklar	описывает
engelli	инвалидов
madde	вещество
yasak	запрещено
boru	труба
askerler	солдаты
Gardiyan	опекун
ders	лекция
simülasyon	моделирование
düzen	расположение
girişimler	инициативы
hasta	больной
konsantrasyon	концентрация
yatırmak	прокладывать
yorumlama	интерпретация
kirli	грязный
öğretilen	учил
işçi	работник
optimizasyon	оптимизация
tapınak	храм
maddeler	вещества
kanıtlamak	доказывать
keşfedilen	обнаруженный
kanatlar	крылья
genetik	генетический
kısıtlamalar	ограничения
ince	тонкий
sergi	выставка
sırt	хребет
modem	модем
getiren	приведение
hasta	больной
değerlendirmek	оценивать
tropikal	тропический
toplamak	собирать
vektör	вектор
kesinlikle	определенно
döndürme	превращение
varoluş	существование
yorum	комментарий
gelişmeler	события
göç	иммиграция
yerler	направления
karşılıklı	взаимное
sözdizimi	синтаксис
li	литий
nitelik	атрибут
hapis	тюрьма
beceri	умение
sandalye	стулья
çevreleyen	окружающих
dağlar	горы
popülerlik	популярность
soruşturma	запрос
kontrol	проверено
sergi	экспонат
atmak	бросать
akım	тенденция
kediler	коты
çöl	пустыня
ya	я
koordinatör	координатор
Merkür	Меркурий
yanan	сжигание
kaçış	побег
alıcı	получатель
ilerici	прогрессирующий
tekneler	лодки
şampiyonluk	чемпионат
çarşı	аркада
imkansız	невозможно
anlatır	говорит
açık	очевидный
depresyon	депрессия
grafik	график
kaplama	покрытие
platin	платина
yargı	суждение
görüşmeler	переговоры
dosyalama	подача
beslemek	способствовать
layık	награжден
denemeler	испытания
ustaları	мастера
kartuş	картридж
açıklama	объяснение
org	организация
dolandırıcılık	мошенничество
elektrik	электричество
spektrum	спектр
varış	прибытие
çömlekçilik	керамика
vurgu	акцент
müthiş	здорово
onaylı	подтвердил
sayımları	счетчики
kaza	авария
asansör	лифт
arası	между
yükseklikleri	высоты
gölge	тень
gider	расходы
girişim	предприятие
klinik	клиника
şifa	исцеление
prenses	принцесса
girme	входящий
paket	пакет
stüdyoları	студии
ilgi	участие
baba	папа
düğmeleri	кнопки
yerleştirme	размещение
gözlemler	наблюдения
kazananlar	победители
yollar	дороги
sonraki	последующий
avlu	двор
ifşa	раскрытие
kuruluş	создание
hatıralar	воспоминания
te	тэ
yaratır	создает
yüzleri	лица
turist	турист
cinayet	убийство
yeterli	адекватный
senatör	сенатор
sunumlar	презентации
özet	дайджест
toz	пыли
wiki	вики
değiştirilir	заменены
radar	радиолокационный
kayıplar	потери
savaş	бой
indirgen	сокращение
durduruldu	остановился
Meslek	занятие
yakından	тесно
radyasyon	излучение
krallar	короли
çekim	стрельба
kulak	ухо
bayraklar	флаги
fırıncı	пекарь
muhafazakâr	консервативный
şok	шок
etki	эффективность
kravat	галстук
çatı	крыша
göstermek	демонстрировать
atmosfer	атмосфера
öpücük	поцелуй
canavar	зверь
ra	ра
ameliyat	управляемый
deney	эксперимент
hedefler	цели
alımları	покупки
federasyon	федерация
Pizza	пицца
davet	приглашенный
atama	назначение
şık	модификация
sorguları	запросы
yokluk	отсутствие
satıcıları	поставщики
yoga	йога
vermektedir	служит
sürpriz	сюрприз
Lamba	лампа
espriler	шутки
danışmanlık	консультирование
Saray	дворец
memnun	доволен
kazanç	победы
depo	склад
sözde	предполагаемый
sıradan	обычный
hayalet	призрак
ihlal	нарушение
patron	босс
gurur	гордость
beklentiler	ожидания
bağımsızlık	независимость
bilme	знание
muhabir	репортер
metabolizma	метаболизм
şampiyon	чемпион
Şahsen	лично
bol	много
solo	соло
boğaz	горло
servet	богатство
vakum	вакуум
dans	танцы
tanımak	признать
yazıyor	пишет
plaza	площадь
araştırma	поиск
Yayınla	публиковать
tarama	скрининг
trans	транс
öncü	пионер
unutulmuş	забытый
akrobat	акробат
plakalar	тарелки
denemeler	эссе
davranış	поведение
söylüyorum	говоря
oldukça	довольно
akıllı	умный
modları	режимы
yükümlülük	обязательство
liman	гавань
gezgin	путешественник
bölüm	сегмент
düşman	враг
bulmaca	головоломка
kuyular	углубления
kısıtlı	ограниченный
cumhuriyetçi	республиканец
sırlar	секреты
sendrom	синдром
katılım	посещаемость
ceza	штраф
davul	барабан
sağlayan	позволяет
kurucu	строитель
manzara	перспектива
sel	наводнение
kolaylaştırmak	легкость
argümanlar	аргументы
arena	арена
maceralar	приключения
öğrenciler	зрачки
duyuru	объявление
sonuç	исход
anlamak	ценить
genişletilmiş	расширенный
yetişkin	взрослый
güzel	прекрасный
merkezleri	центры
fıkra	пункт
gülümseme	улыбка
topraklar	земли
asker	войска
silâhlı	вооруженный
çam	сосна
soğutma	охлаждение
körfez	залив
kamyonlar	грузовики
mekanizmalar	механизмы
boşanma	развод
gelenek	традиция
haplar	таблетки
kaplan	тигр
arkadaşlar	люди
algılayıcı	датчик
maruz	подвергаются
av	охота
melekler	ангелы
milletvekili	заместитель
Tayland	тайский
emisyonları	выбросы
hekimler	врачи
şikâyet	жалоба
sahneler	сцены
deneyler	эксперименты
artırmak	увеличение
Yönetim	управление
değirmen	мельница
kurulmuş	основанный
kronik	хронический
den	логово
parmak	Палец
tutar	держит
pound	фунт
yerleştirmek	разместить
pl	пл
eğitilmiş	обученный
uygulanması	реализации
ekmek	хлеб
motorlar	моторы
sert	жесткий
olay	инцидент
dinamik	динамика
Yalan	ложь
konuşma	разговор
azaltmak	снижение
ibadet	поклонение
kabiliyet	возможность
ak	Аляска
hassas	точность
tazminat	убытки
rezervler	резервы
çözmek	решать
azınlık	меньшинство
çeşitli	разнообразный
malzemeler	ингредиенты
Ah	ах
sesleri	тоны
rehabilitasyon	реабилитация
görme	взгляд
kil	глина
zayıf	слабый
bölünmüş	разделенный
resepsiyon	прием
bilge	мудрый
olasılık	шансы
seminer	семинары
sonuçları	последствия
vericiler	производители
coğrafya	география
bütünlük	целостность
miras	наследие
memnun	довольный
Tehlike	Опасность
vitamin	витамин
işlenmiş	обработанный
ifade	фраза
yükselen	привлечение
etkileri	последствия
işlevselliği	функциональность
cennet	рай
melez	гибридный
okur	читает
duygusal	эмоциональный
şan	слава
ja	JA
coğrafi	географический
aşmak	превышать
çubuk	стержень
ipek	шелк
bebekler	дети
bi	би
romantik	романтик
ortaya	показал
uzmanlar	специалисты
jeneratör	генератор
süspansiyon	подвеска
üzgün	грустный
düzeltme	коррекция
Kurt	волк
yavaşça	медленно
ek	дополнение
bölümleri	участки
bebek	младенец
sektörler	секторов
akışkan	жидкость
zeminler	основания
yemek	еда
ta	та
makinalar	машины
denklem	уравнение
sepetler	корзины
olasılık	вероятность
boyut	измерение
okudu	изучал
kar	доходы
şeytan	дьявол
çimen	трава
resimli	иллюстрированный
Kiraz	вишня
kıta	континентальный
başarı	достижение
sınırlamaları	ограничения
cenaze	похороны
bölümler	главы
yolcu	пассажир
uygun	удобный
Mars	Марс
boy	размера
Yumurta	яйцо
sinyalleri	сигналы
oryantasyon	ориентация
Çalınması	кража
çocukluk	детство
semboller	символы
lat	Lat
meta	мета
analog	аналоговый
yetenek	талант
tarihli	датированный
bilgelik	мудрость
sınır	граница
seçkinler	элита
gi	солдат
inanır	считает
şiirler	стихи
yargı	юрисдикция
robot	робот
sergileyen	отображение
tanık	свидетель
donanımlı	оборудованный
aşamaları	этапы
sur	сюр
Edinilen	приобретенный
belirlemek	оценить
yıkama	мыть
Giriş	вход
deklarasyon	декларация
kaybetme	проигрыш
denemeler	попытки
asil	благородный
otomasyon	автоматизация
etkiler	воздействие
devir	оборот
avantajları	преимущества
şövalye	рыцарь
Amaçları	цели
uzantılar	расширения
itirazlar	апелляции
hastalık	болезнь
ho	эй
alternatifleri	альтернативы
sh	ш
sabun	мыло
reçel	варенье
olağandışı	необычный
cevap	ответил
imha	разрушение
göç	миграция
düzensizlik	расстройство
Konvansiyonel	обычный
giyme	носить
eksen	ось
aranan	искать
genler	гены
medyan	медиана
tarayıcı	сканер
burada	здесь
canlandırılmış	мультипликационный
ayarlama	регулировка
kahraman	герой
tedaviler	лечение
tutum	отношение
halı	ковер
lensler	линзы
katıldı	участие
zorluk	трудность
punk	панк
koalisyon	коалиция
kayıt	регистрация
dük	герцог
hız	темп
üreticileri	производители
yay	дуга
arayüzleri	интерфейсы
Atlas	атлас
gözlem	наблюдение
işkence	пытки
silindi	удаленный
ceket	Пальто
restorasyon	восстановление
Kolaylık	удобство
dönen	возврате
muhalefet	оппозиция
konteyner	контейнер
sanık	ответчик
gözetmen	руководитель
kolordu	корпус
aktörler	актеры
karaciğer	печень
sorumlu	подлежащий
dilekçe	петиция
anten	антенна
seçilmiş	выбрал
inanç	вера
öldürme	убийство
omuz	плечо
dekor	оформление
iyon	ион
çap	диаметр
podcast	подкаст
etkileşimler	взаимодействия
şarkıcı	певец
haberci	вестник
yaşlanma	старение
müdahale	вмешательство
Eklenti	плагин
cazibe	Привлечение
dalış	дайвинг
değişiklik	модификация
varsaymak	предполагать
kamış	тростник
dahil	включать
ılımlı	умеренный
fareler	мышей
anladım	понимать
hızla	быстро
yasak	запрет
güvence	гарантия
olay	происходит
Muazzam	огромный
üreticiler	мельницы
taslak	контур
aldığı	получает
kot	джинсы
derleme	сборник
garip	странный
sigma	сигма
gr	гр
çekici	привлекательный
fırsat	повод
kayıtları	записи
kurban	жертва
talepler	требования
dikkatli	осторожный
kiriş	луч
Bahçıvanlık	садоводство
yükümlülükleri	обязательства
varmak	прибыть
orkestra	оркестр
lisans	лицензия
ayarlanabilir	регулируемый
tahsis	распределение
deneme	сочинение
gösterdi	продемонстрировал
diyalog	диалог
kampları	лагеря
beyan	объявленный
iz	след
kapamak	закрыть
paketleri	пакеты
