arasında	из
için	в
içinde	в
için	для
olduğu	является
üzerinde	на
o	что
tarafından	от
bu	это
ile	с
ben	я
sen	вы
o	Это
veya	или
olmak	быть
Hangi	находятся
en	в
herşey	все
var	иметь
yeni	новый
Biz	мы
irade	будем
ev	Главная
bize	нас
hakkında	около
Eğer	если
sayfa	страница
benim	мой
vardır	имеет
arama	поиск
ücretsiz	свободно
fakat	но
bizim	наш
bir	один
diğer	Другие
yap	делать
bilgi	Информация
zaman	время
o	он
hangi	который
onların	их
haber	Новости
kullanım	использование
Orada	там
görmek	видеть
yani	так
kim	кто
ağ	Web
Ayrıca	также
almak	получить
pm	вечера
görünüm	Посмотреть
c	с
e	е
ilk	первый
olmuştur	было
olur	бы
idi	мы
s	s
sevmek	как
x	Икс
göre	чем
bulmak	найти
fiyat	цена
geri	назад
üst	Вверх
insanlar	люди
vardı	имел
liste	список
isim	имя
sadece	просто
yıl	год
gün	день
içine	в
iki	два
sağlık	здоровье
n	N
yeniden	ре
Kullanılmış	используемый
gitmek	идти
b	б
son	последний
Yapmak	делать
onları	их
meli	должен
ürün	продукт
sistem	система
posta	после
ona	ее
Kent	город
t	T
politika	политика
numara	номер
destek	поддержка
mesaj	сообщение
sonra	после
sonra	тогда
Ocak	январь
iyi	хорошо
d	d
nerede	где
bilgi	Информация
haklar	права
kitaplar	книги
yüksek	высокая
okul	школа
m	м
her	каждый
bağlantılar	связи
o	она
yıl	лет
sipariş	заказ
çok	очень
kitap	книга
ürün	Предметы
şirket	Компания
r	р
okumak	читать
grup	группа
seks	секс
çok	многие
kullanıcı	пользователь
de	де
set	задавать
genel	Генеральная
Araştırma	исследование
Üniversite	Университет
Ocak	январь
posta	почта
tam	полный
yorumlar	отзывы
program	программа
bilmek	знать
oyunlar	игры
yol	путь
günler	дней
p	п
Bölüm	часть
could	мог
harika	Великий
birleşmiş	единый
gerçek	реальный
f	е
Uluslararası	Международный
merkez	центр
seyahat	путешествовать
yorumlar	Комментарии
yapılmış	сделал
gelişme	развитие
rapor	доклад
üye	член
ayrıntılar	Детали
hat	линия
şartlar	сроки
önce	до
oteller	отели
did	сделал
göndermek	Отправить
sağ	правильно
tip	тип
yerel	местный
bu	те
Sonuçlar	Результаты
ofis	офис
Ulusal	национальный
araba	автомобиль
dizayn	дизайн
almak	принимать
gönderildi	отправил
adres	адрес
topluluk	сообщество
içinde	в
devletler	состояния
istemek	хотеть
telefon	Телефон
DVD	DVD
konu	предмет
arasında	между
forum	Форум
aile	семья
l	L
uzun	длинный
w	вес
göstermek	показать
O	о
Üstelik	даже
siyah	черный
özel	особый
indeks	индекс
olmak	являющийся
KADIN	женщины
çok	много
işaret	знак
dosya	файл
bağlantı	ссылка
açık	открытый
güney	юг
dava	дело
proje	проект
sayfalar	страницы
versiyon	версия
Bölüm	раздел
kendi	своя
ev	дом
güvenlik	безопасность
g	г
kontluk	округ
Amerikan	американский
Fotoğraf	Фото
oyun	игра
üyeler	члены
güç	мощность
ağ	сеть
bilgisayar	компьютер
sistemler	системы
üç	три
yer	место
son	конец
h	час
onu	его
başına	в
erişim	доступ
düşünmek	думать
kuzeyinde	север
kaynaklar	Ресурсы
şimdiki	текущий
büyük	большой
medya	СМИ
kanun	закон
kontrol	контроль
Su	воды
Tarihçe	история
boyut	размер
kişisel	личный
kılavuz	руководство
Dükkan	магазин
rehber	каталог
değişiklik	изменение
beyaz	белый
Metin	текст
küçük	маленький
değerlendirme	рейтинг
oran	ставка
hükümet	правительство
çocuklar	дети
dönüş	вернуть
öğrencilerin	студенты
v	v
hesap	Счет
zamanlar	раз
seviye	уровень
dijital	цифровой
profil	профиль
önceki	предыдущий
form	форма
olaylar	Мероприятия
Aşk	люблю
eski	старый
John	Джон
ana	главный
aramak	вызов
görüntü	образ
Bölüm	отдел
Başlık	заглавие
olmayan	не
k	К
y	Y
sigorta	страхование
acak	должен
özellik	имущество
sınıf	класс
CD	CD
kalite	качественный
her	каждый
listeleme	список
içerik	содержание
ülke	страна
küçük	немного
araçlar	инструменты
düşük	низкий
cevap	Ответить
müşteri	клиент
Aralık	Декабрь
karşılaştırmak	сравнить
filmler	кино
kolej	колледж
değer	стоимость
makale	статья
adam	человек
Meslekler	работы
j	J
Gıda	питание
yazar	автор
farklı	другой
u	U
öğrenmek	учить
satış	продажа
baskı	Распечатать
kurs	курс
iş	работа
oda	комната
Stok	акции
Eğitim	обучение
çok	слишком
kredi	кредит
puan	точка
Bilim	наука
erkekler	люди
kategoriler	категории
batı	запад
bak	смотреть
ingilizce	английский
takım	команда
arazi	имущество
Kutu	коробка
koşullar	условия
fotoğraflar	фото
eşcinsel	гей
iplik	нить
kategori	категория
Not	заметка
canlı	жить
büyük	большой
galeri	галерея
tablo	Таблица
ancak	Однако
Haziran	июнь
Ekim	октябрь
Kasım	ноябрь
Market	рынок
kütüphane	библиотека
aksiyon	действие
başla	Начало
dizi	серии
Özellikler	функции
hava	воздух
sanayi	промышленность
plan	план
insan	человек
Evet	да
ikinci	второй
Sıcak	горячий
maliyet	Стоимость
film	кино
forumlar	форумы
Mart	Март
la	ля
Eylül	сентябрь
söylemek	сказать
gidiyor	собирается
tıbbi	медицинская
arkadaş	друг
Aralık	декабрь
sunucu	сервер
uygulama	заявление
Personel	сотрудники
oyun	играть
sorunlar	вопросы
Nisan	апрель
kullanıcılar	пользователи
sokak	улица
konu	тема
karşısında	против
var	получил
Blog	блог
Parti	вечеринка
ödeme	оплата
ekipman	оборудование
let	позволять
programlar	программы
yasal	правовой
son	недавний
park	парк
davranmak	акт
sorun	проблема
kırmızı	красный
vermek	дайте
bellek	Память
performans	представление
sosyal	Социальное
q	Q
Öykü	история
satmak	продавать
seçenekleri	опции
deneyim	опыт
anahtar	ключ
vücut	тело
genç	молодой
önemli	важный
alan	поле
az	мало
Doğu	восток
tek	Один
ii	б
yaş	возраст
kulüp	клуб
örnek	пример
kızlar	девочки
z	Z
yol	Дорога
hediye	подарок
soru	вопрос
CA	Калифорния
zor	жесткий
ödeme	платить
dört	четыре
poker	покер
konu	вопрос
menzil	ассортимент
bina	здание
satıcı	продавец
mahkeme	суд
Şubat	февраль
sonuç	результат
ışık	легкий
yazmak	записывать
savaş	война
teklif	предлагает
mavi	синий
gruplar	группы
ark	аль
kolay	легко
verilmiş	данный
istek	запрос
faks	факс
Çin	Китай
yapma	изготовление
resim	картина
ihtiyaçlar	потребности
mümkün	возможное
ay	месяц
majör	главный
star	звезда
gelecek	будущее
uzay	пространство
Kurul	комитет
el	рука
Güneş	солнце
kartları	карты
Londra	Лондон
toplantı	встреча
olmak	стали
çocuk	ребенок
Tut	держать
porno	порно
pay	доля
benzer	аналогичный
Bahçe	сад
okullar	школы
milyon	миллиона
katma	добавленной
referans	Справка
şirketler	компании
bebek	детка
öğrenme	обучение
enerji	энергия
koşmak	бег
teslim	Доставка
popüler	популярный
terim	срок
film	фильм
hikayeleri	истории
koymak	положил
dergi	журнал
raporlar	отчеты
ko	Колорадо
Deneyin	пытаться
Görüntüler	изображений
ihbar	уведомление
Allah	Бог
orijinal	оригинал
kafa	глава
radyo	радио
hücre	клетка
konsey	совет
içerir	включает
Izlemek	трек
tartışma	обсуждение
Arşiv	архив
diğerleri	другие
anlaşma	соглашение
biçim	формат
toplum	общество
ay	месяцы
Emniyet	безопасность
Arkadaş	друзья
emin	конечно
baskı	издание
mesajları	Сообщения
pazarlama	маркетинг
söylemek	рассказать
birleşme	ассоциация
sağlar	обеспечивает
eğlence	весело
zaten	уже
yeşil	зеленый
çalışmalar	исследования
kapat	Закрыть
ortak	общий
özel	конкретный
birkaç	несколько
yaşam	живой
Toplamak	коллекция
denilen	называется
kısa	короткая
sanat	искусства
çok	много
Sor	просить
sınırlı	ограниченное
çözeltiler	решения
yönetmen	директор
plaj	пляж
geçmiş	мимо
doğal	натуральный
elektronik	электроника
üzerine	на
dönem	период
planlama	планирование
diyor	говорит
resmi	официальный
mar	март
tamam	сделанный
teknik	технический
pencere	окно
profesyonel	профессионал
bölge	область
ada	остров
kayıt	запись
direkt	непосредственный
konferans	конференция
kayıtlar	учет
st	улица
ilçe	район
takvim	календарь
maliyetler	расходы
stil	стиль
Beyan	заявление
mil	миль
kaynak	ресурс
uygulamaları	Приложения
belge	документ
sözcük	слово
Eserleri	работает
malzeme	материал
fatura	законопроект
yazılı	написано
kurallar	правила
nihai	окончательный
şey	вещь
merkez	центр
Gereksinimler	требования
DOĞRU	ПРАВДА
dakika	минут
Başka	еще
işaret	отметка
Kaya	камень
kötü	Плохо
bireysel	индивидуальный
artı	плюс
Oto	авто
kapak	обложка
Düzenle	редактировать
birlikte	вместе
videolar	видео
hızlı	быстро
fonksiyon	функция
gerçek	факт
alma	получение
global	Глобальный
teknoloji	тек
karşılamak	встретить
uzak	далеко
ekonomik	экономической
tr	ан
oyuncu	игрок
projeler	проектов
Miktar	количество
izlemek	смотреть
dahil	включены
hissetmek	Чувствовать
banka	банка
risk	риск
fırsatlar	предложения
çeşitli	различный
kelimeler	слова
üretim	производство
ticari	коммерческая
ağırlık	вес
kalp	сердце
tedavi	лечение
makas	точки
bilgi	знание
dergi	журнал
hata	ошибка
kamera	камера
kız	девушка
inşaat	строительство
oyuncaklar	игрушки
kayıtlı	зарегистрированный
domain	домен
yöntemleri	методы
bölüm	глава
koruma	защита
politikaları	полисы
geniş	широкий
güzellik	красота
müdür	менеджер
Hindistan	Индия
pozisyon	должность
alınmış	взятый
çeşit	Сортировать
listeleri	объявления
bilinen	известен
yarım	половина
vakalar	случаи
adım	шаг
mühendislik	инжиниринг
basit	просто
hızlı	быстро
lisans	лицензия
göl	озеро
bütün	все
yıllık	годовой
yayınlanan	опубликованный
kilise	церковь
yöntem	метод
aktif	активный
tepki	ответ
şekil	фигура
malzemeler	материалы
yeterli	достаточно
tasarlanmış	предназначенный
arasında	среди
ölüm	смерть
kayıp	потеря
yüz	лицо
marka	марка
indirim	скидка
Etkileri	последствия
oluşturulan	созданный
standartlar	стандарты
bit	немного
siyasi	политическая
krallık	Королевство
baz	база
iş	дела
krediler	кредитование
ayakkabı	обувь
giriş	запись
kalmak	оставаться
emirler	заказы
kullanılabilirlik	доступность
özet	резюме
dönüş	очередь
büyüme	рост
Ajans	агентство
kral	король
Avrupa	Европейская
aktivite	Мероприятия
kopya	копия
batı	вестерн
Kuvvet	сила
iş	занятость
Defne	залив
nehir	река
komisyon	комиссия
paket	пакет
görüldü	видели
oyuncu	игроки
motor	двигатель
Liman	порт
albüm	альбом
bölgesel	региональный
durdurmak	стоп
başladı	начал
yönetim	администрация
bar	бар
enstitü	институт
görünümler	Просмотры
çift	двойной
köpek	собака
yakında	скоро
hatlar	линии
elektronik	электронный
faydaları	выгоды
gerekli	необходимый
yazıcı	принтер
şart	состояние
etkili	эффективный
inanmak	верить
organizasyon	организация
Efekt	эффект
us	разум
seçim	выбор
kumarhane	казино
pdf	PDF
tur	тур
çapraz	пересекать
umut	надежда
şirket	корпорация
dilek	желание
çözüm	решение
olgun	зрелый
rol	роль
haftalar	недель
belli	определенный
alt	ниже
gerekli	необходимо
Birlik	союз
Pazartesi	понедельник
com	ком
belirli	конкретный
ince	отлично
saat	час
gaz	газ
becerileri	навыки
altı	шесть
çalı	куст
adaları	острова
tavsiye	совет
kariyer	карьера
karar	решение
ayrılmak	оставлять
önceden	до
Kocaman	огромный
Kadın	женщина
tesisler	оборудование
teklif	предложение
orta	средний
kablo	кабель
fırsatlar	возможности
alma	принятие
değerler	значения
bölünme	деление
gelecek	приход
nesne	объект
lezbiyen	лесбиянка
uygun	подходящее
makine	машина
logo	логотип
uzunluk	длина
Güzel	хороший
Gol	Гол
istatistik	статистика
müşteri	клиент
Numune	образец
yatırım	инвестиции
gönderilen	послал
gösterilen	показанный
Noel	рождество
kültür	культура
flaş	вспышка
MS	Миз
seçim	выбор
dersler	курсы
tüketici	потребитель
Merhaba	Здравствуй
yabancı	иностранные
sanatçı	художник
mobilya	мебель
kanal	канал
mektup	письмо
kip	Режим
telefonlar	телефоны
fikirler	идеи
yapı	состав
derece	степень
sözleşme	контракт
Süper	супер
erkek	мужской
madde	дело
neredeyse	почти
bulunan	располагается
çoklu	множественный
dağıtım	распределение
editör	редактор
Han	гостиница
Sanayi	промышленные
potansiyel	потенциал
şarkı	песня
los	лос
düşmek	падать
Fikir	идея
Odalar	номера
iletişim	связь
kazanmak	выиграть
birincil	первичный
kanser	рак
sayılar	чисел
neden	причина
araç	инструмент
bahar	весна
vakıf	Фонд
Cevap	ответ
ses	голос
program	график
evraklar	документы
amaç	цель
özellik	особенность
yatak	постель
geliyor	выходит
polis	полиция
bağımsız	независимый
yaklaşım	подход
kahverengi	коричневый
fiziksel	физическое
Tepe	холм
haritalar	карты
ambar	держать
derecelendirme	рейтинги
mutlu	счастливый
demirci	кузнец
gelişmiş	развитая
teşekkür	спасибо
kasa	безопасно
benzersiz	уникальный
anket	опрос
önceki	предшествующий
telefon	телефон
spor	спорт
hazır	готов
hayvan	животное
kaynaklar	источники
nüfus	Население
baba	папа
düzenli	регулярный
güvenli	безопасный
operasyonlar	операции
basitçe	просто
kanıt	доказательства
istasyon	станция
anlama	Понимаю
seçenek	вариант
vadi	долина
muhtemelen	вероятно
deniz	море
yayınlar	публикации
iyileştirmek	улучшать
bağ	соединение
Yayımcı	издатель
salon	зал
anti	анти
ağlar	сети
toprak	Земля
ebeveyn	родители
darbe	влияние
Aktar	перевод
Giriş	введение
mutfak	кухня
kuvvetli	сильный
düğün	свадьба
özellikleri	свойства
hastane	больница
zemin	земля
gemi	корабль
Konaklama	жилье
hastalık	болезнь
mükemmel	отлично
mükemmel	идеально
saç	волосы
fırsat	возможность
malzeme	Комплект
klasik	классический
temel	основа
komuta	команда
şehirler	города
ekspres	экспресс
ödül	награда
mesafe	расстояние
ağaç	дерево
değerlendirme	оценка
duvar	стена
ilgili	участвует
el	эль
ekstra	дополнительный
özellikle	особенно
bütçe	бюджет
kılavuzlar	направляющие
başarı	успех
maksimum	максимальная
anne	мама
operasyon	операция
mevcut	существующий
oldukça	довольно
seçilmiş	выбранный
oğlan	мальчик
restoranlar	ресторан
güzel	красивая
uyarı	предупреждение
yerleri	места
at	лошадь
oy	голос
Çiçekler	цветы
yıldızlar	звезды
listeleri	списки
sahip	владелец
hayvanlar	животные
yolları	пути
oğul	сын
sağlama	обеспечение
kural	правило
Konut	Корпус
alır	принимает
getirmek	приносить
katalog	каталог
maksimum	Максимум
anne	мама
yetki	власть
söyledi	сказал
program	программа
katıldı	присоединился
giriş	вход
strateji	стратегия
ayaklar	ноги
ajan	агент
geçerli	действительный
modern	современное
kıdemli	старшая
seksi	сексуальный
öğretim	обучение
kapı	дверь
büyük	большой
Deneme	испытание
birimler	единицы
güzel	круто
normal	нормальный
kuruluş	предприятие
gemiler	судов
tüm	все
pozitif	положительный
Fitness	фитнес
Çince	Китайский
görüş	мнение
Futbol	футбол
soyut	Абстрактные
çıktı	вывод
para	фонды
Bay	Мистер
muhtemelen	вероятно
geliştirmek	развивать
sanatçılar	художники
alternatif	альтернатива
sorumluluk	обязанность
java	Ява
konuk	гость
yayın	публикация
pas	проходить
ilişkiler	связи
güven	доверять
kamyonet	фургон
içeren	содержит
çok	много
cumhuriyet	республика
harç	сборы
bileşenler	компоненты
tatil	отпуск
yüzyıl	века
akademik	академический
yardım	помощь
tamamlanan	завершено
cilt	кожа
grafik	графика
Hintli	индийский
halka	кольцо
sınıf	класс
dağ	гора
organizasyonlar	организации
filtre	фильтр
panel	панель
zemin	пол
alış	покупка
maç	совпадение
önerilen	предложенный
gerektirir	требовать
çocuklar	мальчиков
sabah	утро
verir	позволяет
protein	белок
bitki	растение
rapor	сообщается
vurmak	удар
aa	мм
havuz	бассейн
mini	мини
siyaset	политика
ortak	партнер
yazarlar	авторы
panoları	доски
balık	рыба
üyelik	членство
misyon	миссия
göz	глаз
sicim	строка
duyu	смысл
değiştirilmiş	модифицированный
yayınlandı	выпущенный
evre	сцена
iç	внутренний
doğmuş	Родился
detaylı	подробный
