of	из
to	в
in	в
for	для
is	является
on	на
that	что
by	от
this	это
with	с
i	я
you	вы
it	Это
or	или
be	быть
are	находятся
at	в
all	все
have	иметь
new	новый
we	мы
will	будем
home	Главная
us	нас
about	около
if	если
page	страница
my	мой
has	имеет
search	поиск
free	свободно
but	но
our	наш
one	один
other	Другие
do	делать
information	Информация
time	время
he	он
which	который
their	их
news	Новости
use	использование
there	там
see	видеть
so	так
who	кто
web	Web
also	также
get	получить
pm	вечера
view	Посмотреть
c	с
e	е
first	первый
been	было
would	бы
were	мы
s	s
like	как
x	Икс
than	чем
find	найти
price	цена
back	назад
top	Вверх
people	люди
had	имел
list	список
name	имя
just	просто
year	год
day	день
into	в
two	два
health	здоровье
n	N
re	ре
used	используемый
go	идти
b	б
last	последний
make	делать
them	их
should	должен
product	продукт
system	система
post	после
her	ее
city	город
t	T
policy	политика
number	номер
support	поддержка
message	сообщение
after	после
then	тогда
jan	январь
good	хорошо
d	d
where	где
info	Информация
rights	права
books	книги
high	высокая
school	школа
m	м
each	каждый
links	связи
she	она
years	лет
order	заказ
very	очень
book	книга
items	Предметы
company	Компания
r	р
read	читать
group	группа
sex	секс
many	многие
user	пользователь
de	де
set	задавать
general	Генеральная
research	исследование
university	Университет
january	январь
mail	почта
full	полный
reviews	отзывы
program	программа
know	знать
games	игры
way	путь
days	дней
p	п
part	часть
could	мог
great	Великий
united	единый
real	реальный
f	е
international	Международный
center	центр
travel	путешествовать
comments	Комментарии
made	сделал
development	развитие
report	доклад
member	член
details	Детали
line	линия
terms	сроки
before	до
hotels	отели
did	сделал
send	Отправить
right	правильно
type	тип
local	местный
those	те
results	Результаты
office	офис
national	национальный
car	автомобиль
design	дизайн
take	принимать
posted	отправил
address	адрес
community	сообщество
within	в
states	состояния
want	хотеть
phone	Телефон
dvd	DVD
subject	предмет
between	между
forum	Форум
family	семья
l	L
long	длинный
w	вес
show	показать
o	о
even	даже
black	черный
special	особый
index	индекс
being	являющийся
women	женщины
much	много
sign	знак
file	файл
link	ссылка
open	открытый
south	юг
case	дело
project	проект
pages	страницы
version	версия
section	раздел
own	своя
house	дом
security	безопасность
g	г
county	округ
american	американский
photo	Фото
game	игра
members	члены
power	мощность
network	сеть
computer	компьютер
systems	системы
three	три
place	место
end	конец
h	час
him	его
per	в
access	доступ
think	думать
north	север
resources	Ресурсы
current	текущий
big	большой
media	СМИ
law	закон
control	контроль
water	воды
history	история
size	размер
personal	личный
guide	руководство
shop	магазин
directory	каталог
change	изменение
white	белый
text	текст
small	маленький
rating	рейтинг
rate	ставка
government	правительство
children	дети
return	вернуть
students	студенты
v	v
account	Счет
times	раз
level	уровень
digital	цифровой
profile	профиль
previous	предыдущий
form	форма
events	Мероприятия
love	люблю
old	старый
john	Джон
main	главный
call	вызов
image	образ
department	отдел
title	заглавие
non	не
k	К
y	Y
insurance	страхование
shall	должен
property	имущество
class	класс
cd	CD
quality	качественный
every	каждый
listing	список
content	содержание
country	страна
little	немного
tools	инструменты
low	низкий
reply	Ответить
customer	клиент
december	Декабрь
compare	сравнить
movies	кино
college	колледж
value	стоимость
article	статья
man	человек
jobs	работы
j	J
food	питание
author	автор
different	другой
u	U
learn	учить
sale	продажа
print	Распечатать
course	курс
job	работа
room	комната
stock	акции
training	обучение
too	слишком
credit	кредит
point	точка
science	наука
men	люди
categories	категории
west	запад
look	смотреть
english	английский
team	команда
estate	имущество
box	коробка
conditions	условия
photos	фото
gay	гей
thread	нить
category	категория
note	заметка
live	жить
large	большой
gallery	галерея
table	Таблица
however	Однако
june	июнь
october	октябрь
november	ноябрь
market	рынок
library	библиотека
action	действие
start	Начало
series	серии
features	функции
air	воздух
industry	промышленность
plan	план
human	человек
yes	да
second	второй
hot	горячий
cost	Стоимость
movie	кино
forums	форумы
march	Март
la	ля
september	сентябрь
say	сказать
going	собирается
medical	медицинская
friend	друг
dec	декабрь
server	сервер
application	заявление
staff	сотрудники
play	играть
issues	вопросы
april	апрель
users	пользователи
street	улица
topic	тема
against	против
got	получил
blog	блог
party	вечеринка
payment	оплата
equipment	оборудование
let	позволять
programs	программы
legal	правовой
recent	недавний
park	парк
act	акт
problem	проблема
red	красный
give	дайте
memory	Память
performance	представление
social	Социальное
q	Q
story	история
sell	продавать
options	опции
experience	опыт
key	ключ
body	тело
young	молодой
important	важный
field	поле
few	мало
east	восток
single	Один
ii	б
age	возраст
club	клуб
example	пример
girls	девочки
z	Z
road	Дорога
gift	подарок
question	вопрос
ca	Калифорния
hard	жесткий
pay	платить
four	четыре
poker	покер
issue	вопрос
range	ассортимент
building	здание
seller	продавец
court	суд
february	февраль
result	результат
light	легкий
write	записывать
war	война
offer	предлагает
blue	синий
groups	группы
al	аль
easy	легко
given	данный
request	запрос
fax	факс
china	Китай
making	изготовление
picture	картина
needs	потребности
possible	возможное
month	месяц
major	главный
star	звезда
future	будущее
space	пространство
committee	комитет
hand	рука
sun	солнце
cards	карты
london	Лондон
meeting	встреча
become	стали
child	ребенок
keep	держать
porn	порно
share	доля
similar	аналогичный
garden	сад
schools	школы
million	миллиона
added	добавленной
reference	Справка
companies	компании
baby	детка
learning	обучение
energy	энергия
run	бег
delivery	Доставка
popular	популярный
term	срок
film	фильм
stories	истории
put	положил
journal	журнал
reports	отчеты
co	Колорадо
try	пытаться
images	изображений
notice	уведомление
god	Бог
original	оригинал
head	глава
radio	радио
cell	клетка
council	совет
includes	включает
track	трек
discussion	обсуждение
archive	архив
others	другие
agreement	соглашение
format	формат
society	общество
months	месяцы
safety	безопасность
friends	друзья
sure	конечно
edition	издание
messages	Сообщения
marketing	маркетинг
tell	рассказать
association	ассоциация
provides	обеспечивает
fun	весело
already	уже
green	зеленый
studies	исследования
close	Закрыть
common	общий
specific	конкретный
several	несколько
living	живой
collection	коллекция
called	называется
short	короткая
arts	искусства
lot	много
ask	просить
limited	ограниченное
solutions	решения
director	директор
beach	пляж
past	мимо
natural	натуральный
electronics	электроника
upon	на
period	период
planning	планирование
says	говорит
official	официальный
mar	март
done	сделанный
technical	технический
window	окно
pro	профессионал
region	область
island	остров
record	запись
direct	непосредственный
conference	конференция
records	учет
st	улица
district	район
calendar	календарь
costs	расходы
style	стиль
statement	заявление
miles	миль
resource	ресурс
applications	Приложения
document	документ
word	слово
works	работает
material	материал
bill	законопроект
written	написано
rules	правила
final	окончательный
thing	вещь
centre	центр
requirements	требования
TRUE	ПРАВДА
minutes	минут
else	еще
mark	отметка
rock	камень
bad	Плохо
individual	индивидуальный
plus	плюс
auto	авто
cover	обложка
edit	редактировать
together	вместе
videos	видео
fast	быстро
function	функция
fact	факт
getting	получение
global	Глобальный
tech	тек
meet	встретить
far	далеко
economic	экономической
en	ан
player	игрок
projects	проектов
amount	количество
watch	смотреть
included	включены
feel	Чувствовать
bank	банка
risk	риск
deals	предложения
various	различный
words	слова
production	производство
commercial	коммерческая
weight	вес
heart	сердце
treatment	лечение
points	точки
knowledge	знание
magazine	журнал
error	ошибка
camera	камера
girl	девушка
construction	строительство
toys	игрушки
registered	зарегистрированный
domain	домен
methods	методы
chapter	глава
protection	защита
policies	полисы
wide	широкий
beauty	красота
manager	менеджер
india	Индия
position	должность
taken	взятый
sort	Сортировать
listings	объявления
known	известен
half	половина
cases	случаи
step	шаг
engineering	инжиниринг
simple	просто
quick	быстро
license	лицензия
lake	озеро
whole	все
annual	годовой
published	опубликованный
church	церковь
method	метод
active	активный
response	ответ
figure	фигура
materials	материалы
enough	достаточно
designed	предназначенный
among	среди
death	смерть
loss	потеря
face	лицо
brand	марка
discount	скидка
effects	последствия
created	созданный
standards	стандарты
bit	немного
political	политическая
kingdom	Королевство
base	база
doing	дела
loans	кредитование
shoes	обувь
entry	запись
stay	оставаться
orders	заказы
availability	доступность
summary	резюме
turn	очередь
growth	рост
agency	агентство
king	король
european	Европейская
activity	Мероприятия
copy	копия
western	вестерн
force	сила
employment	занятость
bay	залив
river	река
commission	комиссия
package	пакет
seen	видели
players	игроки
engine	двигатель
port	порт
album	альбом
regional	региональный
stop	стоп
started	начал
administration	администрация
bar	бар
institute	институт
views	Просмотры
double	двойной
dog	собака
soon	скоро
lines	линии
electronic	электронный
benefits	выгоды
needed	необходимый
printer	принтер
condition	состояние
effective	эффективный
believe	верить
organization	организация
effect	эффект
mind	разум
selection	выбор
casino	казино
pdf	PDF
tour	тур
cross	пересекать
hope	надежда
corporation	корпорация
wish	желание
solution	решение
mature	зрелый
role	роль
weeks	недель
certain	определенный
lower	ниже
necessary	необходимо
union	союз
mon	понедельник
com	ком
particular	конкретный
fine	отлично
hour	час
gas	газ
skills	навыки
six	шесть
bush	куст
islands	острова
advice	совет
career	карьера
decision	решение
leave	оставлять
pre	до
huge	огромный
woman	женщина
facilities	оборудование
bid	предложение
middle	средний
cable	кабель
opportunities	возможности
taking	принятие
values	значения
division	деление
coming	приход
object	объект
lesbian	лесбиянка
appropriate	подходящее
machine	машина
logo	логотип
length	длина
nice	хороший
score	Гол
statistics	статистика
client	клиент
sample	образец
investment	инвестиции
sent	послал
shown	показанный
christmas	рождество
culture	культура
flash	вспышка
ms	Миз
choice	выбор
courses	курсы
consumer	потребитель
hi	Здравствуй
foreign	иностранные
artist	художник
furniture	мебель
channel	канал
letter	письмо
mode	Режим
phones	телефоны
ideas	идеи
structure	состав
degree	степень
contract	контракт
super	супер
male	мужской
matter	дело
almost	почти
located	располагается
multiple	множественный
distribution	распределение
editor	редактор
inn	гостиница
industrial	промышленные
potential	потенциал
song	песня
los	лос
fall	падать
idea	идея
rooms	номера
communications	связь
win	выиграть
primary	первичный
cancer	рак
numbers	чисел
reason	причина
tool	инструмент
spring	весна
foundation	Фонд
answer	ответ
voice	голос
schedule	график
documents	документы
purpose	цель
feature	особенность
bed	постель
comes	выходит
police	полиция
independent	независимый
approach	подход
brown	коричневый
physical	физическое
hill	холм
maps	карты
hold	держать
ratings	рейтинги
happy	счастливый
smith	кузнец
developed	развитая
thank	спасибо
safe	безопасно
unique	уникальный
survey	опрос
prior	предшествующий
telephone	телефон
sport	спорт
ready	готов
animal	животное
sources	источники
population	Население
pa	папа
regular	регулярный
secure	безопасный
operations	операции
simply	просто
evidence	доказательства
station	станция
understand	Понимаю
option	вариант
valley	долина
probably	вероятно
sea	море
publications	публикации
improve	улучшать
connection	соединение
publisher	издатель
hall	зал
anti	анти
networks	сети
earth	Земля
parents	родители
impact	влияние
transfer	перевод
introduction	введение
kitchen	кухня
strong	сильный
wedding	свадьба
properties	свойства
hospital	больница
ground	земля
ship	корабль
accommodation	жилье
disease	болезнь
excellent	отлично
perfect	идеально
hair	волосы
opportunity	возможность
kit	Комплект
classic	классический
basis	основа
command	команда
cities	города
express	экспресс
award	награда
distance	расстояние
tree	дерево
assessment	оценка
wall	стена
involved	участвует
el	эль
extra	дополнительный
especially	особенно
budget	бюджет
guides	направляющие
success	успех
maximum	максимальная
ma	мама
operation	операция
existing	существующий
quite	довольно
selected	выбранный
boy	мальчик
restaurants	ресторан
beautiful	красивая
warning	предупреждение
locations	места
horse	лошадь
vote	голос
flowers	цветы
stars	звезды
lists	списки
owner	владелец
animals	животные
ways	пути
son	сын
providing	обеспечение
rule	правило
housing	Корпус
takes	принимает
bring	приносить
catalog	каталог
max	Максимум
mother	мама
authority	власть
told	сказал
programme	программа
joined	присоединился
input	вход
strategy	стратегия
feet	ноги
agent	агент
valid	действительный
modern	современное
senior	старшая
sexy	сексуальный
teaching	обучение
door	дверь
grand	большой
trial	испытание
units	единицы
cool	круто
normal	нормальный
enterprise	предприятие
ships	судов
entire	все
positive	положительный
fitness	фитнес
chinese	Китайский
opinion	мнение
football	футбол
abstract	Абстрактные
output	вывод
funds	фонды
mr	Мистер
likely	вероятно
develop	развивать
artists	художники
alternative	альтернатива
responsibility	обязанность
java	Ява
guest	гость
publication	публикация
pass	проходить
relations	связи
trust	доверять
van	фургон
contains	содержит
multi	много
republic	республика
fees	сборы
components	компоненты
vacation	отпуск
century	века
academic	академический
assistance	помощь
completed	завершено
skin	кожа
graphics	графика
indian	индийский
ring	кольцо
grade	класс
mountain	гора
organizations	организации
filter	фильтр
panel	панель
floor	пол
buying	покупка
match	совпадение
proposed	предложенный
require	требовать
boys	мальчиков
morning	утро
allows	позволяет
protein	белок
plant	растение
reported	сообщается
hit	удар
mm	мм
pool	бассейн
mini	мини
politics	политика
partner	партнер
authors	авторы
boards	доски
fish	рыба
membership	членство
mission	миссия
eye	глаз
string	строка
sense	смысл
modified	модифицированный
released	выпущенный
stage	сцена
internal	внутренний
born	Родился
detailed	подробный
japanese	Японский
race	раса
approved	утвержденный
target	цель
except	Кроме
character	персонаж
maintenance	поддержание
ability	способность
ed	издание
rape	изнасилование
battery	аккумулятор
youth	молодежь
pressure	давление
submitted	Отправлено
debt	долг
medium	средний
television	телевидение
interested	заинтересованный
core	ядро
break	ломать
purposes	цели
sets	наборы
dance	танец
wood	дерево
defined	определенный
papers	документы
awards	награды
fee	плата
studio	студия
reader	читатель
device	устройство
established	установленный
answers	ответы
rent	аренда
las	лас
dark	темно
external	внешний
apple	яблоко
le	ле
instructions	инструкции
min	мин
offered	предложенный
theory	теория
remove	Удалить
aid	помощь
visual	визуальный
host	хозяин
variety	разнообразие
teachers	учителей
manual	руководство
block	блок
subjects	предметы
agents	агенты
repair	ремонт
fair	Справедливая
steel	стали
understanding	понимание
songs	песни
fixed	исправлено
wrong	неправильно
beginning	начало
hands	Руки
az	Аризона
paris	Париж
gets	получает
sector	сектор
capacity	вместимость
un	ООН
fat	жир
father	отец
electric	электрический
saw	увидел
instruments	инструменты
officer	сотрудник
driver	Водитель
businesses	бизнес
dead	мертвый
unknown	неизвестный
restaurant	ресторан
mike	Майк
trip	поездка
mi	ми
poor	бедные
relationship	отношения
workers	рабочие
peace	мир
traditional	традиционный
showing	показ
creative	творческий
coast	берег
benefit	выгода
funding	финансирование
devices	приборы
lord	господин
grant	даровать
sub	суб
fiction	фантастика
watches	часы
careers	карьера
goes	идет
led	светодиод
museum	музей
fan	поклонник
transport	транспорт
interesting	интересно
blogs	блоги
evaluation	оценка
former	бывший
zone	зона
complex	сложный
th	го
cat	Кот
die	умереть
presented	представленный
flat	квартира
flow	течь
agencies	агентства
literature	литература
parent	родитель
setting	установка
dr	доктор
scale	масштаб
economy	экономика
helpful	полезный
monthly	ежемесячно
critical	критический
frame	Рамка
musical	музыкальный
definition	определение
secretary	секретарь
path	дорожка
chief	главный
gives	дает
packages	пакеты
detail	подробно
laws	законы
changed	изменено
begin	начать
royal	королевский
clean	чистый
guy	парень
titles	названия
relevant	Соответствующий
justice	справедливость
connect	соединять
cup	кружка
basket	корзина
applied	прикладная
weekly	еженедельно
vol	об
installation	монтаж
pp	стр
attention	внимание
advance	продвижение
skip	пропускать
diet	диета
army	армия
gear	шестерня
difference	разница
allowed	позволил
correct	верный
nation	нация
selling	продажа
lots	много
piece	кусок
sheet	лист
firm	фирма
seven	Семь
elements	элементы
species	вид
jump	Прыгать
cells	ячейки
module	модуль
resort	курорт
certificate	сертификат
minister	министр
motion	движение
fashion	мода
directions	направления
visitors	посетители
documentation	документация
trading	торговый
forest	лес
calls	звонки
coverage	покрытие
couple	пара
giving	дающий
chance	шанс
vision	видение
ball	мяч
ending	окончание
clients	клиенты
actions	действия
discuss	обсуждать
goal	Цель
successful	успешный
sold	продан
wind	ветер
communities	сообщества
clinical	клиническая
situation	ситуация
markets	рынки
publishing	издательский
appear	появиться
developing	развивающийся
lives	жизни
determine	определить
temperature	температура
announcements	объявления
patient	пациент
actual	фактический
historical	исторический
stone	камень
bob	боб
commerce	коммерция
persons	лиц
difficult	сложно
scientific	научный
satellite	спутник
tests	тесты
village	деревня
accounts	Счета
amateur	любитель
ex	бывший
met	встретил
pain	боль
factors	факторы
coffee	кофе
buyer	покупатель
poster	плакат
edge	край
functional	функциональная
root	корень
fi	фи
closed	закрыто
holidays	каникулы
pink	розовый
balance	баланс
monitoring	мониторинг
replies	ответы
shot	выстрел
initial	начальная
label	метка
sec	сек
canon	канон
league	лига
waste	отходы
minute	минут
bus	автобус
provider	поставщик
dictionary	Словарь
accounting	учет
manufacturing	производство
sections	разделы
chair	стул
effort	усилие
phase	фаза
fantasy	фантазия
po	ро
va	в
professor	профессор
install	устанавливать
shirt	Рубашка
apparel	одежда
foot	фут
breast	грудь
techniques	методы
dollars	долларов
religion	религия
permission	разрешение
wild	дикий
generation	поколение
miss	Мисс
chemical	химическая
doctor	врач
task	задача
reduce	уменьшить
brought	привел
exercise	упражнение
bug	ошибка
guarantee	гарантия
leader	лидер
se	се
processes	процессы
soft	мягкий
meetings	встречи
seconds	секунд
flight	рейс
congress	конгресс
fuel	топливо
walk	ходить
produced	произведенный
saint	святой
argument	аргумент
competition	соревнование
drugs	наркотики
joint	совместный
premium	премия
fresh	свежий
characters	персонажи
attorney	адвокат
di	ди
factor	фактор
thousands	тысячи
km	км
stream	поток
apartments	апартаменты
pick	выбирать
hearing	слух
eastern	восточный
therapy	терапия
entries	записи
signed	подписанный
administrative	административный
serious	серьезный
limit	предел
steps	меры
shops	магазины
bondage	зависимость
del	дель
efforts	усилия
informed	проинформировал
ga	Джорджия
thoughts	мысли
creek	ручей
ft	фут
quantity	количество
essential	существенный
tours	туры
load	нагрузка
immediately	немедленно
machines	машины
designated	назначенный
heavy	тяжелый
covered	покрытый
recovery	восстановление
integrated	интегрированный
configuration	конфигурация
cock	петух
merchant	торговец
comprehensive	комплексный
expert	эксперт
protect	защищать
solid	твердый
presentation	презентация
became	стал
orange	оранжевый
compliance	соблюдение
theme	тема
rich	богатые
campaign	кампания
vs	против
guitar	гитара
finding	обнаружение
examples	Примеры
spirit	дух
ar	Арканзас
claims	требования
acceptance	принятие
strategies	стратегии
mo	мо
affairs	дела
intended	предназначена
sa	са
goals	цели
hire	Наем
election	выборы
suggest	предлагать
branch	филиал
serve	обслуживать
affiliates	филиалы
mount	крепление
latin	латинский
multimedia	мультимедиа
manage	управлять
corner	угол
rank	ранг
element	элемент
birth	рождение
virus	вирус
interactive	интерактивный
requests	Запросы
separate	отдельный
quarter	четверть
procedure	процедура
leadership	руководство
define	определять
religious	религиозная
facts	факты
breakfast	завтрак
column	колонка
faith	вера
chain	цепь
identify	идентифицировать
avenue	проспект
missing	отсутствует
recommendations	рекомендации
moved	переехал
reach	достичь
comparison	сравнение
moment	момент
extended	расширенный
sequence	последовательность
inch	дюймовый
attack	атака
centers	центры
opening	открытие
lab	лаборатория
reserve	резерв
gamma	гамма
produce	производить
truth	правда
counter	счетчик
failure	отказ
follows	следует
dollar	доллар
camp	лагерь
des	дез
films	фильмы
bridge	мост
fill	заполнить
movement	движение
printing	печать
draft	проект
chart	диаграмма
played	играл
contacts	контакты
readers	читатели
clubs	клубы
wa	Вашингтон
adventure	приключение
offering	предложение
profit	прибыль
leaders	лидеры
posters	плакаты
institutions	учреждения
assistant	помощник
variable	переменная
dj	диджей
parking	стоянка
yesterday	вчера
determined	определенный
workshop	мастерская
gone	прошло
codes	коды
kinds	виды
extension	расширение
statements	заявления
completely	полностью
teams	команды
fort	форт
cm	см
senate	сенат
funny	веселая
gene	ген
turned	оказалось
disc	диск
pattern	шаблон
boat	лодка
theatre	театр
manufacturers	производители
sponsor	спонсор
classical	классический
icon	значок
warranty	гарантия
dedicated	преданный
direction	направление
basketball	баскетбол
objects	объекты
delete	Удалить
evening	вечер
assembly	сборка
nuclear	ядерной
mouse	мышь
signal	сигнал
criminal	преступник
issued	выпущен
powerful	мощный
dream	мечта
FALSE	ЛОЖНЫЙ
da	да
cast	бросать
flower	цветок
personnel	персонал
passed	прошло
supplied	поставляется
falls	падения
soul	душа
promote	содействовать
stated	заявил
stats	статистика
professionals	профессионалов
appears	появляется
carry	нести
flag	флаг
covers	крышки
em	Эм
advantage	преимущество
hello	Здравствуйте
designs	конструкции
maintain	поддерживать
tourism	туризм
priority	приоритет
adults	Взрослые
graphic	графический
atom	атом
payments	платежи
binding	переплет
brief	краткое
ended	закончился
winning	выигрыш
anonymous	анонимный
script	скрипт
served	служил
wants	хочет
prepared	подготовленный
void	недействительным
tag	тег
interview	интервью
mix	смешивание
framework	фреймворк
disk	диск
installed	установлен
queen	Королева
credits	кредиты
clearly	явно
fix	фиксировать
handle	ручка
sweet	милая
criteria	критерии
associate	ассоциировать
ne	Небраска
behavior	поведение
enlarge	увеличить
ray	луч
revenue	доход
measure	измерение
votes	голосов
du	дю
duty	обязанность
discussions	обсуждение
bear	медведь
gain	усиление
festival	фестиваль
laboratory	лаборатория
ocean	океан
flights	рейсы
experts	эксперты
signs	знаки
depth	глубина
train	поезд
dry	сухой
explore	исследовать
spa	спа
concept	концепция
nearly	около
handling	обращение
origin	происхождения
billion	миллиард
intelligence	интеллект
bought	купил
con	против
nations	нации
route	маршрут
broken	сломанный
battle	боевой
speak	говорить
protocol	протокол
query	запрос
partnership	партнерство
expression	выражение
es	эс
speech	речь
wire	провод
suggestions	предложения
replacement	замена
tape	лента
strategic	стратегическое
judge	судья
acid	кислота
bytes	байтов
cent	цент
forced	принудительный
compatible	совместимый
apartment	квартира
null	ноль
zero	нуль
speaker	оратор
consulting	консалтинг
designer	дизайнер
pr	пр
marriage	брак
roll	рулон
banks	банки
fr	фр
participants	участники
secret	секрет
negative	отрицательный
favorites	избранное
theater	театр
springs	пружины
var	вар
perform	выполнять
translation	перевод
estimates	оценки
injury	травма
ministry	министерство
drivers	водители
lawyer	адвокат
figures	цифры
protected	защищенный
proposal	предложение
sharing	разделение
portal	портал
beta	бета
gratis	бесплатно
toward	к
slightly	немного
assist	помощь
conduct	поведение
contained	содержащиеся
legislation	законодательство
calling	призвание
parameters	параметры
profiles	профили
matters	вопросы
houses	дома
controls	управления
combined	комбинированный
ultimate	окончательный
representative	представитель
minor	незначительный
departments	ведомства
residents	жители
displayed	отображается
mom	Мама
reduced	уменьшенный
rare	редкий
performed	выполнено
extreme	экстремальный
samples	образцы
bars	брусья
forecast	прогноз
removed	удален
cycle	цикл
contain	содержать
accuracy	точность
sleep	спать
mg	мг
bird	птица
pharmacy	аптека
creation	создание
static	статический
hunter	охотник
addresses	адреса
lady	леди
crystal	кристалл
famous	известный
writer	писатель
chairman	председатель
drink	напиток
academy	академия
dynamic	динамический
eat	есть
permanent	постоянный
cleaning	уборка
constitutes	составляет
portfolio	портфолио
practical	практическое
delivered	доставлен
infrastructure	инфраструктура
colour	цвет
vendor	продавец
philosophy	философия
regulation	регулирование
officers	офицеры
aim	цель
bids	предложения
nutrition	питание
recording	запись
junior	младший
les	ле
cape	мыс
rings	кольца
tip	наконечник
wonderful	замечательно
ticket	билет
announced	объявленный
guess	Угадай
whom	кого
soccer	футбольный
math	математический
import	Импортировать
posting	проводка
presence	присутствие
automatic	автоматический
viewing	просмотр
maintained	поддерживается
ch	ч
dan	Дан
dogs	собаки
directors	директора
aspects	аспекты
ahead	впереди
moon	Луна
participation	участие
scheme	схема
fly	летать
manner	манера
matrix	матрица
combination	сочетание
amendment	поправка
strength	прочность
turkey	Турция
libraries	библиотеки
proper	правильный
degrees	степени
enterprises	предприятия
delta	дельта
fear	страх
seeking	Ищу
inches	дюймов
convention	условность
shares	акции
principal	главный
comfort	комфорт
colors	цвета
wars	войны
ordering	заказ
kept	хранится
alpha	альфа
appeal	обращение
cruise	круиз
bonus	бонус
hey	Привет
buildings	здания
specials	скидки
beat	бить
batteries	батареи
becomes	становится
drives	диски
arms	оружие
tea	чай
improved	улучшен
achieve	достигать
positions	позиции
dress	платье
subscription	подписка
dealer	дилер
contemporary	современный
sky	небо
rom	ПЗУ
carried	осуществляется
exposure	воздействие
hide	скрывать
signature	подпись
miller	мельник
provision	обеспечение
clothes	одежда
frames	кадры
certainly	безусловно
newspaper	газета
toy	игрушка
layer	слой
printed	печатные
slow	медленный
removal	удаление
liability	ответственность
printers	принтеры
adding	добавление
spot	место
spend	проводить
factory	завод
interior	интерьер
grow	расти
optical	оптический
promotion	продвижение
relative	относительный
amazing	удивительно
dot	точка
identity	идентичность
conversion	преобразование
feeling	чувство
hidden	скрытый
reasonable	разумный
revision	пересмотр
influence	влияние
ratio	соотношение
importance	важность
rain	дождь
planet	планета
copies	копии
permit	разрешать
seeing	видя
proof	доказательство
bass	бас
prescription	рецепт
empty	пустой
instance	пример
hole	дыра
ride	поездка
bureau	бюро
conservation	сохранение
pair	пара
ideal	идеальный
specs	функции
recorded	записанный
don	дон
pieces	куски
finished	законченный
parks	парки
lawyers	адвокаты
stress	стресс
cream	крем
ss	сс
runs	работает
discover	обнаружить
ap	ар
patterns	узоры
hills	холмы
nm	нм
advisor	консультант
aware	знать
shape	форма
evolution	эволюция
certificates	сертификаты
objectives	цели
stations	станций
suggested	предложенный
op	оп
remains	остатки
firms	фирмы
euro	евро
operator	оператор
structures	сооружения
generic	общий
encyclopedia	энциклопедия
usage	Применение
ink	чернила
mixed	смешанный
census	перепись
wheel	колесо
suppliers	поставщики
compact	компактный
poetry	поэзия
lights	огни
tracking	отслеживание
angel	ангел
preparation	подготовка
attempt	попытка
receiving	получение
matches	Матчи
accordance	соответствие
width	ширина
engines	двигатели
forget	забывать
array	массив
discussed	обсуждается
accurate	точный
climate	климат
greek	греческий
instruction	инструкция
managing	управление
raw	сырье
differences	различия
explain	объяснять
establish	установить
expressed	выраженный
extent	степень
sharp	острый
ben	Бен
paragraph	параграф
kill	убийство
mathematics	математика
compensation	компенсация
export	экспорт
managers	менеджеры
modules	модули
conducted	проведены
versions	версии
knows	знает
describe	описывать
citizens	граждане
heritage	наследие
trouble	беда
coach	тренер
agricultural	сельскохозяйственное
expand	расширять
audience	аудитория
assigned	назначенный
collections	коллекции
ages	возраст
specialist	специалист
cook	готовить
affect	аффект
virgin	девственница
experienced	опытный
investigation	расследование
raised	поднятый
hat	шапка
institution	учреждение
directed	направленный
affected	пострадавших
bike	велосипед
totally	полностью
plate	пластина
expenses	затраты
indicate	указывать
blonde	блондинка
proceedings	производство
favourite	любимый
characteristics	характеристики
der	дер
lose	потерять
organic	органический
seek	искать
experiences	опыт
albums	альбомы
contracts	контракты
guests	гости
hosted	состоялся
diseases	болезни
concerning	относительно
equivalent	эквивалент
chemistry	химия
kits	комплекты
logic	логика
prince	принц
circle	круг
soil	почва
psychology	психология
wet	влажный
circumstances	обстоятельства
investor	инвестор
elementary	элементарный
sponsors	спонсоры
fox	лиса
unlimited	неограниченный
respond	отвечать
sizes	размеры
plain	гладкий
exit	Выход
arm	рука
keys	ключи
wave	волна
holy	святой
acts	акты
guidance	руководство
trail	след
symbol	символ
highway	шоссе
observed	наблюдаемый
dean	декан
setup	настроить
poll	голосование
styles	стили
filled	заполненный
bond	связь
channels	каналы
appendix	приложение
chocolate	шоколад
portion	часть
scope	объем
supplier	поставщик
cables	кабели
cotton	хлопок
requirement	требование
killed	убитый
border	граница
ancient	древний
debate	обсуждение
representatives	представители
starts	начинается
pregnancy	беременность
attractions	достопримечательности
learned	научился
transactions	операции
explorer	исследователь
historic	исторический
husband	муж
authorized	уполномоченный
crazy	псих
upcoming	предстоящий
concert	концерт
scores	множество
efficiency	эффективность
comedy	комедия
adopted	принят
efficient	эффективное
linear	линейный
commitment	обязательство
specialty	специальность
bears	медведи
hop	хмель
carrier	перевозчик
constant	постоянная
visa	виза
mouth	рот
meter	метр
linked	связанный
interviews	интервью
concepts	концепции
gun	пистолет
reflect	отражать
pure	чистый
hell	ад
fruit	фрукты
begins	начинается
qualified	квалифицированный
reform	реформа
lens	объектив
treated	обрабатывали
discovery	открытие
draw	привлечь
classified	объявление
assume	предполагать
alliance	союз
confirm	подтвердить
engineer	инженер
consistent	последовательный
replace	замещать
clearance	зазор
converter	конвертер
organisation	организация
babe	младенец
checks	проверки
reached	достиг
becoming	становление
objective	задача
indicated	указанный
sugar	сахар
crew	экипаж
legs	ноги
stick	придерживаться
relation	связь
enabled	включен
genre	жанр
volunteer	доброволец
rear	задний
democratic	демократической
enhance	усилить
exact	точный
bound	связанный
parameter	параметр
processor	процессор
node	узел
formal	формальный
storm	буря
micro	микро
colleges	колледжи
mile	мили
challenges	проблемы
editors	редакторы
supreme	высший
brothers	братья
recognition	признание
ref	ссылка
estimate	оценить
kid	дитя
inspection	осмотр
consumers	потребители
limits	пределы
territory	территория
weapons	оружие
delay	задержка
pilot	пилот
contributions	взносы
continuous	непрерывный
initiative	инициатива
novel	роман
execution	выполнение
disability	инвалидность
ultra	ультра
winner	победитель
episode	эпизод
potter	гончар
dish	блюдо
plays	игры
bulletin	бюллетень
ia	Айова
modify	модифицировать
truly	действительно
universe	вселенная
candidate	кандидат
slot	слот
outstanding	выдающийся
ha	ха
planned	планируемый
lodge	домик
mirror	зеркало
tournament	турнир
consideration	рассмотрение
sessions	сессий
kernel	ядро
buyers	покупатели
journals	журналы
gray	серый
catalogue	каталог
charged	заряженный
broad	широкий
und	унд
chosen	выбранный
demo	демонстрация
hate	ненавидеть
terminal	Терминал
publishers	издатели
nights	ночью
liquid	жидкость
rice	рис
reservation	бронирование
foods	продукты
guard	охрана
saving	экономия
empire	империя
newly	вновь
raise	повышение
illegal	нелегальный
expansion	расширение
premier	премьер
tomorrow	завтра
milk	молоко
drama	драма
visiting	посещение
contest	конкурс
collected	собранный
bands	группы
suitable	подходящее
absolutely	абсолютно
audit	аудит
chamber	камера
guinea	Гвинея
findings	Выводы
iso	ISO
typical	типичный
sum	сумма
chicken	курица
temporary	временный
attend	посещать
shower	душ
sending	отправка
sufficient	достаточно
shell	оболочка
province	провинция
catholic	католик
governor	губернатор
beer	пиво
contribution	вклад
formula	формула
constitution	конституции
packaging	упаковка
reliable	надежный
doubt	сомнение
earn	зарабатывать
periods	периодов
attacks	нападки
merchandise	товар
symptoms	симптомы
memorial	мемориал
twin	близнец
insert	вставить
gateway	шлюз
drawing	Рисование
candidates	кандидаты
ordered	приказал
biological	биологический
fighting	борьба
transition	переход
preferences	предпочтения
spy	шпион
romance	романс
instrument	инструмент
split	Трещина
themes	темы
powers	полномочия
heaven	небо
bits	биты
pregnant	беременная
classification	классификация
focused	сосредоточены
physician	врач
asking	просить
blocks	блоки
lo	вот
spiritual	духовный
diabetes	диабет
ml	мл
shift	сдвиг
sit	сидеть
bodies	тела
photographs	фотографии
cutting	резка
writers	писатели
flexible	гибкий
loved	любимый
favourites	избранное
mapping	отображение
numerous	многочисленные
relatively	относительно
represents	представляет
superior	превосходящий
preferred	предпочтительным
saved	сохранены
intellectual	интеллектуальной
granted	предоставляется
carbon	углерод
comfortable	удобный
magnetic	магнитные
interaction	взаимодействие
listening	прослушивание
crisis	кризис
outlook	прогноз
massive	массивный
bright	яркий
formed	сформированный
piano	пианино
echo	эхо
revolution	революция
displays	дисплеи
plasma	плазма
earnings	прибыль
mystery	тайна
landscape	пейзаж
mechanical	механический
journey	поездка
banner	баннер
fig	инжир
counties	графств
acquisition	получение
recognized	признанное
dreams	мечты
notification	уведомление
kg	кг
teach	учат
rapid	быстрый
pull	вытащить
ut	Юта
seminar	семинар
investments	вложения
wheels	колеса
specify	указывать
sensitive	чувствительный
templates	шаблоны
formats	форматы
holds	держит
router	маршрутизатор
concrete	бетон
si	си
folder	папка
completion	завершение
pulse	пульс
technique	техника
voting	голосование
courts	суды
converted	переоборудованный
metro	метро
anniversary	Годовщина
improvements	улучшения
strip	полоса
specification	Спецификация
accident	авария
nick	Ник
accessible	доступной
resident	резидент
plot	сюжет
typically	типично
representation	представление
pump	насос
exists	существует
arrangements	договоренности
conferences	конференций
consumption	потребление
narrow	узкий
threat	угроза
surveys	опросы
sitting	сидящий
consultant	консультант
controller	контроллер
committees	комитеты
penis	пенис
castle	замок
gardens	сады
labels	этикетки
willing	готовы
bio	био
acting	действующий
heads	руководители
exam	экзамен
residence	резиденция
density	плотность
hundred	сто
strange	странный
sustainable	устойчивый
statistical	статистический
mention	упомянуть
innovation	инновация
grey	серый
parallel	параллельно
operate	работать
bills	банкноты
stable	стабильный
definitions	определения
von	фон
doctors	врачи
lesson	урок
cinema	кино
elections	выборы
reaction	реакция
blank	пустой
enhanced	повышенная
entitled	озаглавленный
severe	серьезный
generate	генерировать
newspapers	газеты
hospitals	больницы
vi	VI
humor	юмор
aged	престарелый
monitors	мониторы
exception	исключение
duration	продолжительность
bulk	насыпной
visits	посещения
capabilities	возможности
recommendation	рекомендация
sin	грех
organized	организованная
ba	ба
para	пункт
adoption	принятие
improving	улучшение
expensive	дорогая
buffalo	буйвол
organisations	организации
plane	самолет
programmes	программы
mechanism	механизм
ee	й
marked	отмеченный
driven	управляемый
bottle	бутылка
innovative	инновационный
massage	массаж
conclusion	вывод
closing	закрытие
thousand	тысяча
legend	легенда
villa	вилла
bone	кость
columns	столбцы
disorders	расстройства
collaboration	сотрудничество
detection	обнаружение
inner	внутренний
formation	образование
med	мед
engineers	инженеры
entity	организация
cruises	круизы
gate	Ворота
roman	Римский
duties	обязанности
erotic	эротический
tone	тон
ethics	этика
dragon	Дракон
busy	занятый
captain	капитан
brings	приносит
heating	обогрев
leg	ножка
neck	шея
wing	крыло
scripts	скрипты
abc	азбука
appointed	назначенный
dealing	дело
commit	совершить
rail	рельс
trips	поездки
gap	разрыв
sides	стороны
tube	трубка
corresponding	соответствующий
descriptions	описания
belt	ремень
jacket	куртка
animation	анимация
oracle	оракул
er	эр
productions	производства
aviation	авиация
proud	гордый
disaster	катастрофа
console	консоль
commands	команды
jr	младший
telecommunications	связь
instructor	инструктор
giant	гигант
achieved	достигнутый
injuries	травмы
approaches	подходы
usual	обычный
stamps	Марки
angle	угол
rob	грабить
designers	дизайнеры
liberty	свобода
era	эпоха
convert	конвертировать
possibility	возможность
analyst	аналитик
dangerous	опасно
reliability	надежность
respectively	соответственно
volunteers	добровольцы
derived	полученный
pleasure	удовольствие
honor	честь
oriented	ориентированного
eagle	орел
prayer	молитва
workshops	мастерские
hurricane	ураган
quiet	тихо
producer	режиссер
represented	представленный
responsibilities	обязанности
cheese	сыр
carefully	внимательно
productivity	производительность
crown	корона
par	паритет
diagnosis	диагностика
maker	производитель
crack	трещина
principle	принцип
picks	кирки
gang	банда
fetish	фетиш
appearance	появление
smoke	дым
filters	фильтры
incorporated	включенный
craft	ремесло
fellow	человек
blind	слепой
lounge	гостиная
mad	Сумасшедший
algorithm	алгоритм
strongly	сильно
cafe	кафе
ken	кругозор
proteins	белки
su	су
familiar	знакомые
capable	способный
admission	вход
shoe	башмак
elected	избран
carrying	проведение
terrorism	терроризм
joy	радость
editions	издания
ethnic	этнической
parliament	парламент
actor	актер
finds	находки
seal	печать
situations	ситуации
fifth	пятый
citizen	гражданин
vertical	вертикальный
corrections	поправки
describes	описывает
disabilities	инвалидов
substance	вещество
prohibited	запрещено
pipe	труба
soldiers	солдаты
guardian	опекун
lecture	лекция
simulation	моделирование
layout	расположение
initiatives	инициативы
ill	больной
concentration	концентрация
lay	прокладывать
interpretation	интерпретация
dirty	грязный
taught	учил
worker	работник
optimization	оптимизация
temple	храм
substances	вещества
prove	доказывать
discovered	обнаруженный
wings	крылья
genetic	генетический
restrictions	ограничения
thin	тонкий
exhibition	выставка
ridge	хребет
modem	модем
bringing	приведение
sick	больной
evaluate	оценивать
tropical	тропический
collect	собирать
vector	вектор
definitely	определенно
turning	превращение
existence	существование
commentary	комментарий
developments	события
immigration	иммиграция
destinations	направления
mutual	взаимное
syntax	синтаксис
li	литий
attribute	атрибут
prison	тюрьма
skill	умение
chairs	стулья
surrounding	окружающих
mountains	горы
popularity	популярность
inquiry	запрос
checked	проверено
exhibit	экспонат
throw	бросать
trend	тенденция
cats	коты
desert	пустыня
ya	я
coordinator	координатор
mercury	Меркурий
burning	сжигание
escape	побег
receiver	получатель
progressive	прогрессирующий
boats	лодки
championship	чемпионат
arcade	аркада
impossible	невозможно
tells	говорит
obvious	очевидный
depression	депрессия
graph	график
covering	покрытие
platinum	платина
judgment	суждение
talks	переговоры
filing	подача
foster	способствовать
awarded	награжден
trials	испытания
masters	мастера
cartridge	картридж
explanation	объяснение
org	организация
fraud	мошенничество
electricity	электричество
spectrum	спектр
arrival	прибытие
pottery	керамика
emphasis	акцент
awesome	здорово
confirmed	подтвердил
counts	счетчики
crash	авария
lift	лифт
inter	между
heights	высоты
shadow	тень
expense	расходы
venture	предприятие
clinic	клиника
healing	исцеление
princess	принцесса
entering	входящий
packet	пакет
studios	студии
involvement	участие
dad	папа
buttons	кнопки
placement	размещение
observations	наблюдения
winners	победители
roads	дороги
subsequent	последующий
yard	двор
disclosure	раскрытие
establishment	создание
memories	воспоминания
te	тэ
creates	создает
faces	лица
tourist	турист
murder	убийство
adequate	адекватный
senator	сенатор
presentations	презентации
digest	дайджест
dust	пыли
wiki	вики
replaced	заменены
radar	радиолокационный
losses	потери
combat	бой
reducing	сокращение
stopped	остановился
occupation	занятие
closely	тесно
radiation	излучение
kings	короли
shooting	стрельба
ear	ухо
flags	флаги
baker	пекарь
conservative	консервативный
shock	шок
effectiveness	эффективность
tie	галстук
roof	крыша
demonstrate	демонстрировать
atmosphere	атмосфера
kiss	поцелуй
beast	зверь
ra	ра
operated	управляемый
experiment	эксперимент
targets	цели
purchases	покупки
federation	федерация
pizza	пицца
invited	приглашенный
assignment	назначение
mod	модификация
queries	запросы
absence	отсутствие
vendors	поставщики
yoga	йога
serves	служит
surprise	сюрприз
lamp	лампа
jokes	шутки
counseling	консультирование
palace	дворец
satisfied	доволен
wins	победы
warehouse	склад
supposed	предполагаемый
ordinary	обычный
ghost	призрак
violation	нарушение
boss	босс
pride	гордость
expectations	ожидания
independence	независимость
knowing	знание
reporter	репортер
metabolism	метаболизм
champion	чемпион
personally	лично
plenty	много
solo	соло
throat	горло
wealth	богатство
vacuum	вакуум
dancing	танцы
recognize	признать
writes	пишет
plaza	площадь
quest	поиск
publish	публиковать
screening	скрининг
trans	транс
pioneer	пионер
forgotten	забытый
acrobat	акробат
plates	тарелки
essays	эссе
behaviour	поведение
telling	говоря
fairly	довольно
intelligent	умный
modes	режимы
obligation	обязательство
harbor	гавань
traveler	путешественник
segment	сегмент
enemy	враг
puzzle	головоломка
wells	углубления
restricted	ограниченный
republican	республиканец
secrets	секреты
syndrome	синдром
attendance	посещаемость
penalty	штраф
drum	барабан
enables	позволяет
builder	строитель
vista	перспектива
flood	наводнение
ease	легкость
arguments	аргументы
arena	арена
adventures	приключения
pupils	зрачки
announcement	объявление
outcome	исход
appreciate	ценить
expanded	расширенный
grown	взрослый
lovely	прекрасный
centres	центры
clause	пункт
smile	улыбка
lands	земли
troops	войска
armed	вооруженный
pine	сосна
cooling	охлаждение
gulf	залив
trucks	грузовики
mechanisms	механизмы
divorce	развод
tradition	традиция
pills	таблетки
tiger	тигр
folks	люди
sensor	датчик
exposed	подвергаются
hunt	охота
angels	ангелы
deputy	заместитель
thai	тайский
emissions	выбросы
physicians	врачи
complaint	жалоба
scenes	сцены
experiments	эксперименты
boost	увеличение
governance	управление
mill	мельница
founded	основанный
chronic	хронический
den	логово
finger	Палец
keeps	держит
pound	фунт
locate	разместить
pl	пл
trained	обученный
implementing	реализации
bread	хлеб
motors	моторы
tough	жесткий
incident	инцидент
dynamics	динамика
lie	ложь
conversation	разговор
decrease	снижение
worship	поклонение
capability	возможность
ak	Аляска
precision	точность
damages	убытки
reserves	резервы
solve	решать
minority	меньшинство
diverse	разнообразный
ingredients	ингредиенты
ah	ах
tones	тоны
rehabilitation	реабилитация
sight	взгляд
clay	глина
weak	слабый
divided	разделенный
reception	прием
wise	мудрый
odds	шансы
seminars	семинары
consequences	последствия
makers	производители
geography	география
integrity	целостность
legacy	наследие
pleased	довольный
danger	Опасность
vitamin	витамин
processed	обработанный
phrase	фраза
raising	привлечение
implications	последствия
functionality	функциональность
paradise	рай
hybrid	гибридный
reads	читает
emotional	эмоциональный
glory	слава
ja	JA
geographic	географический
exceed	превышать
rod	стержень
silk	шелк
babies	дети
bi	би
romantic	романтик
revealed	показал
specialists	специалисты
generator	генератор
suspension	подвеска
sad	грустный
correction	коррекция
wolf	волк
slowly	медленно
supplement	дополнение
portions	участки
infant	младенец
sectors	секторов
fluid	жидкость
grounds	основания
meal	еда
ta	та
machinery	машины
equation	уравнение
baskets	корзины
probability	вероятность
dimension	измерение
studied	изучал
profits	доходы
devil	дьявол
grass	трава
illustrated	иллюстрированный
cherry	вишня
continental	континентальный
achievement	достижение
limitations	ограничения
funeral	похороны
chapters	главы
passenger	пассажир
convenient	удобный
mars	Марс
sized	размера
egg	яйцо
signals	сигналы
orientation	ориентация
theft	кража
childhood	детство
symbols	символы
lat	Lat
meta	мета
analog	аналоговый
talent	талант
dated	датированный
wisdom	мудрость
boundary	граница
elite	элита
gi	солдат
believes	считает
poems	стихи
jurisdiction	юрисдикция
robot	робот
displaying	отображение
witness	свидетель
equipped	оборудованный
stages	этапы
sur	сюр
acquired	приобретенный
assess	оценить
wash	мыть
entrance	вход
declaration	декларация
losing	проигрыш
attempts	попытки
noble	благородный
automation	автоматизация
impacts	воздействие
rev	оборот
advantages	преимущества
knight	рыцарь
aims	цели
extensions	расширения
appeals	апелляции
illness	болезнь
ho	эй
alternatives	альтернативы
sh	ш
soap	мыло
jam	варенье
unusual	необычный
answered	ответил
destruction	разрушение
migration	миграция
disorder	расстройство
conventional	обычный
wearing	носить
axis	ось
sought	искать
genes	гены
median	медиана
scanner	сканер
herein	здесь
animated	мультипликационный
adjustment	регулировка
hero	герой
treatments	лечение
attitude	отношение
carpet	ковер
lenses	линзы
attended	участие
difficulty	трудность
punk	панк
coalition	коалиция
enrollment	регистрация
duke	герцог
pace	темп
producers	производители
arc	дуга
interfaces	интерфейсы
atlas	атлас
observation	наблюдение
torture	пытки
deleted	удаленный
coat	Пальто
restoration	восстановление
convenience	удобство
returning	возврате
opposition	оппозиция
container	контейнер
defendant	ответчик
supervisor	руководитель
corps	корпус
actors	актеры
liver	печень
liable	подлежащий
petition	петиция
antenna	антенна
picked	выбрал
belief	вера
killing	убийство
shoulder	плечо
decor	оформление
ion	ион
diameter	диаметр
podcast	подкаст
interactions	взаимодействия
singer	певец
herald	вестник
aging	старение
intervention	вмешательство
plugin	плагин
attraction	Привлечение
diving	дайвинг
modification	модификация
suppose	предполагать
reed	тростник
involve	включать
moderate	умеренный
mice	мышей
understood	понимать
rapidly	быстро
ban	запрет
assurance	гарантия
happening	происходит
vast	огромный
mills	мельницы
outline	контур
receives	получает
jeans	джинсы
compilation	сборник
odd	странный
sigma	сигма
gr	гр
attractive	привлекательный
occasion	повод
recordings	записи
victim	жертва
demands	требования
careful	осторожный
beam	луч
gardening	садоводство
obligations	обязательства
arrive	прибыть
orchestra	оркестр
licence	лицензия
adjustable	регулируемый
allocation	распределение
essay	сочинение
demonstrated	продемонстрировал
dialogue	диалог
camps	лагеря
declared	объявленный
trace	след
shut	закрыть
packs	пакеты
ge	GE
installing	установка
switches	переключатели
voluntary	добровольный
thou	ты
greatly	значительно
ng	нг
commonly	обычно
pe	ре
photographer	фотограф
cry	плакать
quantum	квант
constructed	построенный
additions	дополнения
requiring	требующий
arrow	стрела
engagement	помолвка
rough	грубый
weird	странный
lion	лев
weddings	свадьбы
oxygen	кислород
canyon	каньон
meters	метры
merely	просто
calendars	календари
arrangement	договоренность
conclusions	выводы
bibliography	Библиография
pointer	указатель
compatibility	совместимость
stretch	протяжение
permits	разрешения
cooperative	кооператив
feeding	кормление
township	городок
rankings	рейтинги
measuring	измерения
strap	ремень
crowd	толпа
transfers	переводы
olympic	олимпийский
transformation	преобразование
dir	реж
customs	обычаи
administrators	администраторы
personality	личность
hook	крюк
roulette	рулетка
decline	снижение
cord	шнур
cloud	облако
facilitate	содействовать
val	вал
explains	объясняет
proceed	продолжить
feelings	чувства
knife	нож
adopt	принять
denied	отказано
donation	пожертвование
outer	внешний
crop	культура
rivers	реки
nodes	узлы
cited	цитируется
hub	хаб
targeted	целевое
realized	понял
founder	основатель
decade	десятилетие
dispute	спор
tired	устала
adverse	неблагоприятный
excerpt	выдержка
discharge	разряд
drinks	напитки
ace	туз
voices	голоса
climbing	альпинизм
tons	тонны
perfume	духи
hazardous	опасный
restore	восстановить
stack	стек
methodology	методология
reputation	репутации
democrats	демократы
hang	вешать
curve	кривая
creator	создатель
amber	янтарный
museums	музеи
coding	кодирование
tracker	трекер
variation	изменение
passage	прохождение
transferred	переданы
trunk	хобот
photograph	фотография
waves	волны
camel	верблюд
distributor	распределитель
chi	чи
gathering	сбор
projection	проекция
mathematical	математическая
logical	логический
sauce	соус
fame	известность
specialized	специализированный
corporations	корпорации
criticism	критика
automobile	автомобиль
judges	судьи
remarks	замечания
detected	обнаруженный
paintings	картины
walked	ходил
arising	возникающий
populations	популяции
afraid	боюсь
acoustic	акустическое
cassette	кассета
indicator	индикатор
jpg	JPG
mistake	ошибка
eliminate	Устранить
mineral	минеральная
ruby	Рубин
beads	бисер
fortune	состояние
canvas	холст
threshold	порог
parish	приход
screens	экраны
cemetery	кладбище
stadium	стадион
exploration	исследование
mins	мин
stem	стебель
astronomy	астрономия
contests	конкурсы
flu	грипп
costume	костюм
bikes	велосипеды
bishop	епископ
pulled	вытащил
corn	кукуруза
compression	компрессия
establishing	налаживание
farmer	фермер
tin	банка
slave	рабыня
instantly	немедленно
coaching	тренировка
examined	рассмотрел
encoding	кодирование
submissions	Доводы
heroes	герои
painted	окрашенный
portrait	портрет
terrorist	террорист
ethical	этический
carriers	носители
mobility	мобильность
struggle	борьба
schemes	схемы
suffering	страдающий
neutral	нейтральный
fisher	рыболов
rat	крыса
spears	копья
joining	присоединение
heading	заголовок
artificial	искусственный
bearing	подшипник
spectacular	захватывающий
worlds	миры
guilty	виновный
activation	активация
haven	убежище
tablet	таблетка
jury	жюри
dos	DOS
tail	хвост
charm	очарование
violent	насильственный
potentially	потенциально
ranch	ранчо
constraints	ограничения
crossing	скрещивание
inclusive	включительно
cottage	коттедж
drunk	пьяный
considerable	значительный
crimes	преступления
resolved	решены
byte	байт
nose	нос
branches	ветви
alien	инопланетянин
processors	процессоры
broke	сломал
complexity	сложность
constantly	постоянно
resolve	разрешить
territories	территории
thesis	Тезис
discs	диски
frequent	частый
ceiling	потолок
pixels	пикселей
gen	поколения
diamonds	бриллианты
fleet	флот
bunch	гроздь
theoretical	теоретический
referral	направления
quit	уволиться
protocols	протоколы
lung	легкое
substitute	замена
brilliant	блестящий
ti	ти
gel	гель
spoken	разговорный
omega	омега
evaluated	оценивали
stayed	остались
sees	видит
termination	прекращение
watched	смотрели
households	домохозяйства
redeem	выкупать
grain	зерно
regime	режим
bull	бык
architectural	архитектурный
differ	отличаться
movements	движения
repairs	ремонт
breath	дыхание
amenities	услуги
virtually	фактически
mart	рынок
candle	свеча
hanging	подвешивание
colored	цветной
tale	рассказ
formerly	раньше
projector	проектор
situated	расположенный
seeks	стремится
strictly	строго
psychological	психологический
vitamins	витамины
elegant	элегантный
gains	доходы
renewal	обновление
genealogy	генеалогия
deemed	считается
scoring	счет
expenditure	расход
critics	критики
algorithms	алгоритмы
hacker	хакер
salon	салон
turbo	турбо
cure	лечение
ni	п
thinks	думает
suggestion	предложение
soldier	солдат
bomb	бомбить
harm	вред
interval	интервал
mirrors	зеркала
investigate	исследовать
thy	твой
panels	панели
repeated	повторный
assault	нападение
deer	олень
tongue	язык
bowling	боулинг
tri	три
monkey	обезьяна
proportion	доля
skirt	юбка
analyses	анализы
drawings	рисунки
significance	значение
scenario	сценарий
ye	вы
arabic	арабский
gauge	калибр
protecting	защищающий
faced	сталкиваются
solving	решение
produces	производит
intensive	интенсивный
chains	цепи
sixth	шестой
engage	заниматься
switching	переключение
correspondence	переписка
imports	импорт
supervision	надзор
expenditures	Расходы
separation	разделение
testimony	свидетельство
suspect	подозреваемый
mandatory	обязательное
boundaries	границы
celebration	праздник
filtering	фильтрация
spouse	супруг
exotic	экзотический
viewer	зритель
reaching	достижения
laugh	смех
surgical	хирургический
destroy	уничтожить
citation	цитата
yo	Эй
premises	предпосылки
proved	доказано
offensive	наступление
imperial	имперский
dozen	дюжина
deployment	развертывание
cloth	ткань
lotus	лотос
salmon	лосось
cargo	грузовой
directive	директива
mate	приятель
butter	масло
pepper	перец
weapon	оружие
burden	бремя
tapes	ленты
zones	зон
isle	островной
slim	стройное
maple	кленовый
grocery	продуктовый
governing	руководящий
depot	депо
alt	альт
pie	пирог
blend	смесь
emission	излучение
apparent	очевидный
instructional	учебный
permissions	разрешений
toilet	туалет
ranked	занимает
routes	маршруты
mounting	монтаж
tied	связанный
balanced	сбалансированный
delayed	задерживается
dale	дол
calculation	расчет
villas	виллы
occasions	случаи
equations	уравнения
oils	масла
sept	сентябре
exceptional	исключительный
anxiety	тревожность
spatial	пространственный
respondents	респондентов
considerations	соображения
pays	платит
sunny	солнечно
delivers	обеспечивает
je	JE
necklace	ожерелье
composite	композитный
lang	языки
theaters	театры
designing	проектирование
hopes	надеется
assessments	оценки
diagram	диаграмма
footwear	обувь
sg	SG
peoples	народов
victor	Виктор
licenses	лицензии
ranges	диапазоны
pairs	пары
sensitivity	чувствительность
preservation	сохранение
isolated	изолированный
interim	промежуточный
assisted	помощь
divine	божественный
approve	одобрить
compound	соединение
intensity	интенсивность
technological	технологический
abortion	аборт
dialog	диалог
venues	центры
blast	взрыв
addressing	адресация
pole	столб
shield	щит
membrane	мембрана
desperate	отчаянный
mothers	матери
demonstration	демонстрация
governmental	правительственный
manufactured	изготовлен
candles	свечи
variations	вариации
moms	мамы
sacred	священный
addiction	зависимость
chrome	хром
refused	отказалась
brake	тормоз
exterior	экстерьер
greeting	приветствие
ecology	экология
glen	лощина
unemployment	безработица
scored	забил
enhancement	усиление
clone	клон
velocity	скорость
lambda	лямбда
composed	состоящий
tears	слезы
oasis	оазис
cab	такси
fa	фа
societies	общества
silicon	кремний
identical	идентичный
petroleum	нефть
compete	конкурировать
ist	IST
lover	любовник
belong	принадлежать
lips	губы
escort	эскорт
pond	пруд
ferry	паром
rabbit	кролик
profession	профессия
dam	дамба
physiology	физиология
exports	экспорт
tire	шина
participant	участник
electron	электрон
loads	грузы
heather	вереск
motel	мотель
unions	союзы
treasury	казначейство
occupied	занятый
scales	Весы
strain	напряжение
arrested	арестованный
investigations	исследования
gained	получили
laundry	прачечная
placing	размещение
adjust	регулировать
assessed	оценивается
encryption	шифрование
filling	заполнение
imposed	наложенный
silence	тишина
soviet	советский
possession	владение
treaty	договор
trainer	тренер
organ	орган
lemon	лимон
darkness	темнота
span	пролет
joke	шутка
packing	упаковка
statute	статут
rejected	отвергнуто
shelter	укрытие
chapel	часовня
manufacture	производство
layers	слои
celebrate	праздновать
appliance	прибор
mixture	смесь
rider	наездник
radius	радиус
impressive	впечатляющий
sheep	овца
architect	архитектор
lectures	лекции
wines	вина
cups	чашки
ash	ясень
contributors	авторы
salad	салат
violations	нарушения
temperatures	температура
competitions	соревнования
preserve	сохранять
poem	стих
staying	пребывание
easter	Пасха
theories	теории
repository	хранилище
streams	потоки
landing	посадка
executed	выполненный
negotiations	переговоры
realistic	реалистический
asks	спрашивает
synopsis	конспект
composer	композитор
bean	боб
sword	меч
modifications	изменения
coral	коралловый
pixel	пиксель
paths	пути
bubble	пузырь
por	Пор
acquire	приобретать
contrary	вопреки
tribune	трибуна
vessel	судно
acids	кислоты
viruses	вирусы
stickers	наклейки
reactions	реакции
beliefs	убеждения
squad	команда
analyze	анализировать
divisions	подразделения
swim	плавать
nano	нано
concerts	концерты
males	мужчины
retain	сохранить
colours	цвета
execute	выполнять
tunnel	тоннель
genres	жанры
patents	патенты
wheat	пшеница
chronicles	летописи
obtaining	получение
beaver	бобр
readings	чтения
enlargement	укрупнение
eagles	орлов
bases	основы
accused	обвиняемый
campaigns	кампании
unity	единство
defines	определяет
instances	экземпляры
indigenous	местный
begun	начатый
packets	пакеты
anchor	якорь
socks	носки
trigger	вызывать
cholesterol	холестерин
differential	дифференциал
surfaces	поверхности
terrible	ужасный
routers	маршрутизаторы
clocks	часы
arthritis	артрит
bios	BIOS
females	женщины
reflects	отражает
taxation	налогообложение
fever	лихорадка
cuisine	кухня
surely	конечно
practitioners	практики
theorem	теорема
inflation	инфляция
thee	тебя
compounds	соединений
drums	барабаны
reasonably	разумно
bare	голый
radical	радикал
recommends	рекомендует
controlling	управление
treasure	сокровище
flame	пламя
pit	яма
mono	моно
particles	частицы
floating	плавающий
coordinate	координировать
exclusively	исключительно
limitation	ограничение
struck	пораженный
illustration	иллюстрация
warnings	предупреждения
construct	сооружать
apps	Программы
inquiries	запросы
annex	приложение
inspiration	вдохновение
freight	грузовой
eclipse	затмение
affects	влияет
forecasts	прогнозы
detect	обнаружить
actively	активно
complicated	сложно
injured	пострадавший
expressions	выражения
ton	тонна
courier	курьер
hints	Рекомендации
gif	GIF
conflicts	конфликты
beverage	напиток
tribute	дань
immune	иммунный
forestry	лесоводство
barriers	барьеры
cant	косяк
rarely	редко
offerings	предложения
barrier	барьер
bicycle	велосипед
furnishings	обстановка
arise	возникать
celtic	кельтская
particle	частица
humidity	влажность
bottles	бутылки
dm	дм
renaissance	Ренессанс
ordinance	постановление
photographers	фотографы
infections	инфекции
chess	шахматы
operates	работает
festivals	фестивали
possibilities	возможности
duck	утка
canal	канал
contributing	способствуя
cow	корова
analytical	аналитический
costumes	костюмы
strict	строгий
circulation	циркуляция
offense	преступление
assumption	предположение
hobby	хобби
tries	пытается
invention	изобретение
technician	техник
executives	руководство
enquiries	запросы
cognitive	познавательный
exploring	исследование
trick	трюк
enquiry	запрос
closure	закрытие
timber	лесоматериалы
volt	вольт
intense	интенсивный
supporters	сторонников
statutes	статуты
enrolled	зачислен
sensors	датчиков
screw	винт
ministers	министры
publicly	публично
suffered	пострадали
intake	потребление
butterfly	бабочка
mechanics	механика
headers	заголовки
mistakes	ошибки
numerical	численный
defining	определяющий
counting	подсчет
reflection	отражение
invitation	приглашение
sodium	натрий
hormone	гормон
childrens	детская
brick	кирпич
grip	рукоятка
medieval	средневековый
porcelain	фарфор
captured	захваченный
decent	порядочный
casting	Кастинг
translated	переведенный
donna	Донна
warrior	воин
cabin	кабина
scanning	сканирование
polo	поло
copying	копирование
horn	рог
journalism	журналистика
frog	лягушка
grammar	грамматика
intention	намерение
tires	шины
undertaken	проведены
hazard	опасность
episodes	эпизоды
circular	круговой
anger	гнев
illustrations	иллюстрации
chances	шансы
happiness	счастье
bizarre	эксцентричный
ur	ур
fruits	фрукты
identifier	идентификатор
ribbon	лента
calculations	вычисления
jpeg	JPEG
startup	запускать
handy	удобный
swap	замена
exempt	освобожденный
crops	культуры
reduces	уменьшает
accomplished	осуществляется
geometry	геометрия
impression	впечатление
guild	гильдия
correlation	корреляция
sim	сим
nervous	нервное
fragrance	аромат
replica	копия
tribe	племя
trades	сделки
superb	превосходный
rid	избавиться
trinity	Троица
handled	обрабатываются
legends	легенды
boom	бум
calm	спокойный
champions	чемпионы
floors	этажей
selections	выборы
comparing	Сравнение
speaks	говорит
vocational	профессиональное
pharmacies	аптеки
ln	пер
roller	ролик
batch	партия
organize	организовать
appreciated	оценили
alter	изменять
edges	края
mixing	смешивание
handles	ручки
harmony	гармония
distinguished	выдающийся
asthma	астма
assumptions	допущения
regulated	регулируется
triangle	треугольник
amend	изменить
anticipated	ожидаемый
oriental	восточный
reward	награда
hydrogen	водород
comparable	сравнимый
advocate	адвокат
confusion	путаница
inputs	входные
warranties	гарантии
genome	геном
medal	медаль
coaches	тренеры
vessels	суд
harbour	гавань
eco	эко
vulnerable	уязвимый
arrange	организовать
artistic	художественный
honors	почести
reflected	отраженный
unified	унифицированный
breed	разводить
detector	детектор
ignored	игнорируются
precise	точный
evaluating	оценки
lip	губа
gather	собирать
forming	формирование
journalists	журналисты
slight	незначительный
indirect	косвенный
amongst	среди
foundations	устои
horizon	горизонт
nu	ню
deeply	глубоко
liabilities	обязательства
prizes	призы
decreased	снизилась
describing	описывающее
optics	оптика
pursue	преследовать
lightning	молния
ou	ОУ
quotations	цитаты
inspector	инспектор
snake	змея
reminder	напоминание
searched	поиск
plains	равнины
insights	понимание
abilities	способности
initiated	начатый
karaoke	караоке
trap	ловушка
lonely	Одинокий
ve	ве
observe	наблюдать
containers	контейнеры
attitudes	отношения
berry	ягода
collar	воротник
integrate	интегрировать
sociology	социология
exhibits	экспонаты
dies	умирает
terrace	терраса
bacteria	бактерии
ought	должен
delicious	вкусно
traditions	традиции
finite	конечный
sends	посылает
durable	прочный
allied	союзный
moisture	влажность
transform	преобразование
timer	таймер
tablets	таблетки
gotten	полученный
educators	воспитатели
vegetable	овощной
verse	стих
independently	независимо
competitors	конкуренты
rocket	ракета
aye	да
bullet	пуля
towers	башни
visibility	видимость
latitude	широта
consciousness	сознание
tumor	опухоль
ugly	уродливый
deposits	депозиты
mistress	госпожа
encounter	столкновение
watts	Вт
forty	сорок
tubes	трубы
attempted	попытка
priest	священник
analysts	аналитики
hammer	молоток
invasion	вторжение
runner	бегун
rows	строки
administered	вводить
notion	понятие
spelling	написание
arctic	Арктический
rewards	награды
beneath	под
strengthen	укреплять
defend	защищать
infrared	инфракрасный
seventh	седьмой
belly	живот
aggressive	агрессивный
advertisements	объявления
quarters	помещение
stolen	похищенный
determines	определяет
sculpture	скульптура
poly	поли
ears	уши
fist	кулак
neo	нео
motivation	мотивация
passengers	пассажиров
consistently	последовательно
surplus	избыток
dig	копать
taxi	такси
appreciation	признательность
om	ом
restriction	ограничение
guitars	гитары
essence	сущность
mighty	могущественный
humanity	человечество
transcription	транскрипция
complications	осложнения
scholars	ученые
galaxy	галактика
caring	заботливая
testament	завещание
dominant	доминирующий
stomach	желудок
partially	частично
minimize	минимизировать
ranks	ряды
debut	дебют
generations	поколения
tournaments	турниры
deny	Отрицать
anatomy	анатомия
headphones	наушники
fraction	доля
trio	трио
proceeding	судопроизводство
cube	куб
defects	дефекты
uncertainty	неопределенность
breakdown	сломать
settled	решен
vaccine	вакцина
fate	судьба
bookings	бронирование
republicans	республиканцы
jungle	джунгли
zen	Дзэн
dis	дис
prediction	прогнозирование
ecological	экологический
oval	овальный
implies	подразумевает
ser	сер
appraisal	оценка
prospect	перспектива
geographical	географический
donor	донор
tension	напряженность
trash	мусор
shapes	формы
tier	ярус
earl	граф
homeland	Родина
championships	чемпионаты
breeds	породы
disco	дискотека
aus	AUS
finishing	отделка
emotions	эмоции
eternal	вечный
rotation	вращение
nam	Нама
productive	продуктивный
boulevard	бульвар
pig	свинья
metric	метрический
penalties	штрафы
varied	разнообразный
grande	Гранди
actress	актриса
assign	назначать
accommodate	вмещать
tigers	тигры
villages	деревни
shade	тень
chorus	хор
rhythm	ритм
digit	цифра
symphony	симфония
sudden	внезапно
accepting	принимающий
pools	бассейны
lyric	лирический
isolation	изоляция
speeds	скорость
sustained	устойчивый
matched	соответствие
approximate	приближенный
rope	веревка
rational	рациональный
programmer	программист
fighters	боевики
inherited	унаследованный
incomplete	неполный
vocals	вокал
fountain	фонтан
legitimate	законный
biographies	биографии
investigator	следователь
plaintiff	истец
gentle	нежный
worthy	достойный
architects	архитекторы
saints	святые
entrepreneur	предприниматель
carries	осуществляет
duo	дуэт
excessive	чрезмерное
saves	экономит
regarded	рассматривать
valuation	оценка
unexpected	неожиданный
fog	туман
characteristic	характеристика
lobby	лобби
outlined	изложены
enormous	огромный
karma	карма
consist	состоять
queens	Квинс
academics	ученые
tribes	племена
distinction	различие
hazards	опасность
exemption	освобождение
tenant	арендатор
sustainability	устойчивость
tattoo	тату
algebra	алгебра
shadows	тени
silly	глупый
freely	свободно
mild	мягкий
fur	мех
readily	легко
affiliation	присоединение
fence	забор
infinite	бесконечный
clan	клан
revolutionary	революционер
bracelets	браслеты
remedy	средство
breathing	дыхание
briefly	кратко
thickness	толщина
graphical	графический
genius	гениальность
discussing	обсуждение
fighter	истребитель
meaningful	значимым
adapted	адаптированный
estates	усадеб
rug	коврик
democrat	демократ
borough	район
maintains	поддерживает
ka	ка
retained	сохраняется
marble	мрамор
dem	дем
meditation	медитация
microphone	микрофон
combining	объединение
giants	гиганты
organizing	организация
memo	меморандум
ham	ветчина
solved	решена
tide	волна
partition	раздел
invisible	невидимый
consoles	консоли
magnet	магнит
translations	переводы
jaguar	ягуар
commodity	товар
kilometers	километров
guarantees	гарантии
gothic	готика
cylinder	цилиндр
witch	ведьма
buck	доллар
enemies	враги
consultancy	консультирование
enjoying	наслаждаясь
patrol	патруль
smell	запах
carnival	карнавал
roughly	грубо
sticker	наклейка
promises	обещания
reef	риф
divide	делить
consecutive	последовательный
bon	бон
representations	представления
chan	чан
tunes	мелодии
mas	Рождество
phrases	фразы
kai	кай
peninsula	полуостров
boring	скучный
dom	дом
speeches	речи
reaches	достигает
schema	схема
catalogs	каталоги
ministries	министерства
parliamentary	парламентский
prefix	префикс
savannah	саванна
barrel	бочка
nerve	нерв
dans	данс
planets	планеты
deficit	дефицит
renew	возобновлять
coupled	соединенный
circuits	схемы
texture	текстура
acknowledge	признавать
tent	палатка
identifies	определяет
qualification	квалификация
locks	замки
miniature	миниатюрный
euros	евро
pirates	пираты
aerial	антенна
hawk	ястреб
consequence	следствие
systematic	систематическая
perceived	воспринимается
origins	происхождения
hired	наемный
makeup	составить
ui	щ
weights	веса
geological	геологический
lasting	прочный
wicked	злой
introduces	вводит
pushed	толкнул
ro	ро
slope	скат
poet	поэт
conspiracy	заговор
theology	теология
nails	ногти
evident	очевидный
rides	аттракционы
epic	эпический
organizer	организатор
allergy	аллергия
sake	ради
combinations	комбинации
preceding	предшествующий
merit	заслуга
enzyme	фермент
planes	самолеты
disks	диски
amplifier	усилитель
arbitrary	произвольный
prominent	видный
sans	без
builds	строит
contacted	связаться
shaft	вал
lean	опираться
occasional	случайный
innovations	инновации
reviewing	рассмотрение
panic	паника
citizenship	гражданство
excuse	оправдание
reforms	реформы
onion	лук
sandwich	сэндвич
alto	альт
hierarchy	иерархия
abandoned	заброшенный
circles	круги
beats	биения
merry	веселый
cult	культ
dash	тир
passive	пассивный
valued	ценный
cage	клетка
courage	мужество
elevation	высота
lap	круг
utilization	использование
beverages	напитки
ping	пинг
entertaining	развлекательный
prerequisite	предпосылка
frontier	граница
refugees	беженцы
knights	рыцари
hypothesis	гипотеза
medicines	медикаменты
altered	изменено
doctrine	учение
scenic	сценический
enhancements	улучшения
intersection	пересечение
sewing	шитье
collectors	коллекторы
recognised	признанное
rage	ярость
prix	Приза
astrology	астрология
advisors	консультанты
pavilion	павильон
tactics	тактика
supplemental	дополнительный
talented	талантливый
pillow	подушка
spreading	распространение
provinces	провинция
steal	украсть
parcel	пакет
incidence	падение
fears	боится
predict	прогнозировать
flavor	аромат
hungry	голодный
metallic	металлический
interference	интерференция
warriors	воины
atmospheric	атмосферный
halo	гало
parental	родительский
referenced	ссылка
strikes	забастовки
ant	муравей
proposition	предложение
apt	склонный
dealt	дело
trader	трейдер
thrown	выброшены
criterion	критерий
badge	значок
civilization	цивилизация
heath	вереск
tremendous	огромный
performs	выполняет
realm	область
corrected	исправленный
helmet	шлем
encountered	встречается
tsunami	цунами
scholar	ученый
surrounded	окруженный
geology	геология
creatures	существа
cleared	очищается
accomplish	выполнять
corners	углы
vegetarian	вегетарианец
yeast	дрожжи
pas	па
investigated	исследовалась
ambassador	посол
coated	покрытый
doom	гибель
routines	подпрограммы
beings	существа
reliance	опора
myth	миф
brook	ручей
fu	марихуана
phenomenon	явление
ensemble	ансамбль
assured	уверенный
conscious	сознательный
accent	акцент
wives	жены
utilize	использовать
pledge	залог
vampire	вампир
dock	док
organised	организованная
musician	музыкант
limiting	ограничения
restored	восстановлен
hint	намек
armor	броня
remark	замечание
dozens	множество
varies	меняется
reasoning	рассуждения
guards	гвардия
openings	отверстия
replacing	замена
researcher	Исследователь
councils	советы
occupations	профессий
acknowledged	признанный
pork	свинина
zu	цу
equilibrium	равновесие
pipes	трубы
cottages	коттеджи
merge	сливаться
privilege	привилегия
develops	развивается
chassis	шасси
estimation	оценка
barn	сарай
frost	мороз
institutes	институты
mold	плесень
dame	дама
yacht	яхта
prefers	предпочитает
drilling	бурение
herb	трава
breach	нарушение
whale	кит
traveller	путешественник
appropriations	ассигнования
suspected	подозреваемый
tomatoes	помидоры
instructors	инструкторы
momentum	импульс
fin	плавник
pastor	пастор
mud	грязи
emerald	изумруд
grows	растет
tract	тракт
ul	уль
ballet	балет
journalist	журналист
religions	религии
garlic	чеснок
shine	блеск
explosion	взрыв
briefs	трусы
signatures	подписи
ozone	озон
disciplines	дисциплины
casa	Каса
conversations	разговоры
radios	радио
tariff	тариф
simplified	упрощенный
muscles	мышцы
swift	быстрый
vagina	влагалище
champagne	шампанское
deviation	отклонение
samba	самба
employ	использовать
penguin	пингвин
magical	волшебный
influences	влияет
inspections	инспекции
irrigation	орошение
miracle	чудо
hydraulic	гидравлический
penetration	проникновение
wound	рана
belle	красавица
rosa	Роза
conviction	убеждение
lazy	ленивый
qualities	качества
fathers	отцы
charging	зарядка
importantly	важно
petite	маленькая
apparatus	устройство
terrain	местность
explaining	объясняя
strips	полоски
nomination	назначение
empirical	эмпирический
worm	червь
dependence	зависимость
discrete	дискретный
beginner	начинающий
lid	крышка
sexuality	сексуальность
sapphire	сапфир
privileges	привилегии
specializing	специализация
marking	маркировка
sheriff	шериф
declined	отказался
spies	шпионы
motorcycles	мотоциклы
elect	избранные
highways	шоссе
concentrate	концентрат
intimate	интимный
molecules	молекулы
rounds	туры
refrigerator	холодильник
intervals	интервалы
sentences	предложения
holocaust	истребление
flyer	листовка
peas	горох
dosage	дозировка
variance	дисперсия
navigator	навигатор
needle	игла
baths	баня
brakes	тормоза
og	ог
ko	ко
owns	владеет
destiny	судьба
landscapes	пейзажи
computation	вычисление
hay	сено
salvation	спасение
predictions	прогнозы
learners	учащихся
token	знак
zinc	цинк
sacrifice	жертва
seekers	искатели
guru	гуру
suited	подходящий
numeric	числовой
anthropology	антропология
emperor	император
grad	град
belts	ремни
blacks	негры
educated	образованный
proudly	гордо
necessity	необходимость
curves	кривые
touring	туризм
vertex	вершина
tomato	помидор
travels	путешествия
pale	бледный
functioning	функционирование
economies	экономики
undertake	предпринимать
declare	объявлять
valves	клапаны
gaps	пробелы
achievements	достижения
tear	слеза
teaches	учит
nil	ноль
stranger	незнакомец
nest	гнездо
tribunal	суд
ruled	правил
pensions	пенсии
prayers	молитвы
cop	полицейский
adolescent	подросток
nominations	номинации
banana	банан
introductory	вводный
reservoir	резервуар
occurrence	вхождение
idol	идол
bloody	кровавый
remind	напоминать
charming	обаятельный
tooth	зуб
respected	уважаемый
stays	остается
affair	дело
restrict	ограничивать
mines	мины
portraits	портреты
interpreted	интерпретированы
evaluations	оценки
elimination	устранение
metres	метры
hypothetical	гипотетический
helicopter	вертолет
pencil	карандаш
performer	исполнитель
commissions	комиссии
sphere	сфера
moss	мох
ratios	коэффициенты
concord	созвучие
graduated	закончил
endorsed	одобрил
surprising	удивительный
lance	копье
ladder	лестница
cork	пробка
senators	сенаторы
bleeding	кровотечение
characterization	характеристика
likelihood	вероятность
lanes	полосы
fundamentals	основы
contamination	загрязнение
dome	купол
bless	благословить
negotiation	Переговоры
crest	гребень
opponents	соперники
triumph	триумф
nominated	номинирована
welding	сварка
orgasm	оргазм
alloy	сплав
plots	участки
gently	осторожно
locking	блокировка
controversial	спорный
draws	рисует
fridge	холодильник
blades	лезвия
loops	петли
surge	волна
trauma	травма
advert	объявление
defensive	оборонительный
forbidden	запрещено
vanilla	ваниль
programmers	программисты
monitored	контролируемый
installations	сооружения
souls	души
motivated	мотивировано
dumb	тупой
hollow	полый
vault	свод
groove	паз
revelation	откровение
pursuit	преследование
delegation	делегация
wires	провода
dictionaries	словари
transparency	прозрачность
orbit	орбита
currencies	валюты
niger	Нигер
positioning	позиционирование
colony	колония
cannon	пушка
circus	цирк
promoted	способствовало
trout	форель
feat	подвиг
temporarily	временно
cooked	приготовленный
transmit	передавать
frequencies	частоты
reflections	размышления
hunger	голод
municipality	муниципалитет
detective	детектив
cement	цемент
experiencing	испытывают
fireplace	камин
endorsement	поддержка
textiles	текстиль
missile	ракета
psychiatry	психиатрия
assists	помогает
auditor	аудитор
violin	скрипка
prophet	пророк
oxide	окись
magnificent	великолепный
promptly	быстро
adaptation	приспособление
harmful	вредный
sexually	сексуально
enclosure	ограда
glucose	глюкоза
norm	норма
playback	воспроизведение
turtle	черепаха
distances	расстояния
absorption	поглощение
treasures	сокровища
fossil	ископаемое
badly	плохо
communist	коммунист
entrepreneurs	предприниматели
robots	роботы
foul	фол
biodiversity	биоразнообразия
excitement	волнение
verbal	словесный
seas	моря
mysterious	загадочный
novelty	новинка
tiles	плитка
librarian	библиотекарь
switched	переключился
ru	RU
pose	поза
grams	граммов
therapist	Терапевт
budgets	бюджеты
goat	козел
render	оказывать
sail	паруса
commissioners	комиссары
dense	плотный
brave	Храбрый
forwarding	пересылка
awful	ужасный
airplane	самолет
organisms	микроорганизмы
telescope	телескоп
asbestos	асбест
advancement	продвижение
willow	ива
resumes	резюме
existed	существовавший
generators	генераторы
generates	генерирует
potatoes	картофель
thorough	тщательный
receptors	рецепторы
optimum	оптимальный
creature	существо
lone	одинокий
subtle	тонкий
stripes	полосы
firmware	прошивка
shepherd	пасти
cradle	колыбель
chancellor	канцлер
flour	мука
controversy	полемика
legendary	легендарный
choir	хор
avoiding	избегая
beautifully	красиво
expects	надеется
jumping	прыжки
fabrics	ткань
polymer	полимер
hygiene	гигиена
virtue	добродетель
surgeons	хирурги
mandate	мандат
corpus	тело
terminology	терминология
gentleman	джентльмен
convicted	осужденный
jets	струи
indices	индексы
qui	Квай
threatening	угрожающий
activists	активисты
prisoner	заключенный
encourages	призывает
assembled	собранный
terminals	терминалы
crude	сырой
examines	осматривает
viking	викинг
cleanup	уборка
conditional	условный
attacked	атакован
arrives	прибывает
translator	переводчик
automobiles	автомобили
tractor	трактор
continent	континент
fares	тарифы
longitude	долгота
hoped	надеялся
insertion	вставка
constraint	ограничение
strengthening	укрепление
wishing	желающих
insulation	изоляция
infringement	нарушение
bent	изогнутый
subjective	субъективный
monsters	монстры
asylum	убежище
stake	доля
cocktail	коктейль
varieties	сорта
poison	яд
dominated	доминировал
costly	дорогостоящий
derivatives	производные
prevents	предотвращает
rifle	винтовка
racism	расизм
interpret	интерпретировать
accord	согласие
modest	скромный
gamers	геймеров
sorting	сортировка
liaison	связь
bulbs	луковицы
tourists	туристы
behaviors	поведения
clarify	прояснить
waist	Талия
attributed	приписаны
owl	сова
crystals	кристаллы
exceeds	превышает
complementary	дополнительный
battles	сражения
bitter	горький
memorandum	меморандум
dragons	драконы
din	шум
incredibly	невероятно
delegates	делегаты
psychiatric	психиатрический
teenagers	подростков
courtyard	двор
presidents	президенты
depart	отходить
expressly	специально
lily	Лили
oversight	надзор
resin	смола
allies	союзники
preserved	сохраняется
crossed	пересекла
ascending	Восходящий
nominal	номинальный
decay	распад
quartz	кварц
registers	регистры
eighth	восьмой
authorised	уполномоченный
improves	улучшает
advocates	адвокаты
phenomena	явления
tilt	наклон
granite	гранит
masses	массы
athlete	спортсмен
franc	франк
similarity	сходство
leak	утечка
adviser	консультант
booklet	буклет
expecting	ожидая
turnover	оборот
urine	моча
towel	полотенце
ginger	имбирь
chromosome	хромосома
als	ALS
flies	летит
competence	компетентность
crying	плач
amateurs	любители
crane	кран
investigating	расследование
rotten	гнилой
habit	привычка
honour	честь
protects	защищает
iris	Ирис
manages	управляет
erosion	эрозия
carpenter	столяр
khan	хан
insufficient	недостаточное
formulation	формулировка
clever	умная
lords	лорды
enjoyable	приятный
crescent	полумесяц
sixty	шестьдесят
concentrated	концентрированный
distinguish	выделить
ei	й
projections	прогнозы
spark	искра
securing	обеспечение
pathway	путь
detectors	детекторы
spike	колос
ingredient	ингредиент
curtain	занавес
disclosed	раскрытый
tactical	тактический
pilots	пилоты
expedition	экспедиция
operative	оперативный
humour	юмор
mol	моль
imprint	отпечаток
assisting	содействие
defect	дефект
poorly	плохо
goddess	богиня
observers	наблюдателей
magnets	магниты
formulas	формулы
spacious	просторный
argues	утверждает
soils	почвы
organs	органы
det	йе
loyalty	лояльность
faithful	верный
offence	преступление
lithium	литий
leap	прыжок
founding	учредительный
swan	лебедь
planting	насаждение
covenant	завет
archaeology	археология
sailor	матрос
cares	заботы
sanctuary	святилище
statue	статуя
quotation	цитата
majors	майоров
manipulation	манипуляция
bells	колокольчики
toxicity	токсичность
transmitter	передатчик
neighborhoods	окрестности
trophy	трофей
emotion	эмоция
sights	Достопримечательности
uniforms	униформа
wounded	раненый
derivative	производное
occupancy	размещение
doses	дозы
educate	воспитывать
prejudice	предубеждение
technicians	техники
probable	вероятный
issuance	выдача
decoration	украшение
nationals	граждане
trojan	троянский
assistants	ассистенты
counselor	консультант
enacted	принятый
unstable	неустойчивый
urged	настоятельно
reflecting	отражающий
gaining	получение
definitive	окончательный
traveled	путешествовал
adapt	адаптироваться
accession	присоединение
regulator	регулятор
fuels	топливо
soy	соя
neat	аккуратный
naming	именование
stern	кормовой
crafted	проработаны
idiot	идиот
comprised	состоит
aliens	инопланетяне
edits	правки
raven	вороной
dwelling	жилье
symbolic	символический
angles	углы
pressures	давление
venus	Венера
flames	огонь
primitive	примитивный
stocking	чулок
ecosystem	экосистема
halls	залы
simplicity	простота
demon	демон
welcomed	приветствовал
notation	обозначение
aunt	тетка
crow	ворона
semantic	семантический
discontinued	прекращено
decides	решает
globalization	глобализация
asses	ослы
compass	компас
evolved	эволюционировали
infantry	пехота
renowned	прославленный
corridor	коридор
philosophical	философский
justification	обоснование
vacant	вакантный
fixing	фиксация
gram	грамм
hiding	прячется
dye	краситель
alphabet	алфавит
cleaned	очищенный
honored	заслуженный
optic	оптический
telephones	телефоны
diaries	дневников
grief	горе
sweat	пот
dolphin	дельфин
wonders	чудеса
ventilation	вентиляция
masks	маски
bust	бюст
alley	аллея
pathways	путей
telegraph	телеграф
monument	памятник
formally	формально
dew	роса
withdrawn	отозваны
debates	дебаты
identities	тождества
deficiency	дефицит
saddle	седло
malaria	малярия
loyal	верный
tendency	тенденция
utilized	используется
ein	Эйн
binoculars	бинокль
initiate	инициировать
purely	чисто
vivid	яркий
allegations	утверждения
corresponds	соответствует
daemon	демон
celebrated	знаменитый
hunters	охотники
acted	действовал
coefficient	коэффициент
skull	череп
continuation	продолжение
servant	служащий
falcon	сокол
jointly	совместно
avoided	избегать
explanations	объяснения
renewed	обновленный
critic	критик
sediment	отстой
squares	квадраты
vans	фургоны
cone	конус
survived	переживший
prevalence	распространенность
fragment	фрагмент
commits	совершает
cobra	кобра
threw	бросил
hoc	специальная
performers	исполнители
dessert	Десерт
dissertation	диссертация
ninth	девятый
enthusiasm	энтузиазм
celebrations	празднования
governors	губернаторы
atoms	атомы
tissues	тканей
ramp	скат
nicely	мило
della	делла
domination	доминирование
chords	аккорды
impairment	нарушение
molecule	молекула
