of	из
to	в
in	в
for	для
is	является
on	на
that	что
by	от
this	это
with	с
i	я
you	вы
it	Это
or	или
be	быть
are	находятся
at	в
all	все
have	иметь
new	новый
we	мы
will	будем
home	Главная
us	нас
about	около
if	если
page	страница
my	мой
has	имеет
search	поиск
free	свободно
but	но
our	наш
one	один
other	Другие
do	делать
information	Информация
time	время
he	он
which	который
their	их
news	Новости
use	использование
there	там
see	видеть
so	так
who	кто
web	Web
also	также
get	получить
pm	вечера
view	Посмотреть
c	с
e	е
first	первый
been	было
would	бы
were	мы
s	s
like	как
x	Икс
than	чем
find	найти
price	цена
back	назад
top	Вверх
people	люди
had	имел
list	список
name	имя
just	просто
year	год
day	день
into	в
two	два
health	здоровье
n	N
re	ре
used	используемый
go	идти
b	б
last	последний
make	делать
them	их
should	должен
product	продукт
system	система
post	после
her	ее
city	город
t	T
policy	политика
number	номер
support	поддержка
message	сообщение
after	после
then	тогда
jan	январь
good	хорошо
d	d
where	где
info	Информация
rights	права
books	книги
high	высокая
school	школа
m	м
each	каждый
links	связи
she	она
years	лет
order	заказ
very	очень
book	книга
items	Предметы
company	Компания
r	р
read	читать
group	группа
sex	секс
many	многие
user	пользователь
de	де
set	задавать
general	Генеральная
research	исследование
university	Университет
january	январь
mail	почта
full	полный
reviews	отзывы
program	программа
know	знать
games	игры
way	путь
days	дней
p	п
part	часть
could	мог
great	Великий
united	единый
real	реальный
f	е
international	Международный
center	центр
travel	путешествовать
comments	Комментарии
made	сделал
development	развитие
report	доклад
member	член
details	Детали
line	линия
terms	сроки
before	до
hotels	отели
did	сделал
send	Отправить
right	правильно
type	тип
local	местный
those	те
results	Результаты
office	офис
national	национальный
car	автомобиль
design	дизайн
take	принимать
posted	отправил
address	адрес
community	сообщество
within	в
states	состояния
want	хотеть
phone	Телефон
dvd	DVD
subject	предмет
between	между
forum	Форум
family	семья
l	L
long	длинный
w	вес
show	показать
o	о
even	даже
black	черный
special	особый
index	индекс
being	являющийся
women	женщины
much	много
sign	знак
file	файл
link	ссылка
open	открытый
south	юг
case	дело
project	проект
pages	страницы
version	версия
section	раздел
own	своя
house	дом
security	безопасность
g	г
county	округ
american	американский
photo	Фото
game	игра
members	члены
power	мощность
network	сеть
computer	компьютер
systems	системы
three	три
place	место
end	конец
h	час
him	его
per	в
access	доступ
think	думать
north	север
resources	Ресурсы
current	текущий
big	большой
media	СМИ
law	закон
control	контроль
water	воды
history	история
size	размер
personal	личный
guide	руководство
shop	магазин
directory	каталог
change	изменение
white	белый
text	текст
small	маленький
rating	рейтинг
rate	ставка
government	правительство
children	дети
return	вернуть
students	студенты
v	v
account	Счет
times	раз
level	уровень
digital	цифровой
profile	профиль
previous	предыдущий
form	форма
events	Мероприятия
love	люблю
old	старый
john	Джон
main	главный
call	вызов
image	образ
department	отдел
title	заглавие
non	не
k	К
y	Y
insurance	страхование
shall	должен
property	имущество
class	класс
cd	CD
quality	качественный
every	каждый
listing	список
content	содержание
country	страна
little	немного
tools	инструменты
low	низкий
reply	Ответить
customer	клиент
december	Декабрь
compare	сравнить
movies	кино
college	колледж
value	стоимость
article	статья
man	человек
jobs	работы
j	J
food	питание
author	автор
different	другой
u	U
learn	учить
sale	продажа
print	Распечатать
course	курс
job	работа
room	комната
stock	акции
training	обучение
too	слишком
credit	кредит
point	точка
science	наука
men	люди
categories	категории
west	запад
look	смотреть
english	английский
team	команда
estate	имущество
box	коробка
conditions	условия
photos	фото
gay	гей
thread	нить
category	категория
note	заметка
live	жить
large	большой
gallery	галерея
table	Таблица
however	Однако
june	июнь
october	октябрь
november	ноябрь
market	рынок
library	библиотека
action	действие
start	Начало
series	серии
features	функции
air	воздух
industry	промышленность
plan	план
human	человек
yes	да
second	второй
hot	горячий
cost	Стоимость
movie	кино
forums	форумы
march	Март
la	ля
september	сентябрь
say	сказать
going	собирается
medical	медицинская
friend	друг
dec	декабрь
server	сервер
application	заявление
staff	сотрудники
play	играть
issues	вопросы
april	апрель
users	пользователи
street	улица
topic	тема
against	против
got	получил
blog	блог
party	вечеринка
payment	оплата
equipment	оборудование
let	позволять
programs	программы
legal	правовой
recent	недавний
park	парк
act	акт
problem	проблема
red	красный
give	дайте
memory	Память
performance	представление
social	Социальное
q	Q
story	история
sell	продавать
options	опции
experience	опыт
key	ключ
body	тело
young	молодой
important	важный
field	поле
few	мало
east	восток
single	Один
ii	б
age	возраст
club	клуб
example	пример
girls	девочки
z	Z
road	Дорога
gift	подарок
question	вопрос
ca	Калифорния
hard	жесткий
pay	платить
four	четыре
poker	покер
issue	вопрос
range	ассортимент
building	здание
seller	продавец
court	суд
february	февраль
result	результат
light	легкий
write	записывать
war	война
offer	предлагает
blue	синий
groups	группы
al	аль
easy	легко
given	данный
request	запрос
fax	факс
china	Китай
making	изготовление
picture	картина
needs	потребности
possible	возможное
month	месяц
major	главный
star	звезда
future	будущее
space	пространство
committee	комитет
hand	рука
sun	солнце
cards	карты
london	Лондон
meeting	встреча
become	стали
child	ребенок
keep	держать
porn	порно
share	доля
similar	аналогичный
garden	сад
schools	школы
million	миллиона
added	добавленной
reference	Справка
companies	компании
baby	детка
learning	обучение
energy	энергия
run	бег
delivery	Доставка
popular	популярный
term	срок
film	фильм
stories	истории
put	положил
journal	журнал
reports	отчеты
co	Колорадо
try	пытаться
images	изображений
notice	уведомление
god	Бог
original	оригинал
head	глава
radio	радио
cell	клетка
council	совет
includes	включает
track	трек
discussion	обсуждение
archive	архив
others	другие
agreement	соглашение
format	формат
society	общество
months	месяцы
safety	безопасность
friends	друзья
sure	конечно
edition	издание
messages	Сообщения
marketing	маркетинг
tell	рассказать
association	ассоциация
provides	обеспечивает
fun	весело
already	уже
green	зеленый
studies	исследования
close	Закрыть
common	общий
specific	конкретный
