od	из
do	в
u	в
za	для
je	является
na	на
da	что
po	от
ovaj	это
s	с
ja	я
vas	вы
to	Это
ili	или
biti	быть
su	находятся
na	в
svi	все
imati	иметь
novi	новый
mi	мы
htjeti	будем
Dom	Главная
nas	нас
oko	около
ako	если
stranica	страница
moj	мой
ima	имеет
traži	поиск
besplatno	свободно
ali	но
naše	наш
jedan	один
drugo	Другие
čini	делать
informacija	Информация
vrijeme	время
on	он
koji	который
njihov	их
vijesti	Новости
koristiti	использование
tamo	там
vidjeti	видеть
tako	так
tko	кто
mreža	Web
također	также
dobiti	получить
pm	вечера
pogled	Посмотреть
c	с
e	е
prvi	первый
bila	было
bi	бы
su	мы
a	s
Kao	как
x	Икс
od	чем
pronaći	найти
cijena	цена
leđa	назад
vrh	Вверх
narod	люди
imala	имел
popis	список
Ime	имя
samo	просто
godina	год
dan	день
u	в
dva	два
zdravlje	здоровье
n	N
ponovno	ре
koristi	используемый
ići	идти
b	б
posljednji	последний
napraviti	делать
ih	их
treba	должен
proizvod	продукт
sistem	система
pošta	после
nju	ее
Grad	город
t	T
politika	политика
broj	номер
podrška	поддержка
poruka	сообщение
nakon	после
zatim	тогда
siječanj	январь
dobro	хорошо
d	d
gdje	где
Informacije	Информация
prava	права
knjige	книги
visok	высокая
škola	школа
m	м
svaki	каждый
linkovi	связи
ona	она
godine	лет
narudžba	заказ
vrlo	очень
knjiga	книга
stavke	Предметы
društvo	Компания
r	р
čitati	читать
skupina	группа
seks	секс
mnogi	многие
korisnik	пользователь
de	де
set	задавать
general	Генеральная
istraživanje	исследование
sveučilište	Университет
siječanj	январь
pošta	почта
puni	полный
recenzije	отзывы
program	программа
znati	знать
igre	игры
put	путь
dana	дней
p	п
dio	часть
mogao	мог
Sjajno	Великий
ujedinjen	единый
stvaran	реальный
f	е
međunarodna	Международный
centar	центр
putovati	путешествовать
komentari	Комментарии
napravljen	сделал
razvoj	развитие
izvješće	доклад
član	член
detalji	Детали
crta	линия
Pojmovi	сроки
prije	до
hoteli	отели
učinio	сделал
poslati	Отправить
pravo	правильно
tip	тип
lokalne	местный
oni	те
rezultati	Результаты
ured	офис
nacionalna	национальный
automobil	автомобиль
dizajn	дизайн
uzeti	принимать
objavljeno	отправил
adresa	адрес
zajednica	сообщество
unutar	в
Države	состояния
željeti	хотеть
telefon	Телефон
DVD	DVD
predmet	предмет
između	между
forum	Форум
obitelj	семья
l	L
dugo	длинный
w	вес
pokazati	показать
o	о
čak	даже
crno	черный
poseban	особый
indeks	индекс
biće	являющийся
žene	женщины
mnogo	много
znak	знак
datoteka	файл
veza	ссылка
otvoren	открытый
jug	юг
slučaj	дело
projekt	проект
stranica	страницы
verzija	версия
odjeljak	раздел
vlastiti	своя
kuća	дом
sigurnosti	безопасность
g	г
okrug	округ
američki	американский
foto	Фото
igra	игра
članovi	члены
vlast	мощность
mreža	сеть
Računalo	компьютер
sustavi	системы
tri	три
mjesto	место
kraj	конец
h	час
mu	его
po	в
pristup	доступ
razmišljati	думать
sjeverno	север
resursi	Ресурсы
Trenutno	текущий
velik	большой
media	СМИ
zakon	закон
kontrolirati	контроль
voda	воды
povijest	история
veličina	размер
osobni	личный
vodič	руководство
dućan	магазин
imenik	каталог
promijeniti	изменение
bijela	белый
tekst	текст
mali	маленький
klijenata	рейтинг
stopa	ставка
vlada	правительство
djeca	дети
povratak	вернуть
studenti	студенты
v	v
račun	Счет
puta	раз
nivo	уровень
digitalni	цифровой
profil	профиль
prijašnji	предыдущий
oblik	форма
događaji	Мероприятия
ljubav	люблю
star	старый
Ivan	Джон
glavni	главный
poziv	вызов
slika	образ
odjel	отдел
titula	заглавие
ne	не
k	К
y	Y
osiguranje	страхование
treba	должен
svojstvo	имущество
klasa	класс
CD	CD
kvaliteta	качественный
svaki	каждый
spisak	список
sadržaj	содержание
zemlja	страна
malo	немного
alat	инструменты
nizak	низкий
odgovor	Ответить
kupac	клиент
prosinac	Декабрь
usporediti	сравнить
filmovi	кино
koledž	колледж
vrijednost	стоимость
članak	статья
čovjek	человек
poslovi	работы
j	J
hrana	питание
Autor	автор
drugačiji	другой
u	U
naučiti	учить
prodaja	продажа
otisak	Распечатать
tečaj	курс
posao	работа
soba	комната
zaliha	акции
trening	обучение
isto	слишком
Kreditna	кредит
točka	точка
znanost	наука
muškarci	люди
kategorije	категории
Zapad	запад
izgled	смотреть
Engleski	английский
tim	команда
imanje	имущество
kutija	коробка
Uvjeti	условия
fotografije	фото
homoseksualac	гей
nit	нить
kategorija	категория
Bilješka	заметка
uživo	жить
veliki	большой
galerija	галерея
stol	Таблица
međutim	Однако
lipanj	июнь
listopad	октябрь
studeni	ноябрь
tržište	рынок
knjižnica	библиотека
akcijski	действие
početak	Начало
niz	серии
značajke	функции
zrak	воздух
industrija	промышленность
plan	план
ljudski	человек
Da	да
drugi	второй
vruće	горячий
cijena	Стоимость
film	кино
forumi	форумы
ožujak	Март
la	ля
rujan	сентябрь
reći	сказать
odlazak	собирается
medicinski	медицинская
prijatelj	друг
prosinca	декабрь
server	сервер
primjena	заявление
osoblje	сотрудники
igra	играть
pitanja	вопросы
travanj	апрель
Korisnici	пользователи
ulica	улица
tema	тема
protiv	против
dobio	получил
blog	блог
Zabava	вечеринка
plaćanje	оплата
oprema	оборудование
pustiti	позволять
programi	программы
pravni	правовой
nedavni	недавний
park	парк
čin	акт
problem	проблема
Crvena	красный
dati	дайте
memorija	Память
izvođenje	представление
socijalni	Социальное
q	Q
priča	история
prodavati	продавать
opcije	опции
iskustvo	опыт
ključ	ключ
tijelo	тело
mladi	молодой
važno	важный
polje	поле
nekoliko	мало
istočno	восток
singl	Один
ii	б
dob	возраст
klub	клуб
primjer	пример
djevojke	девочки
z	Z
cesta	Дорога
dar	подарок
pitanje	вопрос
ca	Калифорния
teško	жесткий
platiti	платить
četiri	четыре
poker	покер
problem	вопрос
opseg	ассортимент
zgrada	здание
prodavač	продавец
sud	суд
veljača	февраль
proizlaziti	результат
svjetlo	легкий
pisati	записывать
rat	война
ponuda	предлагает
plava	синий
grupe	группы
al	аль
lako	легко
dan	данный
zahtjev	запрос
faks	факс
Kina	Китай
izrađivanje	изготовление
slika	картина
potrebe	потребности
moguće	возможное
mjesec	месяц
glavni	главный
zvijezda	звезда
budućnost	будущее
prostor	пространство
odbor	комитет
ruka	рука
Sunce	солнце
kartice	карты
London	Лондон
sastanak	встреча
postati	стали
dijete	ребенок
zadržati	держать
pornografija	порно
udio	доля
sličan	аналогичный
vrt	сад
škola	школы
milijuna	миллиона
dodano	добавленной
upućivanje	Справка
tvrtke	компании
dijete	детка
učenje	обучение
energija	энергия
trčanje	бег
dostava	Доставка
popularan	популярный
termin	срок
film	фильм
priče	истории
staviti	положил
časopis	журнал
izvještaji	отчеты
ko	Колорадо
probati	пытаться
slika	изображений
obavijest	уведомление
bog	Бог
izvornik	оригинал
glava	глава
radio	радио
ćelija	клетка
vijeće	совет
uključuje	включает
staza	трек
rasprava	обсуждение
arhiva	архив
drugi	другие
sporazum	соглашение
format	формат
društvo	общество
mjeseci	месяцы
sigurnosni	безопасность
prijatelji	друзья
Naravno	конечно
izdanje	издание
poruke	Сообщения
Marketing	маркетинг
reći	рассказать
asocijacija	ассоциация
pruža	обеспечивает
zabava	весело
već	уже
zelena	зеленый
studije	исследования
Zatvoriti	Закрыть
uobičajen	общий
specifično	конкретный
nekoliko	несколько
život	живой
kolekcija	коллекция
zvao	называется
kratak	короткая
umjetnost	искусства
mnogo	много
pitati	просить
ograničen	ограниченное
rješenja	решения
direktor	директор
plaža	пляж
prošlost	мимо
prirodni	натуральный
elektronika	электроника
na	на
razdoblje	период
planiranje	планирование
kaže	говорит
službeno	официальный
pokvariti	март
učinio	сделанный
tehnička	технический
prozor	окно
profesionalac	профессионал
regija	область
otoka	остров
snimiti	запись
direktno	непосредственный
konferencija	конференция
ploče	учет
st	улица
okrug	район
kalendar	календарь
troškovi	расходы
stil	стиль
izjava	заявление
milja	миль
resurs	ресурс
aplikacije	Приложения
dokument	документ
riječ	слово
djela	работает
materijal	материал
račun	законопроект
napisan	написано
pravila	правила
konačni	окончательный
stvar	вещь
centar	центр
zahtjevi	требования
PRAVI	ПРАВДА
minuta	минут
drugo	еще
ocjena	отметка
stijena	камень
loše	Плохо
pojedinac	индивидуальный
plus	плюс
auto	авто
pokriti	обложка
Uredi	редактировать
zajedno	вместе
video	видео
brzo	быстро
funkcija	функция
činjenica	факт
uzimajući	получение
globalno	Глобальный
tech	тек
sastati	встретить
daleko	далеко
ekonomski	экономической
hr	ан
igrač	игрок
projekti	проектов
iznos	количество
Gledati	смотреть
uključen	включены
osjetiti	Чувствовать
banka	банка
rizik	риск
Popularna	предложения
raznovrstan	различный
riječi	слова
proizvodnja	производство
trgovački	коммерческая
težina	вес
srce	сердце
liječenje	лечение
bodova	точки
znanje	знание
časopis	журнал
greška	ошибка
fotoaparat	камера
djevojka	девушка
izgradnja	строительство
igračke	игрушки
zabilježen	зарегистрированный
domena	домен
metode	методы
poglavlje	глава
zaštita	защита
politika	полисы
širok	широкий
ljepota	красота
menadžer	менеджер
Indija	Индия
položaj	должность
poduzete	взятый
vrsta	Сортировать
oglasi	объявления
znan	известен
pola	половина
slučajevi	случаи
korak	шаг
inženjering	инжиниринг
jednostavan	просто
brz	быстро
licenca	лицензия
jezero	озеро
čitav	все
godišnji	годовой
Objavljeno	опубликованный
crkva	церковь
način	метод
aktivan	активный
odgovor	ответ
lik	фигура
materijali	материалы
dovoljno	достаточно
konstruiran	предназначенный
među	среди
smrt	смерть
gubitak	потеря
lice	лицо
marka	марка
popust	скидка
efekti	последствия
stvorio	созданный
standardi	стандарты
bit	немного
politički	политическая
kraljevstvo	Королевство
baza	база
rade	дела
krediti	кредитование
cipele	обувь
ulaz	запись
boravak	оставаться
narudžbe	заказы
dostupnost	доступность
Sažetak	резюме
skretanje	очередь
rast	рост
agencija	агентство
kralj	король
europska	Европейская
aktivnost	Мероприятия
kopirati	копия
zapadni	вестерн
sila	сила
zapošljavanje	занятость
zaljev	залив
Rijeka	река
komisija	комиссия
paket	пакет
vidio	видели
igrači	игроки
motor	двигатель
luka	порт
album	альбом
Regionalni	региональный
Stop	стоп
počeo	начал
uprava	администрация
bar	бар
institut	институт
pregleda	Просмотры
dvostruko	двойной
pas	собака
uskoro	скоро
linije	линии
elektronička	электронный
prednosti	выгоды
potreban	необходимый
printer	принтер
stanje	состояние
djelotvoran	эффективный
vjerovati	верить
organizacija	организация
posljedica	эффект
um	разум
izbor	выбор
kasino	казино
pdf	PDF
obilazak	тур
križ	пересекать
nada	надежда
korporacija	корпорация
želja	желание
riješenje	решение
zreo	зрелый
uloga	роль
tjedni	недель
siguran	определенный
niži	ниже
potreban	необходимо
unija	союз
mon	понедельник
com	ком
posebno	конкретный
fino	отлично
sat	час
plin	газ
vještine	навыки
šest	шесть
grm	куст
otoci	острова
savjet	совет
karijera	карьера
odluka	решение
napustiti	оставлять
prije	до
ogroman	огромный
žena	женщина
postrojenja	оборудование
ponuda	предложение
srednji	средний
kabel	кабель
prilike	возможности
uzimanje	принятие
vrijednosti	значения
podjela	деление
dolazak	приход
objekt	объект
lezbijka	лесбиянка
prikladan	подходящее
mašina	машина
logo	логотип
dužina	длина
Lijepo	хороший
postići	Гол
statistika	статистика
klijent	клиент
uzorak	образец
ulaganje	инвестиции
poslao	послал
prikazan	показанный
Božić	рождество
Kultura	культура
bljesak	вспышка
ms	Миз
izbor	выбор
tečajevi	курсы
potrošač	потребитель
bok	Здравствуй
strana	иностранные
umjetnik	художник
namještaj	мебель
kanal	канал
pismo	письмо
način	Режим
telefoni	телефоны
ideje	идеи
struktura	состав
stupanj	степень
ugovor	контракт
super	супер
muški	мужской
stvar	дело
skoro	почти
nalazi	располагается
višekratnik	множественный
distribucija	распределение
urednik	редактор
gostionica	гостиница
industrijski	промышленные
potencijal	потенциал
pjesma	песня
los	лос
pad	падать
ideja	идея
sobe	номера
komunikacije	связь
pobijediti	выиграть
osnovni	первичный
Rak	рак
brojevi	чисел
razlog	причина
alat	инструмент
Proljeće	весна
temelj	Фонд
odgovor	ответ
glas	голос
raspored	график
dokumenti	документы
Svrha	цель
svojstvo	особенность
krevet	постель
dolazi	выходит
policija	полиция
samostalan	независимый
pristup	подход
smeđ	коричневый
fizička	физическое
brdo	холм
Karte	карты
držati	держать
ocjene	рейтинги
sretan	счастливый
kovač	кузнец
razvijen	развитая
zahvaliti	спасибо
sef	безопасно
jedinstvena	уникальный
pregled	опрос
prije	предшествующий
telefon	телефон
sport	спорт
spreman	готов
životinja	животное
izvori	источники
populacija	Население
godišnje	папа
redovan	регулярный
siguran	безопасный
operacije	операции
jednostavno	просто
dokaz	доказательства
stanica	станция
razumjeti	Понимаю
opcija	вариант
dolina	долина
vjerojatno	вероятно
more	море
publikacije	публикации
poboljšati	улучшать
veza	соединение
izdavač	издатель
dvorana	зал
anti	анти
mreže	сети
Zemlja	Земля
roditelji	родители
udarac	влияние
prijenos	перевод
Uvod	введение
kuhinja	кухня
jak	сильный
vjenčanje	свадьба
nekretnine	свойства
bolnica	больница
tlo	земля
brod	корабль
smještaj	жилье
bolest	болезнь
izvrstan	отлично
savršen	идеально
dlaka	волосы
prilika	возможность
oprema	Комплект
klasik	классический
osnova	основа
naredba	команда
gradovi	города
izraziti	экспресс
dodijeliti	награда
udaljenost	расстояние
drvo	дерево
procjena	оценка
zid	стена
umiješan	участвует
el	эль
ekstra	дополнительный
posebno	особенно
budžet	бюджет
vodiči	направляющие
uspjeh	успех
maksimum	максимальная
majka	мама
operacija	операция
postojanje	существующий
dosta	довольно
odabran	выбранный
dječak	мальчик
restorani	ресторан
lijep	красивая
upozorenje	предупреждение
lokacije	места
konj	лошадь
glasanje	голос
cvijeće	цветы
zvijezde	звезды
arena	списки
vlasnik	владелец
životinje	животные
načine	пути
sin	сын
pružanje	обеспечение
Pravilo	правило
kućište	Корпус
traje	принимает
donijeti	приносить
katalog	каталог
maksimum	Максимум
majka	мама
vlast	власть
rekao	сказал
program	программа
spojen	присоединился
ulazni	вход
strategija	стратегия
noge	ноги
agent	агент
vrijedi	действительный
moderan	современное
stariji	старшая
seksi	сексуальный
nastava	обучение
vrata	дверь
veličanstven	большой
suđenje	испытание
jedinice	единицы
svjež	круто
normalan	нормальный
poduzeće	предприятие
brodovi	судов
čitav	все
pozitivan	положительный
sposobnost	фитнес
kineski	Китайский
mišljenje	мнение
nogomet	футбол
sažetak	Абстрактные
izlaz	вывод
fondovi	фонды
mr	Мистер
Vjerojatno	вероятно
razviti	развивать
izvođači	художники
alternativa	альтернатива
odgovornost	обязанность
Java	Ява
gost	гость
objavljivanje	публикация
proći	проходить
odnosi	связи
povjerenje	доверять
kombi	фургон
sadrži	содержит
multi	много
republika	республика
naknada	сборы
komponente	компоненты
odmor	отпуск
stoljeće	века
akademski	академический
pomoć	помощь
dovršen	завершено
koža	кожа
grafika	графика
Indijanac	индийский
prsten	кольцо
razred	класс
planina	гора
organizacija	организации
filtar	фильтр
ploča	панель
kat	пол
kupovina	покупка
utakmica	совпадение
zaprosio	предложенный
zahtijevati	требовать
dječaci	мальчиков
jutro	утро
omogućuje	позволяет
protein	белок
biljka	растение
izvijestio	сообщается
pogoditi	удар
mm	мм
bazen	бассейн
mini	мини
politika	политика
partner	партнер
autori	авторы
ploče	доски
riba	рыба
članstvo	членство
misija	миссия
oko	глаз
niz	строка
osjećaj	смысл
promijenjen	модифицированный
oslobođen	выпущенный
faza	сцена
interni	внутренний
rođen	Родился
detaljan	подробный
japanski	Японский
utrka	раса
odobren	утвержденный
cilj	цель
osim	Кроме
lik	персонаж
održavanje	поддержание
sposobnost	способность
ed	издание
silovanje	изнасилование
baterija	аккумулятор
mladež	молодежь
pritisak	давление
podnijeti	Отправлено
dug	долг
srednji	средний
televizija	телевидение
zainteresiran	заинтересованный
srž	ядро
pauza	ломать
svrhe	цели
setovi	наборы
ples	танец
drvo	дерево
definiran	определенный
novine	документы
nagrade	награды
pristojba	плата
studio	студия
čitač	читатель
uređaj	устройство
osnovan	установленный
odgovori	ответы
najam	аренда
las	лас
mrak	темно
vanjski	внешний
jabuka	яблоко
le	ле
instrukcije	инструкции
min	мин
ponudio	предложенный
teorija	теория
ukloniti	Удалить
pomoć	помощь
vidni	визуальный
domaćin	хозяин
raznolikost	разнообразие
učitelji	учителей
priručnik	руководство
blok	блок
teme	предметы
agenti	агенты
popravak	ремонт
pravedan	Справедливая
željezo	стали
razumijevanje	понимание
Pjesme	песни
fiksni	исправлено
pogrešno	неправильно
početak	начало
ruke	Руки
AZ	Аризона
Pariz	Париж
dobiva	получает
sektor	сектор
kapacitet	вместимость
uN	ООН
mast	жир
otac	отец
električni	электрический
pila	увидел
instrumenti	инструменты
časnik	сотрудник
vozač	Водитель
poduzeća	бизнес
mrtav	мертвый
nepoznat	неизвестный
restoran	ресторан
mikrofon	Майк
putovanje	поездка
mi	ми
siromašan	бедные
odnos	отношения
radnici	рабочие
mir	мир
tradicionalan	традиционный
pokazivanje	показ
kreativan	творческий
obala	берег
korist	выгода
financiranje	финансирование
uređaji	приборы
gospodar	господин
odobriti	даровать
pod	суб
fikcija	фантастика
satovi	часы
karijere	карьера
ide	идет
vodio	светодиод
muzej	музей
ventilator	поклонник
prijevoz	транспорт
zanimljiv	интересно
blogovi	блоги
procjena	оценка
prijašnji	бывший
zona	зона
kompleks	сложный
th	го
mačka	Кот
umrijeti	умереть
predstavili	представленный
ravan	квартира
teći	течь
agencije	агентства
književnost	литература
roditelj	родитель
postavljanje	установка
doktor	доктор
ljestvica	масштаб
Ekonomija	экономика
koristan	полезный
mjesečno	ежемесячно
kritično	критический
okvir	Рамка
mjuzikl	музыкальный
definicija	определение
tajnica	секретарь
staza	дорожка
glavni	главный
daje	дает
paketi	пакеты
detalj	подробно
zakoni	законы
promijenjen	изменено
početi	начать
kraljevski	королевский
čist	чистый
momak	парень
naslovi	названия
relevantan	Соответствующий
pravda	справедливость
Spojiti	соединять
kupa	кружка
košara	корзина
primijenjen	прикладная
tjedni	еженедельно
vol	об
montaža	монтаж
str	стр
pažnja	внимание
napredovati	продвижение
preskočiti	пропускать
dijeta	диета
vojska	армия
zupčanik	шестерня
razlika	разница
dopušteno	позволил
ispravan	верный
narod	нация
prodaja	продажа
mnogo	много
komad	кусок
list	лист
firma	фирма
sedam	Семь
elementi	элементы
vrsta	вид
skok	Прыгать
Stanice	ячейки
modul	модуль
pribjeći	курорт
potvrda	сертификат
ministar	министр
pokret	движение
moda	мода
smjerovi	направления
posjetitelji	посетители
dokumentacija	документация
trgovački	торговый
šuma	лес
pozivi	звонки
pokrivenost	покрытие
par	пара
davanje	дающий
prilika	шанс
vizija	видение
lopta	мяч
završni	окончание
klijenti	клиенты
akcije	действия
raspravljati	обсуждать
cilj	Цель
uspješan	успешный
prodan	продан
vjetar	ветер
zajednice	сообщества
klinički	клиническая
situacija	ситуация
tržišta	рынки
objavljivanje	издательский
pojaviti	появиться
razvoju	развивающийся
život	жизни
odrediti	определить
temperatura	температура
najave	объявления
pacijent	пациент
stvaran	фактический
povijesni	исторический
kamen	камень
bob	боб
trgovina	коммерция
osobe	лиц
težak	сложно
znanstvena	научный
satelit	спутник
testovi	тесты
selo	деревня
računi	Счета
amater	любитель
ex	бывший
sastali	встретил
bol	боль
čimbenici	факторы
kava	кофе
kupac	покупатель
poster	плакат
rub	край
funkcionalna	функциональная
korijen	корень
fi	фи
zatvoreno	закрыто
Praznici	каникулы
ružičasta	розовый
ravnoteža	баланс
nadgledanje	мониторинг
odgovora	ответы
šut	выстрел
početni	начальная
označiti	метка
sek	сек
kanon	канон
liga	лига
gubljenje	отходы
minuta	минут
autobus	автобус
usluga	поставщик
rječnik	Словарь
računovodstvo	учет
proizvodnja	производство
dijelovi	разделы
stolica	стул
napor	усилие
faza	фаза
fantazija	фантазия
PO	ро
va	в
profesor	профессор
instalirati	устанавливать
košulja	Рубашка
odjeća	одежда
noga	фут
grudi	грудь
Tehnike	методы
dolara	долларов
religija	религия
dopuštenje	разрешение
divlji	дикий
generacija	поколение
propustiti	Мисс
kemijski	химическая
liječnik	врач
zadatak	задача
smanjiti	уменьшить
donio	привел
vježba	упражнение
buba	ошибка
jamčiti	гарантия
vođa	лидер
sebi	се
procesi	процессы
mekan	мягкий
sastanci	встречи
sekundi	секунд
let	рейс
kongres	конгресс
gorivo	топливо
hodati	ходить
izrađen	произведенный
svetac	святой
argument	аргумент
konkurencija	соревнование
lijekovi	наркотики
zajednički	совместный
premija	премия
svježe	свежий
likovi	персонажи
pravnik	адвокат
di	ди
faktor	фактор
tisuća	тысячи
km	км
potok	поток
apartmani	апартаменты
odabrati	выбирать
sluh	слух
istočni	восточный
terapija	терапия
unosi	записи
potpisan	подписанный
upravni	административный
ozbiljan	серьезный
ograničiti	предел
koraci	меры
trgovine	магазины
ropstvo	зависимость
del	дель
napori	усилия
informiran	проинформировал
gA	Джорджия
misli	мысли
potok	ручей
ft	фут
količina	количество
osnovni	существенный
ture	туры
opterećenje	нагрузка
odmah	немедленно
strojevi	машины
određen	назначенный
teško	тяжелый
pokriven	покрытый
oporavak	восстановление
integriran	интегрированный
konfiguracija	конфигурация
penis	петух
trgovac	торговец
opsežan	комплексный
stručnjak	эксперт
zaštititi	защищать
solidan	твердый
prezentacija	презентация
postao	стал
narančasta	оранжевый
usklađenost	соблюдение
tema	тема
bogat	богатые
kampanja	кампания
vs	против
gitara	гитара
nalaz	обнаружение
primjeri	Примеры
duh	дух
ar	Арканзас
zahtjevi	требования
prihvaćanje	принятие
strategije	стратегии
mj	мо
poslovi	дела
namijenjen	предназначена
sa	са
ciljevi	цели
najam	Наем
izbor	выборы
predložiti	предлагать
podružnica	филиал
poslužiti	обслуживать
podružnice	филиалы
montiranje	крепление
latinski	латинский
multimedijalni	мультимедиа
upravljati	управлять
ugao	угол
rang	ранг
element	элемент
rođenja	рождение
virus	вирус
interaktivni	интерактивный
zahtjevi	Запросы
odvojen	отдельный
četvrtina	четверть
postupak	процедура
rukovodstvo	руководство
definirati	определять
vjerski	религиозная
činjenicama	факты
doručak	завтрак
kolona	колонка
vjera	вера
lanac	цепь
identificirati	идентифицировать
avenija	проспект
nedostaje	отсутствует
preporuke	рекомендации
pomaknuto	переехал
dohvatiti	достичь
usporedba	сравнение
trenutak	момент
produžen	расширенный
slijed	последовательность
palac	дюймовый
napad	атака
centri	центры
otvor	открытие
laboratorija	лаборатория
rezerva	резерв
gama	гамма
proizvoditi	производить
istina	правда
brojač	счетчик
neuspjeh	отказ
slijedi	следует
dolar	доллар
kamp	лагерь
des	дез
filmovi	фильмы
most	мост
ispuniti	заполнить
pokret	движение
tiskanje	печать
Nacrt	проект
grafikon	диаграмма
igrao	играл
kontakti	контакты
čitači	читатели
klubovi	клубы
wa	Вашингтон
avantura	приключение
ponuda	предложение
dobit	прибыль
čelnici	лидеры
plakati	плакаты
institucije	учреждения
asistent	помощник
varijabla	переменная
dj	диджей
parkiralište	стоянка
jučer	вчера
odlučan	определенный
radionica	мастерская
otišao	прошло
kodovi	коды
vrste	виды
nastavak	расширение
izjava	заявления
potpuno	полностью
timovi	команды
tvrđava	форт
cm	см
senat	сенат
smiješno	веселая
gen	ген
okrenut	оказалось
disk	диск
uzorak	шаблон
čamac	лодка
kazalište	театр
proizvođači	производители
sponzor	спонсор
klasična	классический
ikona	значок
garancija	гарантия
posvećen	преданный
smjer	направление
košarka	баскетбол
objekti	объекты
izbrisati	Удалить
večer	вечер
skupština	сборка
nuklearni	ядерной
miš	мышь
signal	сигнал
kriminalac	преступник
izdaje	выпущен
snažan	мощный
san	мечта
NETOČNO	ЛОЖНЫЙ
da	да
baciti	бросать
cvijet	цветок
osoblje	персонал
prošao	прошло
isporučuje	поставляется
Slapovi	падения
duša	душа
unaprijediti	содействовать
navedeno	заявил
statistika	статистика
profesionalci	профессионалов
Čini	появляется
nositi	нести
zastava	флаг
korice	крышки
em	Эм
prednost	преимущество
zdravo	Здравствуйте
dizajna	конструкции
održavati	поддерживать
turizam	туризм
prioritet	приоритет
odrasli	Взрослые
grafički	графический
atom	атом
plaćanja	платежи
vezivanje	переплет
kratak	краткое
završeno	закончился
osvajanjem	выигрыш
anoniman	анонимный
skripta	скрипт
služio	служил
želi	хочет
pripremljen	подготовленный
poništiti	недействительным
označiti	тег
intervju	интервью
miješati	смешивание
okvir	фреймворк
disk	диск
instaliran	установлен
kraljica	Королева
krediti	кредиты
jasno	явно
popraviti	фиксировать
rukovati	ручка
slatko	милая
kriteriji	критерии
suradnik	ассоциировать
NE	Небраска
ponašanje	поведение
uvećati	увеличить
zraka	луч
prihod	доход
mjera	измерение
glasova	голосов
du	дю
dužnost	обязанность
rasprave	обсуждение
snositi	медведь
dobit	усиление
festival	фестиваль
laboratorija	лаборатория
ocean	океан
letovi	рейсы
stručnjaci	эксперты
znakovi	знаки
dubina	глубина
vlak	поезд
suho	сухой
istražiti	исследовать
banja	спа
koncept	концепция
skoro	около
rukovanje	обращение
podrijetlo	происхождения
milijardi	миллиард
inteligencija	интеллект
kupio	купил
protiv	против
nacije	нации
put	маршрут
slomljen	сломанный
bitka	боевой
govoriti	говорить
protokol	протокол
pitanje	запрос
partnerstvo	партнерство
izraz	выражение
es	эс
govor	речь
žica	провод
prijedlozi	предложения
zamjena	замена
traka	лента
strateški	стратегическое
suditi	судья
kiselina	кислота
bajtova	байтов
cent	цент
prisiljeni	принудительный
kompatibilan	совместимый
apartman	квартира
nula	ноль
nula	нуль
zvučnik	оратор
savjetodavni	консалтинг
dizajner	дизайнер
pr	пр
brak	брак
svitak	рулон
banke	банки
fr	фр
sudionici	участники
tajna	секрет
negativan	отрицательный
favoriti	избранное
kazalište	театр
izvori	пружины
var	вар
izvesti	выполнять
prijevod	перевод
procjene	оценки
ozljeda	травма
ministarstvo	министерство
vozači	водители
odvjetnik	адвокат
figure	цифры
zaštićen	защищенный
prijedlog	предложение
dijeljenje	разделение
portal	портал
beta	бета
besplatno	бесплатно
prema	к
malo	немного
pomoći	помощь
ponašanje	поведение
sadržane	содержащиеся
zakonodavstvo	законодательство
zvanje	призвание
parametri	параметры
profili	профили
pitanja	вопросы
kuća	дома
kontrole	управления
kombinirana	комбинированный
ultimativno	окончательный
predstavnik	представитель
manji	незначительный
odjeli	ведомства
stanovnici	жители
prikazati	отображается
mama	Мама
smanjen	уменьшенный
rijedak	редкий
izvedena	выполнено
krajnost	экстремальный
uzorci	образцы
barovi	брусья
prognoza	прогноз
ukloniti	удален
ciklus	цикл
sadržati	содержать
točnost	точность
spavati	спать
mg	мг
ptica	птица
ljekarna	аптека
stvaranje	создание
statički	статический
Lovac	охотник
adrese	адреса
dama	леди
kristal	кристалл
poznat	известный
pisac	писатель
predsjednik	председатель
piće	напиток
akademija	академия
dinamičan	динамический
jesti	есть
trajan	постоянный
čišćenje	уборка
tvori	составляет
portfelj	портфолио
praktičan	практическое
isporučena	доставлен
infrastruktura	инфраструктура
boja	цвет
prodavač	продавец
filozofija	философия
regulacija	регулирование
službenici	офицеры
cilj	цель
ponude	предложения
ishrana	питание
snimanje	запись
mlađi	младший
les	ле
rt	мыс
prstenovi	кольца
Savjet	наконечник
predivan	замечательно
ulaznica	билет
najavio	объявленный
nagađati	Угадай
kome	кого
nogomet	футбольный
matematika	математический
uvoz	Импортировать
postavljanje	проводка
prisutnost	присутствие
automatski	автоматический
gledanja	просмотр
održavati	поддерживается
CH	ч
Dan	Дан
psi	собаки
direktori	директора
aspekti	аспекты
naprijed	впереди
mjesec	Луна
sudjelovanje	участие
shema	схема
letjeti	летать
držanje	манера
matrica	матрица
kombinacija	сочетание
amandman	поправка
snaga	прочность
purica	Турция
knjižnice	библиотеки
ispravan	правильный
stupnjeva	степени
poduzeća	предприятия
delta	дельта
strah	страх
traži	Ищу
inča	дюймов
konvencija	условность
dionice	акции
glavni	главный
udobnost	комфорт
boje	цвета
ratovi	войны
naručivanje	заказ
čuva	хранится
alfa	альфа
apel	обращение
krstarenje	круиз
bonus	бонус
ej	Привет
građevine	здания
specijalaca	скидки
pobijediti	бить
baterije	батареи
postaje	становится
diskovi	диски
oružje	оружие
čaj	чай
poboljšan	улучшен
postići	достигать
pozicije	позиции
haljina	платье
pretplata	подписка
prodavač	дилер
suvremeni	современный
nebo	небо
ROM	ПЗУ
prenosi	осуществляется
izlaganje	воздействие
sakriti	скрывать
potpis	подпись
mlinar	мельник
opskrba	обеспечение
odjeća	одежда
okviri	кадры
sigurno	безусловно
novine	газета
igračka	игрушка
sloj	слой
tiskan	печатные
usporiti	медленный
uklanjanje	удаление
odgovornost	ответственность
pisači	принтеры
dodajući	добавление
mjesto	место
potrošiti	проводить
tvornica	завод
unutrašnjost	интерьер
rasti	расти
optički	оптический
promocija	продвижение
rođak	относительный
nevjerojatan	удивительно
točka	точка
identitet	идентичность
pretvaranje	преобразование
osjećaj	чувство
skriven	скрытый
razuman	разумный
revizija	пересмотр
utjecaj	влияние
omjer	соотношение
važnost	важность
kiša	дождь
planeta	планета
kopije	копии
dozvola	разрешать
vidim	видя
dokaz	доказательство
bas	бас
recept	рецепт
prazan	пустой
primjer	пример
rupa	дыра
vožnja	поездка
zavod	бюро
konzervacija	сохранение
par	пара
idealan	идеальный
naočale	функции
zabilježena	записанный
Don	дон
komada	куски
gotov	законченный
parkovi	парки
odvjetnici	адвокаты
stres	стресс
krema	крем
ss	сс
radi	работает
otkriti	обнаружить
ap	ар
obrasci	узоры
brda	холмы
nm	нм
savjetnik	консультант
svjestan	знать
oblik	форма
evolucija	эволюция
potvrde	сертификаты
ciljevi	цели
stanice	станций
predložio	предложенный
op	оп
ostaci	остатки
tvrtke	фирмы
euro	евро
operater	оператор
strukture	сооружения
opći	общий
enciklopedija	энциклопедия
upotreba	Применение
tinta	чернила
mješovit	смешанный
popis	перепись
kotač	колесо
dobavljači	поставщики
kompaktan	компактный
poezija	поэзия
svjetla	огни
praćenje	отслеживание
anđeo	ангел
priprema	подготовка
pokušaj	попытка
primanje	получение
šibice	Матчи
suglasnost	соответствие
širina	ширина
motori	двигатели
zaboraviti	забывать
red	массив
raspravljati	обсуждается
točan	точный
klima	климат
grčki	греческий
instrukcija	инструкция
upravljanje	управление
sirov	сырье
Razlike	различия
objasniti	объяснять
uspostaviti	установить
izrazio	выраженный
opseg	степень
oštar	острый
Ben	Бен
stav	параграф
ubiti	убийство
matematika	математика
kompenzacija	компенсация
izvoz	экспорт
menadžeri	менеджеры
moduli	модули
provedena	проведены
verzije	версии
zna	знает
opisati	описывать
građani	граждане
nasljeđe	наследие
nevolja	беда
trener	тренер
poljoprivredni	сельскохозяйственное
proširiti	расширять
publika	аудитория
dodijeljena	назначенный
zbirke	коллекции
dobi	возраст
specijalista	специалист
kuhati	готовить
utjecati	аффект
Djevica	девственница
iskusan	опытный
istraga	расследование
uzdignut	поднятый
šešir	шапка
institucija	учреждение
usmjerene	направленный
pogođeni	пострадавших
bicikl	велосипед
potpuno	полностью
ploča	пластина
troškovi	затраты
naznačiti	указывать
plavuša	блондинка
postupak	производство
ljubimac	любимый
karakteristike	характеристики
der	дер
izgubiti	потерять
organski	органический
tražiti	искать
iskustva	опыт
albuma	альбомы
ugovori	контракты
gosti	гости
domaćin	состоялся
oboljenja	болезни
o	относительно
ekvivalent	эквивалент
kemija	химия
setove	комплекты
logika	логика
princ	принц
krug	круг
tlo	почва
psihologija	психология
mokar	влажный
okolnosti	обстоятельства
investitor	инвестор
osnovni	элементарный
sponzori	спонсоры
lisica	лиса
neograničen	неограниченный
odgovarati	отвечать
veličine	размеры
običan	гладкий
Izlaz	Выход
ruka	рука
ključevi	ключи
val	волна
svet	святой
djela	акты
vođenje	руководство
trag	след
simbol	символ
autocesta	шоссе
promatranom	наблюдаемый
dekan	декан
postaviti	настроить
anketa	голосование
stilovi	стили
ispunjen	заполненный
veza	связь
kanali	каналы
dodatak	приложение
čokolada	шоколад
dio	часть
djelokrug	объем
dobavljač	поставщик
kabeli	кабели
pamuk	хлопок
zahtjev	требование
ubijen	убитый
granica	граница
antički	древний
debata	обсуждение
predstavnici	представители
počinje	начинается
trudnoća	беременность
atrakcije	достопримечательности
naučeno	научился
transakcije	операции
istraživač	исследователь
povijesni	исторический
suprug	муж
odobren	уполномоченный
lud	псих
Nadolazeći	предстоящий
koncert	концерт
rezultate	множество
efikasnost	эффективность
komedija	комедия
usvojen	принят
učinkovit	эффективное
linearan	линейный
opredjeljenje	обязательство
specijalitet	специальность
medvjedi	медведи
hmelj	хмель
prijevoznik	перевозчик
konstantno	постоянная
Visa	виза
usta	рот
metar	метр
povezan	связанный
razgovori	интервью
pojmovi	концепции
puška	пистолет
odraziti	отражать
čist	чистый
pakao	ад
voće	фрукты
počinje	начинается
kvalificiran	квалифицированный
reforma	реформа
leće	объектив
liječi	обрабатывали
otkriće	открытие
crtati	привлечь
svrstan	объявление
pretpostaviti	предполагать
savez	союз
potvrditi	подтвердить
inženjer	инженер
dosljedan	последовательный
zamijeniti	замещать
odobrenje	зазор
konverter	конвертер
organizacija	организация
dijete	младенец
provjere	проверки
postignut	достиг
postaje	становление
cilj	задача
naznačeno	указанный
šećer	сахар
posada	экипаж
noge	ноги
štap	придерживаться
odnos	связь
omogućeno	включен
žanr	жанр
dobrovoljac	доброволец
stražnji	задний
demokratski	демократической
povećati	усилить
točno	точный
granica	связанный
parametar	параметр
procesor	процессор
čvor	узел
formalan	формальный
oluja	буря
mikro	микро
fakulteti	колледжи
milja	мили
izazovi	проблемы
urednici	редакторы
vrhovni	высший
braća	братья
priznanje	признание
Najbolje	ссылка
procjena	оценить
dijete	дитя
inspekcija	осмотр
potrošači	потребители
granice	пределы
teritorija	территория
oružje	оружие
odgoditi	задержка
pilot	пилот
doprinosi	взносы
stalan	непрерывный
inicijativa	инициатива
roman	роман
izvršenje	выполнение
invalidnost	инвалидность
ultra	ультра
pobjednik	победитель
epizoda	эпизод
lončar	гончар
jelo	блюдо
igra	игры
bilten	бюллетень
ia	Айова
izmijeniti	модифицировать
uistinu	действительно
svemir	вселенная
kandidat	кандидат
prorez	слот
izvanredan	выдающийся
Ha	ха
planirani	планируемый
loža	домик
ogledalo	зеркало
turnir	турнир
obzir	рассмотрение
sjednice	сессий
zrno	ядро
kupci	покупатели
časopisi	журналы
siva	серый
katalog	каталог
optužen	заряженный
širok	широкий
und	унд
odabran	выбранный
demo	демонстрация
mrziti	ненавидеть
terminal	Терминал
izdavači	издатели
noću	ночью
tekući	жидкость
riža	рис
rezervacija	бронирование
hrana	продукты
straža	охрана
ušteda	экономия
carstvo	империя
novo	вновь
podići	повышение
nezakonit	нелегальный
ekspanzija	расширение
premijer	премьер
sutra	завтра
mlijeko	молоко
drama	драма
gostujući	посещение
Natjecanje	конкурс
prikupljeni	собранный
bendovi	группы
pogodan	подходящее
apsolutno	абсолютно
revizija	аудит
komora	камера
Gvineja	Гвинея
nalazi	Выводы
izo	ISO
tipičan	типичный
iznos	сумма
piletina	курица
privremen	временный
prisustvovati	посещать
tuš	душ
slanje	отправка
dovoljan	достаточно
ljuska	оболочка
pokrajina	провинция
katolički	католик
guverner	губернатор
pivo	пиво
doprinos	вклад
formula	формула
ustav	конституции
ambalaža	упаковка
pouzdan	надежный
sumnjati	сомнение
zaraditi	зарабатывать
razdoblja	периодов
napadi	нападки
roba	товар
simptomi	симптомы
spomen	мемориал
blizanac	близнец
umetnuti	вставить
prolaz	шлюз
crtanje	Рисование
kandidati	кандидаты
naredio	приказал
biološki	биологический
borba	борьба
tranzicija	переход
postavke	предпочтения
špijun	шпион
romantika	романс
instrument	инструмент
podjela	Трещина
teme	темы
sile	полномочия
raj	небо
komadići	биты
trudna	беременная
klasifikacija	классификация
usmjerena	сосредоточены
liječnik	врач
traži	просить
blokovi	блоки
gle	вот
duhovni	духовный
dijabetes	диабет
ml	мл
smjena	сдвиг
sjediti	сидеть
tjelesa	тела
fotografije	фотографии
rezanje	резка
pisci	писатели
fleksibilno	гибкий
voljen	любимый
favoriti	избранное
kartografija	отображение
brojan	многочисленные
relativno	относительно
predstavlja	представляет
superioran	превосходящий
poželjna	предпочтительным
spremaju	сохранены
intelektualac	интеллектуальной
odobreno	предоставляется
ugljen	углерод
udobno	удобный
magnetski	магнитные
interakcija	взаимодействие
slušanje	прослушивание
kriza	кризис
pogled	прогноз
masivan	массивный
svijetao	яркий
formirana	сформированный
klavir	пианино
jeka	эхо
revolucija	революция
prikazuje	дисплеи
plazma	плазма
zarada	прибыль
misterija	тайна
pejzaž	пейзаж
mehanički	механический
putovanje	поездка
zastava	баннер
smokva	инжир
županije	графств
akvizicija	получение
priznat	признанное
snovi	мечты
obavijest	уведомление
kg	кг
učiti	учат
brz	быстрый
Vuci	вытащить
Juta	Юта
seminar	семинар
investicije	вложения
kotači	колеса
odrediti	указывать
osjetljiv	чувствительный
predlošci	шаблоны
formati	форматы
drži	держит
usmjerivač	маршрутизатор
beton	бетон
si	си
mapa	папка
završetak	завершение
puls	пульс
tehnika	техника
glasanje	голосование
sudovi	суды
pretvaraju	переоборудованный
metro	метро
godišnjica	Годовщина
poboljšanja	улучшения
traka	полоса
specifikacija	Спецификация
nesreća	авария
zarez	Ник
dostupan	доступной
Rezidencija	резидент
zemljište	сюжет
tipično	типично
prikaz	представление
pumpa	насос
postoji	существует
aranžmani	договоренности
konferencije	конференций
potrošnja	потребление
suziti	узкий
prijetnja	угроза
ankete	опросы
sjedenje	сидящий
konzultant	консультант
kontrolor	контроллер
odbori	комитеты
penis	пенис
dvorac	замок
vrtovi	сады
etikete	этикетки
spreman	готовы
bio	био
gluma	действующий
glave	руководители
ispit	экзамен
prebivalište	резиденция
gustoća	плотность
stotina	сто
čudan	странный
održiv	устойчивый
statistički	статистический
spomenuti	упомянуть
inovacija	инновация
siva	серый
paralelno	параллельно
raditi	работать
novčanice	банкноты
stabilan	стабильный
definicije	определения
von	фон
liječnici	врачи
lekcija	урок
kino	кино
izbori	выборы
reakcija	реакция
prazan	пустой
poboljšane	повышенная
pravo	озаглавленный
ozbiljan	серьезный
generirati	генерировать
novine	газеты
bolnice	больницы
vi	VI
humor	юмор
star	престарелый
monitori	мониторы
izuzetak	исключение
trajanje	продолжительность
Glavnina	насыпной
posjeta	посещения
sposobnosti	возможности
preporuka	рекомендация
grijeh	грех
organizirani	организованная
ba	ба
stavak	пункт
posvajanje	принятие
poboljšanje	улучшение
skup	дорогая
bizon	буйвол
organizacija	организации
avion	самолет
programi	программы
mehanizam	механизм
ee	й
obilježen	отмеченный
upravljan	управляемый
boca	бутылка
inovativan	инновационный
masaža	массаж
zaključak	вывод
zatvaranje	закрытие
tisuću	тысяча
legenda	легенда
vila	вилла
kost	кость
stupovi	столбцы
poremećaji	расстройства
kolaboracija	сотрудничество
otkrivanje	обнаружение
unutrašnji	внутренний
formacija	образование
med	мед
inženjeri	инженеры
osoba	организация
krstarenja	круизы
vrata	Ворота
rimski	Римский
dužnosti	обязанности
erotski	эротический
ton	тон
etika	этика
zmaj	Дракон
zaposlen	занятый
kapetan	капитан
donosi	приносит
grijanje	обогрев
noga	ножка
vrat	шея
krilo	крыло
skripta	скрипты
abeceda	азбука
postavljen	назначенный
bavljenje	дело
počiniti	совершить
željeznički	рельс
putovanja	поездки
praznina	разрыв
strane	стороны
cijev	трубка
odgovara	соответствующий
opisi	описания
pojas	ремень
jakna	куртка
animacija	анимация
proročanstvo	оракул
er	эр
produkcija	производства
zrakoplovstvo	авиация
ponos	гордый
katastrofa	катастрофа
konzola	консоль
naredbe	команды
jr	младший
telekomunikacija	связь
instruktor	инструктор
gigantski	гигант
postići	достигнутый
ozljede	травмы
pristupi	подходы
uobičajen	обычный
marke	Марки
kut	угол
opljačkati	грабить
dizajneri	дизайнеры
sloboda	свобода
doba	эпоха
Pretvoriti	конвертировать
mogućnost	возможность
analitičar	аналитик
opasno	опасно
pouzdanost	надежность
odnosno	соответственно
volonteri	добровольцы
izveden	полученный
zadovoljstvo	удовольствие
čast	честь
orijentiran	ориентированного
orao	орел
molitva	молитва
radionice	мастерские
uragan	ураган
miran	тихо
proizvođač	режиссер
zastupljeni	представленный
odgovornosti	обязанности
sir	сыр
pažljivo	внимательно
produktivnost	производительность
kruna	корона
jednakost	паритет
dijagnoza	диагностика
tvorac	производитель
pukotina	трещина
načelo	принцип
motika	кирки
banda	банда
fetiš	фетиш
izgled	появление
dim	дым
filteri	фильтры
inkorporiran	включенный
čamac	ремесло
kolega	человек
slijep	слепой
salon	гостиная
lud	Сумасшедший
algoritam	алгоритм
snažno	сильно
kafić	кафе
znanje	кругозор
proteini	белки
Su	су
upoznat	знакомые
sposoban	способный
ulaz	вход
cipela	башмак
izabran	избран
nošenje	проведение
terorizam	терроризм
radost	радость
izdanja	издания
etnički	этнической
parlament	парламент
glumac	актер
nalazi	находки
pečat	печать
situacije	ситуации
peti	пятый
građanin	гражданин
vertikala	вертикальный
ispravke	поправки
opisuje	описывает
invaliditetom	инвалидов
supstanca	вещество
zabranjen	запрещено
cijev	труба
vojnici	солдаты
čuvar	опекун
predavanje	лекция
simuliranje	моделирование
raspored	расположение
inicijative	инициативы
bolestan	больной
koncentracija	концентрация
položiti	прокладывать
tumačenje	интерпретация
prljav	грязный
učio	учил
radnik	работник
optimizacija	оптимизация
hram	храм
tvari	вещества
dokazati	доказывать
otkriven	обнаруженный
krila	крылья
genetski	генетический
ograničenja	ограничения
tanak	тонкий
izložba	выставка
greben	хребет
modem	модем
donošenje	приведение
bolestan	больной
procijeniti	оценивать
tropski	тропический
prikupiti	собирать
vektor	вектор
definitivno	определенно
tokarenje	превращение
postojanje	существование
komentar	комментарий
razvoj	события
imigracija	иммиграция
destinacije	направления
zajednički	взаимное
sintaksa	синтаксис
li	литий
atribut	атрибут
zatvor	тюрьма
vještina	умение
stolice	стулья
okolni	окружающих
planine	горы
popularnost	популярность
pitanje	запрос
provjeren	проверено
izložak	экспонат
bacanje	бросать
trend	тенденция
mačke	коты
pustinja	пустыня
ya	я
koordinator	координатор
Merkur	Меркурий
spaljivanje	сжигание
pobjeći	побег
prijamnik	получатель
progresivan	прогрессирующий
brodovi	лодки
prvenstvo	чемпионат
arkada	аркада
nemoguće	невозможно
govori	говорит
očigledan	очевидный
depresija	депрессия
grafikon	график
pokrivati	покрытие
platina	платина
osuda	суждение
razgovori	переговоры
podnošenje	подача
gajiti	способствовать
nagrađen	награжден
ispitivanja	испытания
majstori	мастера
kaseta	картридж
obrazloženje	объяснение
org	организация
prevara	мошенничество
elektricitet	электричество
spektar	спектр
dolazak	прибытие
posuđe	керамика
isticanje	акцент
super	здорово
potvrđen	подтвердил
broji	счетчики
sudar	авария
lift	лифт
između	между
visine	высоты
sjena	тень
trošak	расходы
pothvat	предприятие
Klinika	клиника
liječenje	исцеление
princeza	принцесса
ulazak	входящий
paket	пакет
studio	студии
učešće	участие
tata	папа
tipke	кнопки
plasman	размещение
zapažanja	наблюдения
pobjednici	победители
ceste	дороги
sljedeći	последующий
dvorište	двор
otkriće	раскрытие
osnivanje	создание
sjećanja	воспоминания
TE	тэ
stvara	создает
lica	лица
turist	турист
ubiti	убийство
adekvatan	адекватный
senator	сенатор
prezentacije	презентации
probaviti	дайджест
prah	пыли
wiki	вики
zamijeniti	заменены
radar	радиолокационный
gubici	потери
borba	бой
smanjivanje	сокращение
prestao	остановился
okupacija	занятие
tijesno	тесно
radijacija	излучение
kraljevi	короли
pucanje	стрельба
uho	ухо
zastave	флаги
pekar	пекарь
konzervativan	консервативный
šok	шок
efikasnost	эффективность
kravata	галстук
krov	крыша
pokazati	демонстрировать
atmosfera	атмосфера
poljubac	поцелуй
zvijer	зверь
ra	ра
operiran	управляемый
eksperiment	эксперимент
ciljevi	цели
kupi	покупки
federacija	федерация
pizza	пицца
pozvan	приглашенный
zadatak	назначение
modni	модификация
upita	запросы
odsutnost	отсутствие
dobavljači	поставщики
joga	йога
služi	служит
iznenađenje	сюрприз
svjetiljka	лампа
vicevi	шутки
savjetovanje	консультирование
palača	дворец
zadovoljan	доволен
pobjeda	победы
skladište	склад
trebala	предполагаемый
običan	обычный
duh	призрак
povreda	нарушение
šef	босс
ponos	гордость
očekivanja	ожидания
nezavisnost	независимость
poznavanje	знание
reporter	репортер
metabolizam	метаболизм
prvak	чемпион
lično	лично
mnogo	много
solo	соло
grlo	горло
bogatstvo	богатство
vakuum	вакуум
ples	танцы
prepoznati	признать
piše	пишет
trg	площадь
traganje	поиск
objaviti	публиковать
probir	скрининг
trans	транс
pionir	пионер
zaboravljen	забытый
akrobata	акробат
ploče	тарелки
eseji	эссе
ponašanje	поведение
reći	говоря
pošteno	довольно
inteligentan	умный
načini	режимы
obaveza	обязательство
luka	гавань
putnik	путешественник
segment	сегмент
neprijatelj	враг
puzzle	головоломка
bunara	углубления
ograničen	ограниченный
republikanac	республиканец
tajne	секреты
sindrom	синдром
pohađanje	посещаемость
kazna	штраф
bubanj	барабан
omogućuje	позволяет
graditelj	строитель
vidik	перспектива
poplava	наводнение
olakšati	легкость
argumenti	аргументы
arena	арена
avanture	приключения
zjenice	зрачки
Obavijest	объявление
ishod	исход
cijeniti	ценить
proširen	расширенный
odrastao	взрослый
lijep	прекрасный
centri	центры
klauzula	пункт
osmijeh	улыбка
zemljišta	земли
trupe	войска
naoružan	вооруженный
bor	сосна
hlađenje	охлаждение
zaljev	залив
kamioni	грузовики
mehanizmi	механизмы
razvod	развод
tradicija	традиция
tablete	таблетки
tigar	тигр
ljudi	люди
senzor	датчик
izložen	подвергаются
lov	охота
anđeli	ангелы
zamjenik	заместитель
thai	тайский
emisija	выбросы
liječnici	врачи
prigovor	жалоба
scene	сцены
pokusi	эксперименты
pojačati	увеличение
vladavina	управление
mlin	мельница
osnovan	основанный
kroničan	хронический
jazbina	логово
prst	Палец
drži	держит
funta	фунт
pronaći	разместить
pl	пл
obučen	обученный
provođenje	реализации
kruh	хлеб
motori	моторы
tvrd	жесткий
incident	инцидент
dinamika	динамика
laž	ложь
razgovor	разговор
smanjenje	снижение
obožavanje	поклонение
sposobnost	возможность
ak	Аляска
preciznost	точность
štete	убытки
rezerve	резервы
riješiti	решать
manjina	меньшинство
drugačiji	разнообразный
Sastojci	ингредиенты
Ah	ах
tonovi	тоны
rehabilitacija	реабилитация
vid	взгляд
glina	глина
slab	слабый
podijeljen	разделенный
recepcija	прием
mudar	мудрый
izgledi	шансы
seminari	семинары
posljedice	последствия
odluka	производители
geografija	география
integritet	целостность
nasljedstvo	наследие
zadovoljan	довольный
opasnost	Опасность
vitamin	витамин
obrađen	обработанный
fraza	фраза
podizanje	привлечение
implikacije	последствия
funkcionalnost	функциональность
raj	рай
hibrid	гибридный
čita	читает
emotivan	эмоциональный
slava	слава
ja	JA
geografski	географический
prekoračiti	превышать
štap	стержень
svila	шелк
bebe	дети
dvo	би
romantičan	романтик
objavi	показал
stručnjaci	специалисты
generator	генератор
suspenzija	подвеска
tužan	грустный
korekcija	коррекция
vuk	волк
polako	медленно
dopuniti	дополнение
dijelovi	участки
dječji	младенец
sektori	секторов
tekućina	жидкость
teren	основания
obrok	еда
tA	та
strojevi	машины
jednadžba	уравнение
košare	корзины
vjerojatnost	вероятность
dimenzija	измерение
studirao	изучал
dobit	доходы
vrag	дьявол
trava	трава
ilustrirano	иллюстрированный
trešnja	вишня
kontinentalni	континентальный
dostignuće	достижение
ograničenja	ограничения
pogreb	похороны
poglavlja	главы
putnik	пассажир
zgodan	удобный
Mars	Марс
veličine	размера
jaje	яйцо
signali	сигналы
orijentacija	ориентация
krađa	кража
djetinjstvo	детство
simboli	символы
lat	Lat
meta	мета
analog	аналоговый
talenat	талант
datiran	датированный
mudrost	мудрость
granica	граница
elita	элита
vojnik	солдат
vjeruje	считает
pjesme	стихи
nadležnost	юрисдикция
robot	робот
prikazivanje	отображение
svjedok	свидетель
opremljen	оборудованный
faze	этапы
sur	сюр
stečena	приобретенный
procijeniti	оценить
pranje	мыть
ulaz	вход
izjava	декларация
gubljenje	проигрыш
pokušaji	попытки
plemenite	благородный
automatizacija	автоматизация
utjecaji	воздействие
revolucija	оборот
prednosti	преимущества
vitez	рыцарь
ciljevi	цели
ekstenzije	расширения
žalbe	апелляции
bolest	болезнь
Ho	эй
alternative	альтернативы
sh	ш
sapun	мыло
pekmez	варенье
neuobičajen	необычный
odgovorio	ответил
razaranje	разрушение
migracija	миграция
poremećaj	расстройство
konvencionalne	обычный
nošenje	носить
os	ось
traži	искать
geni	гены
srednja	медиана
skener	сканер
ovdje	здесь
animirani	мультипликационный
podešavanje	регулировка
junak	герой
tretmani	лечение
stav	отношение
tepih	ковер
leće	линзы
prisustvovao	участие
teškoća	трудность
punk	панк
koalicija	коалиция
upis	регистрация
vojvoda	герцог
tempo	темп
proizvođači	производители
luk	дуга
sučelja	интерфейсы
atlas	атлас
zapažanje	наблюдение
mučenje	пытки
izbrisana	удаленный
kaput	Пальто
obnova	восстановление
pogodnost	удобство
povratak	возврате
opozicija	оппозиция
kontejner	контейнер
tuženik	ответчик
nadglednik	руководитель
korpus	корпус
glumci	актеры
jetra	печень
odgovoran	подлежащий
peticija	петиция
antena	антенна
izabran	выбрал
vjerovanje	вера
ubijanje	убийство
rame	плечо
dekor	оформление
ion	ион
promjer	диаметр
podcast	подкаст
interakcije	взаимодействия
pjevač	певец
glasnik	вестник
starenje	старение
intervencija	вмешательство
uključiti	плагин
privlačnost	Привлечение
ronjenje	дайвинг
modifikacija	модификация
pretpostaviti	предполагать
trska	тростник
obuhvatiti	включать
umjeren	умеренный
miševi	мышей
razumjeti	понимать
brzo	быстро
zabrana	запрет
uvjerenje	гарантия
događa	происходит
ogroman	огромный
mlinovi	мельницы
obris	контур
prima	получает
traperice	джинсы
kompilacija	сборник
neparan	странный
sigma	сигма
gr	гр
atraktivan	привлекательный
prilika	повод
snimke	записи
žrtva	жертва
zahtjevi	требования
pažljiv	осторожный
snop	луч
vrtlarstvo	садоводство
obveze	обязательства
stići	прибыть
orkestar	оркестр
licenca	лицензия
prilagodljiv	регулируемый
namjena	распределение
esej	сочинение
pokazao	продемонстрировал
dijalog	диалог
kampovi	лагеря
proglašen	объявленный
trag	след
zatvoriti	закрыть
omot	пакеты
ge	GE
instaliranje	установка
prekidači	переключатели
dobrovoljan	добровольный
ti	ты
veoma	значительно
ng	нг
obično	обычно
pe	ре
fotograf	фотограф
plakati	плакать
kvantni	квант
konstruiran	построенный
dodaci	дополнения
traži	требующий
strijela	стрела
angažman	помолвка
hrapav	грубый
čudan	странный
lav	лев
vjenčanja	свадьбы
kisik	кислород
kanjon	каньон
metara	метры
samo	просто
kalendari	календари
uređenje	договоренность
zaključci	выводы
bibliografija	Библиография
pokazivač	указатель
kompatibilnost	совместимость
rastezanje	протяжение
dozvole	разрешения
zadruga	кооператив
hraniti	кормление
općina	городок
ljestvici	рейтинги
mjerenje	измерения
remen	ремень
gužva	толпа
transferi	переводы
olimpijski	олимпийский
transformacija	преобразование
dir	реж
carina	обычаи
administratori	администраторы
osoba	личность
kuka	крюк
rulet	рулетка
odbiti	снижение
vrpca	шнур
oblak	облако
olakšati	содействовать
val	вал
objašnjava	объясняет
postupiti	продолжить
osjećaji	чувства
nož	нож
posvojiti	принять
odbijen	отказано
donacija	пожертвование
vanjski	внешний
usjev	культура
rijeka	реки
čvorovi	узлы
naveo	цитируется
središte	хаб
ciljano	целевое
shvatio	понял
osnivač	основатель
desetljeće	десятилетие
rasprava	спор
umoran	устала
štetan	неблагоприятный
izvod	выдержка
pražnjenje	разряд
pića	напитки
as	туз
glasovi	голоса
penjanje	альпинизм
tona	тонны
parfem	духи
opasan	опасный
vratiti	восстановить
stog	стек
metodologija	методология
ugled	репутации
demokrati	демократы
objesiti	вешать
zavoj	кривая
tvorac	создатель
jantar	янтарный
muzeji	музеи
šifriranje	кодирование
tragač	трекер
varijacija	изменение
prolaz	прохождение
prebačen	переданы
deblo	хобот
fotografirati	фотография
valovi	волны
deva	верблюд
distributer	распределитель
chi	чи
prikupljanje	сбор
projekcija	проекция
matematički	математическая
logičan	логический
umak	соус
slava	известность
specijalizirani	специализированный
korporacije	корпорации
kritika	критика
automobil	автомобиль
suci	судьи
opaske	замечания
otkrivena	обнаруженный
slike	картины
hodao	ходил
proizlaze	возникающий
populacije	популяции
uplašen	боюсь
akustički	акустическое
kaseta	кассета
indikator	индикатор
jpg	JPG
pogreška	ошибка
eliminirati	Устранить
mineral	минеральная
rubin	Рубин
perle	бисер
bogatstvo	состояние
platno	холст
prag	порог
župljani	приход
ekrani	экраны
groblje	кладбище
stadion	стадион
istraživanje	исследование
min	мин
stabljika	стебель
astronomija	астрономия
natjecanja	конкурсы
gripa	грипп
kostim	костюм
bicikle	велосипеды
biskup	епископ
izvukao	вытащил
kukuruz	кукуруза
kompresija	компрессия
uspostavljanje	налаживание
seljak	фермер
kositar	банка
rob	рабыня
odmah	немедленно
treniranje	тренировка
pregledan	рассмотрел
kodiranje	кодирование
Tvrdnje	Доводы
heroji	герои
obojen	окрашенный
portret	портрет
terorista	террорист
etički	этический
nositelji	носители
mobilnost	мобильность
borba	борьба
sheme	схемы
pati	страдающий
neutralan	нейтральный
ribolovac	рыболов
štakor	крыса
koplja	копья
spajanje	присоединение
naslov	заголовок
Umjetna	искусственный
ležaj	подшипник
spektakularan	захватывающий
svjetovi	миры
kriv	виновный
aktiviranje	активация
utočište	убежище
tableta	таблетка
porota	жюри
dos	DOS
rep	хвост
draž	очарование
nasilan	насильственный
potencijalno	потенциально
ranč	ранчо
ograničenja	ограничения
prijelaz	скрещивание
uključujući	включительно
kućica	коттедж
pijan	пьяный
znatan	значительный
zločini	преступления
riješen	решены
bajt	байт
nos	нос
grane	ветви
stranac	инопланетянин
procesora	процессоры
razbio	сломал
složenost	сложность
konstantno	постоянно
odlučnost	разрешить
područja	территории
teza	Тезис
diskovi	диски
čest	частый
strop	потолок
piksela	пикселей
gen	поколения
karo	бриллианты
flota	флот
mnogo	гроздь
teorijski	теоретический
upućivanje	направления
prestati	уволиться
protokoli	протоколы
pluća	легкое
zamjena	замена
sjajan	блестящий
ti	ти
gel	гель
govorni	разговорный
omega	омега
procijenjen	оценивали
ostao	остались
vidi	видит
završetak	прекращение
gledao	смотрели
domaćinstva	домохозяйства
otkupiti	выкупать
žitarica	зерно
režim	режим
bik	бык
arhitektonski	архитектурный
razlikuju	отличаться
pokreti	движения
popravci	ремонт
dah	дыхание
sadržajima	услуги
praktično	фактически
tržište	рынок
svijeća	свеча
vješanje	подвешивание
obojen	цветной
priča	рассказ
ranije	раньше
projektor	проектор
smješten	расположенный
traži	стремится
strogo	строго
psihološki	психологический
vitamini	витамины
elegantan	элегантный
dobici	доходы
obnova	обновление
genealogija	генеалогия
smatra	считается
urezivanje	счет
trošak	расход
kritičari	критики
algoritmi	алгоритмы
haker	хакер
salon	салон
turbina	турбо
lijek	лечение
ni	п
misli	думает
prijedlog	предложение
vojnik	солдат
bomba	бомбить
šteta	вред
interval	интервал
ogledala	зеркала
istraga	исследовать
tvoj	твой
paneli	панели
ponovljen	повторный
napad	нападение
jelen	олень
jezik	язык
kuglanje	боулинг
tri	три
majmun	обезьяна
razmjer	доля
suknja	юбка
analize	анализы
crteži	рисунки
značaj	значение
scenario	сценарий
vi	вы
arapski	арабский
mjerilo	калибр
zaštitu	защищающий
suočeni	сталкиваются
rješavanje	решение
proizvodi	производит
intenzivan	интенсивный
lanci	цепи
šesti	шестой
angažirati	заниматься
prebacivanje	переключение
Dopisivanje	переписка
uvoz	импорт
nadzor	надзор
rashodi	Расходы
odvajanje	разделение
svjedočanstvo	свидетельство
sumnjiv	подозреваемый
obavezan	обязательное
granice	границы
Proslava	праздник
filtriranje	фильтрация
suprug	супруг
Egzotično	экзотический
gledatelj	зритель
dostizanje	достижения
smijeh	смех
kirurška	хирургический
uništiti	уничтожить
citat	цитата
yo	Эй
prostorije	предпосылки
dokazao	доказано
uvredljiv	наступление
carski	имперский
tucet	дюжина
razvoj	развертывание
tkanina	ткань
lotos	лотос
losos	лосось
teret	грузовой
direktiva	директива
pariti	приятель
maslac	масло
papar	перец
oružje	оружие
teret	бремя
vrpce	ленты
zone	зон
Otok	островной
vitak	стройное
javor	кленовый
trgovine	продуктовый
upravni	руководящий
depo	депо
alt	альт
pita	пирог
mješavina	смесь
emisija	излучение
vidljiv	очевидный
nastavni	учебный
dozvole	разрешений
WC	туалет
rangirani	занимает
ruta	маршруты
montiranje	монтаж
vezan	связанный
uravnotežen	сбалансированный
kasni	задерживается
dolina	дол
računanje	расчет
vile	виллы
prilike	случаи
jednadžbe	уравнения
ulja	масла
bratstvo	сентябре
izuzetan	исключительный
anksioznost	тревожность
prostorni	пространственный
ispitanici	респондентов
razmatranja	соображения
plaća	платит
sunčano	солнечно
donosi	обеспечивает
Je	JE
ogrlica	ожерелье
mješavina	композитный
lang	языки
kazališta	театры
projektiranje	проектирование
nade	надеется
procjene	оценки
dijagram	диаграмма
obuća	обувь
sg	SG
narodi	народов
pobjednik	Виктор
licence	лицензии
rasponi	диапазоны
parovi	пары
osjetljivost	чувствительность
čuvanje	сохранение
izolirani	изолированный
privremena	промежуточный
pomogao	помощь
božanski	божественный
odobriti	одобрить
spoj	соединение
intenzitet	интенсивность
tehnološki	технологический
abortus	аборт
dijaloški	диалог
prostorima	центры
eksplozija	взрыв
adresiranje	адресация
pol	столб
štit	щит
membrana	мембрана
očajan	отчаянный
majke	матери
demonstracija	демонстрация
vladin	правительственный
proizveden	изготовлен
svijeće	свечи
varijacije	вариации
mame	мамы
svet	священный
ovisnost	зависимость
krom	хром
odbijen	отказалась
kočnica	тормоз
vanjski	экстерьер
pozdrav	приветствие
ekologija	экология
klisura	лощина
nezaposlenost	безработица
zabio	забил
poboljšanje	усиление
klon	клон
brzina	скорость
À	лямбда
sastavljen	состоящий
suze	слезы
oaza	оазис
taksi	такси
fa	фа
društva	общества
silicij	кремний
identičan	идентичный
nafta	нефть
konkurirati	конкурировать
ist	IST
ljubavnik	любовник
pripadati	принадлежать
usne	губы
pratnja	эскорт
jezero	пруд
trajekt	паром
zec	кролик
profesija	профессия
brana	дамба
fiziologija	физиология
izvoz	экспорт
guma	шина
učesnik	участник
elektron	электрон
opterećenja	грузы
vrijesak	вереск
motel	мотель
sindikati	союзы
riznica	казначейство
okupiran	занятый
vage	Весы
naprezanje	напряжение
uhićen	арестованный
istraživanja	исследования
stekao	получили
praonica	прачечная
smještanje	размещение
prilagoditi	регулировать
procjenjuje	оценивается
šifriranje	шифрование
punjenje	заполнение
nametnuti	наложенный
tišina	тишина
sovjetski	советский
posjed	владение
ugovor	договор
trener	тренер
orgulje	орган
limun	лимон
tama	темнота
pedalj	пролет
vic	шутка
pakiranje	упаковка
statut	статут
odbijen	отвергнуто
sklonište	укрытие
kapela	часовня
proizvodnja	производство
slojevi	слои
slaviti	праздновать
uređaj	прибор
smjesa	смесь
jahač	наездник
radius	радиус
impresivan	впечатляющий
ovca	овца
arhitekt	архитектор
predavanja	лекции
vina	вина
šalice	чашки
pepeo	ясень
suradnici	авторы
salata	салат
prekršaji	нарушения
temperature	температура
natjecanja	соревнования
sačuvati	сохранять
pjesma	стих
ostanak	пребывание
Uskrs	Пасха
teorije	теории
skladište	хранилище
potoci	потоки
slijetanje	посадка
pogubljen	выполненный
pregovori	переговоры
realističan	реалистический
pita	спрашивает
sinopsis	конспект
kompozitor	композитор
grah	боб
mač	меч
izmjene	изменения
koraljni	коралловый
piksela	пиксель
staze	пути
mjehurić	пузырь
por	Пор
steći	приобретать
suprotno	вопреки
tribina	трибуна
Brod	судно
kiseline	кислоты
virusi	вирусы
naljepnice	наклейки
reakcije	реакции
vjerovanja	убеждения
odjeljenje	команда
analizirati	анализировать
podjele	подразделения
plivati	плавать
nano	нано
koncerti	концерты
muškarci	мужчины
zadržati	сохранить
boje	цвета
izvršiti	выполнять
tunel	тоннель
žanrovi	жанры
patenti	патенты
pšenica	пшеница
kronike	летописи
dobivanje	получение
dabar	бобр
čitanja	чтения
uvećanje	укрупнение
orlovi	орлов
baze	основы
optuženik	обвиняемый
kampanje	кампании
jedinstvo	единство
definira	определяет
slučajevi	экземпляры
domaći	местный
počela	начатый
paketi	пакеты
sidro	якорь
čarape	носки
okidač	вызывать
kolesterol	холестерин
diferencijal	дифференциал
površine	поверхности
užasan	ужасный
usmjerivači	маршрутизаторы
satovi	часы
artritis	артрит
bios	BIOS
ženke	женщины
odražava	отражает
oporezivanje	налогообложение
groznica	лихорадка
kuhinja	кухня
sigurno	конечно
praktičari	практики
teorema	теорема
inflacija	инфляция
ti	тебя
spojevi	соединений
bubnjevi	барабаны
razumno	разумно
ogoljen	голый
radikal	радикал
preporučuje	рекомендует
kontrolni	управление
blago	сокровище
plamen	пламя
jama	яма
mono	моно
čestice	частицы
plivajući	плавающий
Koordinirati	координировать
isključivo	исключительно
ograničenje	ограничение
pogođen	пораженный
ilustracija	иллюстрация
upozorenja	предупреждения
izgraditi	сооружать
aplikacije	Программы
upita	запросы
dodatak	приложение
inspiracija	вдохновение
teretni	грузовой
zasjeniti	затмение
utječe	влияет
prognoze	прогнозы
otkriti	обнаружить
aktivno	активно
složen	сложно
ozlijeđen	пострадавший
izrazi	выражения
tona	тонна
kurir	курьер
savjeti	Рекомендации
gif	GIF
sukobi	конфликты
piće	напиток
danak	дань
imun	иммунный
šumarstvo	лесоводство
barijere	барьеры
nagib	косяк
rijetko	редко
ponuda	предложения
prepreka	барьер
bicikl	велосипед
namještaj	обстановка
ustati	возникать
keltski	кельтская
čestica	частица
vlažnost	влажность
boce	бутылки
dm	дм
preporod	Ренессанс
propis	постановление
fotografi	фотографы
infekcije	инфекции
šah	шахматы
djeluje	работает
festivale	фестивали
mogućnosti	возможности
patka	утка
kanal	канал
doprinosi	способствуя
krava	корова
analitički	аналитический
kostimi	костюмы
strog	строгий
Cirkulacija	циркуляция
prekršaj	преступление
pretpostavka	предположение
hobi	хобби
pokušava	пытается
izum	изобретение
tehničar	техник
rukovoditelji	руководство
upita	запросы
spoznajni	познавательный
istraživanje	исследование
trik	трюк
pitanje	запрос
zatvaranje	закрытие
greda	лесоматериалы
volt	вольт
intenzivan	интенсивный
pristaše	сторонников
statuti	статуты
upisao	зачислен
senzori	датчиков
vijak	винт
ministri	министры
javno	публично
patio	пострадали
usisni	потребление
leptir	бабочка
mehanika	механика
zaglavlja	заголовки
greške	ошибки
numerički	численный
definiranje	определяющий
računajući	подсчет
odraz	отражение
poziv	приглашение
natrij	натрий
hormon	гормон
dječji	детская
cigla	кирпич
zahvat	рукоятка
srednjovjekovni	средневековый
porculan	фарфор
uhvaćen	захваченный
pristojan	порядочный
lijevanje	Кастинг
preveo	переведенный
gospođa	Донна
ratnik	воин
kabina	кабина
skeniranje	сканирование
polo	поло
kopiranje	копирование
rog	рог
novinarstvo	журналистика
žaba	лягушка
gramatika	грамматика
namjera	намерение
gume	шины
poduzeti	проведены
opasnost	опасность
epizoda	эпизоды
kružni	круговой
bijes	гнев
ilustracije	иллюстрации
šanse	шансы
sreća	счастье
bizaran	эксцентричный
ur	ур
voće	фрукты
identifikator	идентификатор
vrpca	лента
izračuni	вычисления
jPEG	JPEG
pokretanje	запускать
spretan	удобный
razmjena	замена
oslobođen	освобожденный
usjevi	культуры
smanjuje	уменьшает
ostvariti	осуществляется
geometrija	геометрия
utisak	впечатление
ceh	гильдия
korelacija	корреляция
sim	сим
živčani	нервное
miris	аромат
replika	копия
pleme	племя
obrta	сделки
divan	превосходный
osloboditi	избавиться
trojstvo	Троица
rukovati	обрабатываются
legende	легенды
uspon	бум
smiriti	спокойный
prvaci	чемпионы
podovi	этажей
izbor	выборы
uspoređivanje	Сравнение
govori	говорит
strukovno	профессиональное
ljekarne	аптеки
ln	пер
valjak	ролик
serija	партия
organizirati	организовать
poštovati	оценили
mijenjati	изменять
rubovi	края
miješanje	смешивание
ručke	ручки
sklad	гармония
razlikuje	выдающийся
astma	астма
pretpostavke	допущения
regulirano	регулируется
trokut	треугольник
ispraviti	изменить
predviđa	ожидаемый
istočnjački	восточный
nagrada	награда
vodik	водород
usporedivo	сравнимый
pristalica	адвокат
zbunjenost	путаница
ulazi	входные
jamstva	гарантии
genom	геном
medalja	медаль
treneri	тренеры
posuđe	суд
luka	гавань
eko	эко
ranjiv	уязвимый
urediti	организовать
umjetnički	художественный
počasti	почести
ogleda	отраженный
ujedinjen	унифицированный
vrsta	разводить
detektor	детектор
zanemarena	игнорируются
precizan	точный
ocjenjivanje	оценки
usna	губа
okupiti	собирать
formiranje	формирование
novinari	журналисты
blagi	незначительный
posredan	косвенный
među	среди
temelji	устои
horizont	горизонт
nu	ню
duboko	глубоко
pasiva	обязательства
nagrade	призы
smanjen	снизилась
opisujući	описывающее
optika	оптика
progoniti	преследовать
munja	молния
ou	ОУ
citati	цитаты
inspektor	инспектор
zmija	змея
podsjetnik	напоминание
tražili	поиск
ravnice	равнины
uvidi	понимание
sposobnosti	способности
pokrenut	начатый
karaoke	караоке
zamka	ловушка
usamljen	Одинокий
ve	ве
promatrati	наблюдать
spremnici	контейнеры
stavovi	отношения
bobica	ягода
ovratnik	воротник
integrirati	интегрировать
sociologija	социология
izlošci	экспонаты
umire	умирает
terasa	терраса
bakterija	бактерии
treba	должен
ukusno	вкусно
tradicija	традиции
konačan	конечный
šalje	посылает
trajan	прочный
saveznički	союзный
vlaga	влажность
transformirati	преобразование
brojač	таймер
tablete	таблетки
dobivši	полученный
nastavnici	воспитатели
povrće	овощной
stih	стих
nezavisno	независимо
natjecatelji	конкуренты
raketa	ракета
aye	да
metak	пуля
kule	башни
vidljivost	видимость
širina	широта
svijest	сознание
tumor	опухоль
ružan	уродливый
depoziti	депозиты
ljubavnica	госпожа
susret	столкновение
vata	Вт
četrdeset	сорок
cijevi	трубы
pokušaj	попытка
svećenik	священник
analitičari	аналитики
čekić	молоток
invazija	вторжение
trkač	бегун
redovi	строки
davati	вводить
pojam	понятие
pravopis	написание
Arktik	Арктический
nagrade	награды
ispod	под
ojačati	укреплять
braniti	защищать
infracrveni	инфракрасный
sedmi	седьмой
trbuh	живот
agresivan	агрессивный
Oglasi	объявления
četvrtine	помещение
ukraden	похищенный
određuje	определяет
skulptura	скульптура
poli	поли
uši	уши
šaka	кулак
neo	нео
motivacija	мотивация
putnici	пассажиров
dosljedno	последовательно
višak	избыток
kopati	копать
taksi	такси
zahvalnost	признательность
om	ом
ograničenje	ограничение
gitare	гитары
suština	сущность
moćan	могущественный
čovječanstvo	человечество
transkripcija	транскрипция
komplikacije	осложнения
znanstvenici	ученые
galaksija	галактика
brižan	заботливая
zavjet	завещание
dominantan	доминирующий
trbuh	желудок
djelimično	частично
umanjiti	минимизировать
redovima	ряды
debi	дебют
generacije	поколения
turniri	турниры
poreći	Отрицать
anatomija	анатомия
slušalice	наушники
frakcija	доля
trio	трио
postupak	судопроизводство
kocka	куб
nedostaci	дефекты
nesigurnost	неопределенность
kvar	сломать
riješiti	решен
cjepivo	вакцина
sudbina	судьба
rezervacije	бронирование
Republikanci	республиканцы
džungla	джунгли
Zen	Дзэн
dis	дис
proricanje	прогнозирование
ekološki	экологический
ovalan	овальный
podrazumijeva	подразумевает
ser	сер
procjena	оценка
vjerojatnost	перспектива
geografski	географический
donor	донор
napetost	напряженность
smeće	мусор
oblika	формы
red	ярус
grof	граф
zavičaj	Родина
prvenstvo	чемпионаты
pasmine	породы
diskoteka	дискотека
aus	AUS
dorada	отделка
emocije	эмоции
vječan	вечный
rotacija	вращение
Nam	Нама
produktivan	продуктивный
bulevar	бульвар
svinja	свинья
metrički	метрический
kazne	штрафы
raznolik	разнообразный
grande	Гранди
glumica	актриса
dodijeliti	назначать
smjestiti	вмещать
tigrovi	тигры
sela	деревни
hlad	тень
pripjev	хор
ritam	ритм
broj	цифра
simfonija	симфония
naglo	внезапно
prihvaćanjem	принимающий
bazeni	бассейны
lirski	лирический
izolacija	изоляция
brzine	скорость
neprekidan	устойчивый
uskladiti	соответствие
približan	приближенный
uže	веревка
racionalan	рациональный
programer	программист
borci	боевики
naslijedio	унаследованный
nepotpun	неполный
vokal	вокал
fontana	фонтан
legitiman	законный
biografije	биографии
istraživač	следователь
tužitelj	истец
nježan	нежный
dostojan	достойный
arhitekti	архитекторы
sveci	святые
poduzetnik	предприниматель
nosi	осуществляет
dvojac	дуэт
pretjeran	чрезмерное
štedi	экономит
smatrati	рассматривать
vrijednost	оценка
neočekivan	неожиданный
magla	туман
svojstvo	характеристика
lobi	лобби
navedeno	изложены
ogroman	огромный
karma	карма
sastojati	состоять
kraljice	Квинс
akademici	ученые
plemena	племена
razlika	различие
opasnosti	опасность
izuzeće	освобождение
stanar	арендатор
održivost	устойчивость
tetoviranje	тату
algebra	алгебра
sjene	тени
glup	глупый
slobodno	свободно
blag	мягкий
krzno	мех
spremno	легко
pripadanje	присоединение
ograda	забор
beskonačan	бесконечный
klan	клан
revolucionar	революционер
narukvice	браслеты
lijek	средство
disanje	дыхание
kratko	кратко
debljina	толщина
grafički	графический
genije	гениальность
raspravlja	обсуждение
borac	истребитель
značajan	значимым
prilagođen	адаптированный
imanja	усадеб
tepih	коврик
demokrat	демократ
varoš	район
održava	поддерживает
ke	ка
zadržan	сохраняется
mramor	мрамор
dem	дем
meditacija	медитация
mikrofon	микрофон
Kombinirajući	объединение
divovi	гиганты
organiziranje	организация
memorandum	меморандум
šunka	ветчина
riješen	решена
plima	волна
pregrada	раздел
nevidljiv	невидимый
konzole	консоли
magnet	магнит
prijevodi	переводы
jaguar	ягуар
roba	товар
kilometara	километров
jamstva	гарантии
gotika	готика
cilindar	цилиндр
vještica	ведьма
mužjak	доллар
Neprijatelji	враги
savjetovanje	консультирование
uživanje	наслаждаясь
patrola	патруль
miris	запах
karneval	карнавал
grubo	грубо
naljepnica	наклейка
obećanja	обещания
greben	риф
podijeliti	делить
uzastopni	последовательный
bon	бон
prikazi	представления
chan	чан
pjesme	мелодии
mas	Рождество
fraze	фразы
kai	кай
poluotok	полуостров
dosadan	скучный
dom	дом
govori	речи
doseže	достигает
shema	схема
katalozi	каталоги
ministarstva	министерства
parlamentarni	парламентский
prefiks	префикс
Savannah	саванна
barel	бочка
živac	нерв
dans	данс
planeti	планеты
deficit	дефицит
obnoviti	возобновлять
spojen	соединенный
krugovi	схемы
tekstura	текстура
priznati	признавать
šator	палатка
identificira	определяет
kvalifikacija	квалификация
brave	замки
minijatura	миниатюрный
eura	евро
pirati	пираты
antena	антенна
Sokol	ястреб
posljedica	следствие
sistematski	систематическая
percipiraju	воспринимается
podrijetlo	происхождения
zaposlen	наемный
šminka	составить
UI	щ
utezi	веса
geološki	геологический
trajan	прочный
zao	злой
uvodi	вводит
gurnula	толкнул
ro	ро
nagib	скат
pjesnik	поэт
zavjera	заговор
teologija	теология
nokti	ногти
evidentan	очевидный
vožnje	аттракционы
ep	эпический
organizator	организатор
alergija	аллергия
sake	ради
kombinacije	комбинации
prethodnih	предшествующий
zasluga	заслуга
enzim	фермент
zrakoplovi	самолеты
diskovi	диски
pojačalo	усилитель
proizvoljan	произвольный
istaknut	видный
sans	без
gradi	строит
kontakt	связаться
vratilo	вал
mršav	опираться
poneki	случайный
inovacije	инновации
pregleda	рассмотрение
panika	паника
državljanstvo	гражданство
izgovor	оправдание
reforme	реформы
luk	лук
sendvič	сэндвич
alt	альт
hijerarhija	иерархия
napušten	заброшенный
krugovi	круги
otkucaja	биения
veseo	веселый
kult	культ
crtica	тир
pasivno	пассивный
cijenjena	ценный
kavez	клетка
hrabrost	мужество
visina	высота
krug	круг
iskorištenje	использование
pića	напитки
ping	пинг
zabavan	развлекательный
preduvjet	предпосылка
granica	граница
izbjeglice	беженцы
vitezovi	рыцари
hipoteza	гипотеза
lijekovi	медикаменты
promijenjen	изменено
doktrina	учение
lijep	сценический
poboljšanja	улучшения
križanje	пересечение
šivanje	шитье
kolektori	коллекторы
priznat	признанное
bijes	ярость
prix	Приза
astrologija	астрология
savjetnici	консультанты
paviljon	павильон
taktika	тактика
naknadni	дополнительный
talentirani	талантливый
jastuk	подушка
širenje	распространение
provincija	провинция
ukrasti	украсть
parcela	пакет
učestalost	падение
strahovi	боится
predvidjeti	прогнозировать
aroma	аромат
gladan	голодный
metalik	металлический
interferencija	интерференция
ratnici	воины
atmosferski	атмосферный
halo	гало
roditeljski	родительский
upućuje	ссылка
štrajkovi	забастовки
mrav	муравей
prijedlog	предложение
pogodan	склонный
rješavati	дело
trgovac	трейдер
bačen	выброшены
kriterij	критерий
Bedž	значок
civilizacija	цивилизация
vrijes	вереск
ogroman	огромный
obavlja	выполняет
carstvo	область
ispravljeno	исправленный
kaciga	шлем
naišao	встречается
cunami	цунами
učenjak	ученый
okružen	окруженный
geologija	геология
stvorenja	существа
izbrisan	очищается
ostvariti	выполнять
kutovi	углы
vegetarijanac	вегетарианец
kvasac	дрожжи
korak	па
istražuju	исследовалась
ambasador	посол
premazan	покрытый
sudbina	гибель
rutine	подпрограммы
bića	существа
oslanjanje	опора
mit	миф
potok	ручей
fu	марихуана
fenomen	явление
ansambl	ансамбль
osiguran	уверенный
svjestan	сознательный
naglasak	акцент
supruge	жены
iskoristiti	использовать
zalog	залог
vampir	вампир
pristanište	док
organizirani	организованная
glazbenik	музыкант
ograničavajući	ограничения
obnovljena	восстановлен
savjet	намек
oklop	броня
napomena	замечание
desetine	множество
varira	меняется
rasuđivanje	рассуждения
čuvari	гвардия
otvori	отверстия
zamjena	замена
istraživač	Исследователь
vijeća	советы
zanimanja	профессий
priznao	признанный
svinjetina	свинина
zu	цу
ravnoteža	равновесие
cijevi	трубы
vikendice	коттеджи
sjediniti	сливаться
privilegija	привилегия
razvija	развивается
šasija	шасси
procjena	оценка
staja	сарай
mraz	мороз
ustanove	институты
kalup	плесень
dama	дама
jahta	яхта
voli	предпочитает
bušenje	бурение
biljka	трава
kršenje	нарушение
kit	кит
putnik	путешественник
izdvajanja	ассигнования
sumnja	подозреваемый
rajčice	помидоры
instruktori	инструкторы
moment	импульс
peraje	плавник
pastor	пастор
blato	грязи
smaragd	изумруд
raste	растет
rasprava	тракт
ul	уль
balet	балет
novinar	журналист
religije	религии
češnjak	чеснок
sjaj	блеск
Eksplozija	взрыв
gaćice	трусы
potpisi	подписи
ozon	озон
discipline	дисциплины
casa	Каса
razgovori	разговоры
radio	радио
tarifa	тариф
pojednostavljen	упрощенный
mišići	мышцы
brz	быстрый
vagina	влагалище
šampanjac	шампанское
devijacija	отклонение
samba	самба
zaposliti	использовать
pingvin	пингвин
čaroban	волшебный
utjecaji	влияет
inspekcije	инспекции
navodnjavanje	орошение
čudo	чудо
hidraulički	гидравлический
prodiranje	проникновение
rana	рана
ljepotica	красавица
Rosa	Роза
osuda	убеждение
lijen	ленивый
osobine	качества
oci	отцы
punjenje	зарядка
važnije	важно
tanka	маленькая
aparat	устройство
teren	местность
objašnjavajući	объясняя
trake	полоски
imenovanje	назначение
empirijska	эмпирический
crv	червь
zavisnost	зависимость
diskretna	дискретный
početnik	начинающий
poklopac	крышка
seksualnost	сексуальность
safir	сапфир
povlastice	привилегии
specijaliziran	специализация
obilježava	маркировка
šerif	шериф
odbijeno	отказался
špijuni	шпионы
motocikli	мотоциклы
izabrati	избранные
autoceste	шоссе
koncentrat	концентрат
intiman	интимный
molekule	молекулы
kola	туры
hladnjak	холодильник
intervali	интервалы
rečenice	предложения
uništenje	истребление
letak	листовка
grašak	горох
doziranje	дозировка
varijacija	дисперсия
navigator	навигатор
igla	игла
kupke	баня
kočnice	тормоза
og	ог
ko	ко
posjeduje	владеет
sudbina	судьба
krajolici	пейзажи
računanje	вычисление
sijeno	сено
spasenje	спасение
predviđanja	прогнозы
učenici	учащихся
znak	знак
cinkov	цинк
žrtva	жертва
azila	искатели
guru	гуру
prilagođen	подходящий
numerički	числовой
antropologija	антропология
car	император
grad	град
remenje	ремни
crnci	негры
obrazovan	образованный
ponosno	гордо
nužnost	необходимость
krivulje	кривые
obilazak	туризм
tjeme	вершина
rajčica	помидор
putovanja	путешествия
blijed	бледный
funkcioniranje	функционирование
ekonomija	экономики
poduzeti	предпринимать
proglasiti	объявлять
ventili	клапаны
praznine	пробелы
dostignuća	достижения
suza	слеза
uči	учит
nula	ноль
stranac	незнакомец
gnijezdo	гнездо
sud	суд
vladao	правил
mirovine	пенсии
molitve	молитвы
policajac	полицейский
adolescent	подросток
nominacije	номинации
banana	банан
uvodni	вводный
rezervoar	резервуар
pojavljivanje	вхождение
idol	идол
krvav	кровавый
podsjetiti	напоминать
šarmantan	обаятельный
zub	зуб
ugledan	уважаемый
ostaje	остается
afera	дело
ograničiti	ограничивать
mine	мины
portreti	портреты
tumačiti	интерпретированы
procjene	оценки
eliminacija	устранение
metara	метры
hipotetski	гипотетический
helikopter	вертолет
olovka	карандаш
izvođač	исполнитель
provizije	комиссии
sfera	сфера
mahovina	мох
omjeri	коэффициенты
sloga	созвучие
diplomirao	закончил
potvrđen	одобрил
iznenađujuće	удивительный
koplje	копье
ljestve	лестница
pluta	пробка
senatori	сенаторы
krvarenje	кровотечение
karakterizacija	характеристика
vjerojatnost	вероятность
staze	полосы
osnove	основы
kontaminacija	загрязнение
kupola	купол
blagosloviti	благословить
Pregovaranje	Переговоры
vrh	гребень
protivnici	соперники
trijumf	триумф
nominiran	номинирована
zavarivanje	сварка
orgazam	оргазм
legura	сплав
parcele	участки
nježno	осторожно
zaključavanje	блокировка
kontroverzno	спорный
neriješeno	рисует
hladnjak	холодильник
noževi	лезвия
petlje	петли
udar	волна
trauma	травма
oglas	объявление
obrambeni	оборонительный
zabranjen	запрещено
vanilija	ваниль
programera	программисты
prati	контролируемый
instalacije	сооружения
duše	души
motiviran	мотивировано
glup	тупой
šupalj	полый
svod	свод
žlijeb	паз
otkrivanje	откровение
potjera	преследование
delegacija	делегация
žice	провода
rječnici	словари
prozirnost	прозрачность
orbita	орбита
valute	валюты
Niger	Нигер
namještanje	позиционирование
kolonija	колония
top	пушка
cirkus	цирк
unaprijeđen	способствовало
pastrva	форель
podvig	подвиг
privremeno	временно
kuhan	приготовленный
prenositi	передавать
frekvencije	частоты
razmišljanje	размышления
glad	голод
općina	муниципалитет
detektiv	детектив
cement	цемент
doživljava	испытывают
kamin	камин
odobrenje	поддержка
tekstil	текстиль
raketa	ракета
psihijatrija	психиатрия
asistencija	помогает
revizor	аудитор
violina	скрипка
prorok	пророк
oksid	окись
veličanstven	великолепный
brzo	быстро
prilagodba	приспособление
štetan	вредный
seksualno	сексуально
prilog	ограда
glukoza	глюкоза
norma	норма
reprodukcija	воспроизведение
kornjača	черепаха
udaljenosti	расстояния
apsorpcija	поглощение
blaga	сокровища
fosil	ископаемое
Loše	плохо
komunist	коммунист
poduzetnici	предприниматели
roboti	роботы
prekršaj	фол
bioraznolikosti	биоразнообразия
uzbuđenje	волнение
glagolski	словесный
morima	моря
misteriozan	загадочный
novost	новинка
pločice	плитка
bibliotekar	библиотекарь
uključen	переключился
ru	RU
poza	поза
grama	граммов
terapeut	Терапевт
proračuni	бюджеты
Jarac	козел
učiniti	оказывать
ploviti	паруса
povjerenici	комиссары
gust	плотный
hrabar	Храбрый
prosljeđivanje	пересылка
grozan	ужасный
zrakoplov	самолет
organizmi	микроорганизмы
teleskop	телескоп
azbest	асбест
napredak	продвижение
vrba	ива
nastavlja	резюме
postojala	существовавший
generatori	генераторы
generira	генерирует
krumpir	картофель
temeljita	тщательный
receptori	рецепторы
optimalno	оптимальный
stvorenje	существо
usamljen	одинокий
fin	тонкий
pruge	полосы
firmware	прошивка
pastir	пасти
kolijevka	колыбель
kancelar	канцлер
brašno	мука
polemika	полемика
legendaran	легендарный
zbor	хор
izbjegavanje	избегая
lijepo	красиво
očekuje	надеется
skakanje	прыжки
tkanine	ткань
polimer	полимер
higijena	гигиена
vrlina	добродетель
kirurzi	хирурги
mandat	мандат
zbirka	тело
terminologija	терминология
gospodin	джентльмен
osuđen	осужденный
mlaznice	струи
indeksi	индексы
qui	Квай
prijeteći	угрожающий
aktivisti	активисты
zatvorenik	заключенный
potiče	призывает
sklopljen	собранный
terminali	терминалы
Sirovi	сырой
ispituje	осматривает
viking	викинг
počistiti	уборка
uvjetna	условный
napadnut	атакован
stigne	прибывает
prevoditelj	переводчик
automobili	автомобили
traktor	трактор
kontinent	континент
cijene	тарифы
dužina	долгота
nadao	надеялся
umetanje	вставка
ograničenje	ограничение
jačanje	укрепление
želeći	желающих
izolacija	изоляция
prekršaj	нарушение
savijen	изогнутый
subjektivan	субъективный
čudovišta	монстры
azil	убежище
ulog	доля
koktel	коктейль
sorte	сорта
Otrov	яд
dominira	доминировал
skup	дорогостоящий
derivati	производные
sprječava	предотвращает
puška	винтовка
rasizam	расизм
protumačiti	интерпретировать
sporazum	согласие
skroman	скромный
igračima	геймеров
sortiranje	сортировка
veza	связь
žarulje	луковицы
turisti	туристы
ponašanja	поведения
razjasniti	прояснить
struk	Талия
pripisuje	приписаны
sova	сова
kristali	кристаллы
prelazi	превышает
dopunski	дополнительный
bitke	сражения
gorak	горький
memorandum	меморандум
zmajevi	драконы
buka	шум
nevjerojatno	невероятно
delegati	делегаты
psihijatrijski	психиатрический
tinejdžeri	подростков
dvorište	двор
predsjednici	президенты
odstupiti	отходить
izričito	специально
ljiljan	Лили
nadzor	надзор
smola	смола
saveznici	союзники
očuvan	сохраняется
prešao	пересекла
uzlazni	Восходящий
nazivni	номинальный
raspad	распад
kvarcni	кварц
registri	регистры
osmi	восьмой
odobren	уполномоченный
poboljšava	улучшает
zagovara	адвокаты
pojave	явления
nagib	наклон
granit	гранит
mase	массы
atletičar	спортсмен
franak	франк
sličnost	сходство
curenje	утечка
savjetnik	консультант
knjižica	буклет
očekujući	ожидая
promet	оборот
urin	моча
ručnik	полотенце
đumbir	имбирь
kromosom	хромосома
als	ALS
muhe	летит
nadležnost	компетентность
plač	плач
amateri	любители
dizalica	кран
istražuje	расследование
pokvaren	гнилой
navika	привычка
čast	честь
štiti	защищает
iris	Ирис
upravlja	управляет
erozija	эрозия
stolar	столяр
kan	хан
nedovoljan	недостаточное
formuliranje	формулировка
pametan	умная
gospodari	лорды
ugodna	приятный
srp	полумесяц
šezdeset	шестьдесят
koncentriran	концентрированный
razlikovati	выделить
ei	й
projekcije	прогнозы
iskra	искра
osiguranje	обеспечение
staza	путь
detektori	детекторы
šiljak	колос
sastojak	ингредиент
zavjesa	занавес
opisana	раскрытый
taktički	тактический
piloti	пилоты
ekspedicija	экспедиция
operativan	оперативный
humor	юмор
mol	моль
otisak	отпечаток
pomažući	содействие
mana	дефект
slabo	плохо
Božica	богиня
promatrači	наблюдателей
magneti	магниты
formula	формулы
prostran	просторный
tvrdi	утверждает
tla	почвы
organi	органы
Det	йе
odanost	лояльность
vjeran	верный
prekršaj	преступление
litij	литий
skok	прыжок
osnivanje	учредительный
labud	лебедь
sjetva	насаждение
savez	завет
arheologija	археология
mornar	матрос
brige	заботы
svetilište	святилище
kip	статуя
citat	цитата
većim	майоров
manipulacija	манипуляция
zvona	колокольчики
toksičnost	токсичность
odašiljač	передатчик
četvrti	окрестности
trofej	трофей
emocija	эмоция
znamenitosti	Достопримечательности
uniforme	униформа
ranjen	раненый
derivat	производное
stanovanje	размещение
doze	дозы
obrazovati	воспитывать
predrasuda	предубеждение
tehničari	техники
vjerojatan	вероятный
izdavanje	выдача
ukras	украшение
državljani	граждане
trojanski	троянский
asistenti	ассистенты
savjetnik	консультант
donesen	принятый
nestabilan	неустойчивый
pozvao	настоятельно
odražavajući	отражающий
dobivanjem	получение
konačan	окончательный
putovao	путешествовал
prilagoditi	адаптироваться
pristupanje	присоединение
regulator	регулятор
goriva	топливо
soja	соя
uredan	аккуратный
imenovanje	именование
krma	кормовой
izrađen	проработаны
idiot	идиот
sastoji	состоит
vanzemaljci	инопланетяне
izmjene	правки
gavran	вороной
stan	жилье
simboličan	символический
kutovi	углы
pritisci	давление
Venera	Венера
plamen	огонь
primitivan	примитивный
čarapa	чулок
ekosustav	экосистема
dvorane	залы
jednostavnost	простота
demon	демон
dobrodošla	приветствовал
notacija	обозначение
tetka	тетка
vrana	ворона
semantički	семантический
ukinut	прекращено
odlučuje	решает
globalizacija	глобализация
magaraca	ослы
kompas	компас
razvio	эволюционировали
pješaštvo	пехота
slavan	прославленный
hodnik	коридор
filozofski	философский
opravdanje	обоснование
prazan	вакантный
popravljanje	фиксация
gram	грамм
skrivanje	прячется
boja	краситель
abeceda	алфавит
očišćeni	очищенный
poštovan	заслуженный
optički	оптический
telefoni	телефоны
dnevnici	дневников
tuga	горе
znoj	пот
dupin	дельфин
čuda	чудеса
ventilacija	вентиляция
maske	маски
poprsje	бюст
drvored	аллея
putevi	путей
telegraf	телеграф
spomenik	памятник
formalno	формально
rosa	роса
povučen	отозваны
rasprave	дебаты
identiteti	тождества
nedostatak	дефицит
sedlo	седло
malarija	малярия
odan	верный
sklonost	тенденция
koristi	используется
ein	Эйн
dvogled	бинокль
pokrenuti	инициировать
potpuno	чисто
živ	яркий
navodi	утверждения
odgovara	соответствует
demon	демон
slavni	знаменитый
lovci	охотники
djelovao	действовал
koeficijent	коэффициент
lubanja	череп
nastavljanje	продолжение
sluga	служащий
Sokol	сокол
zajednički	совместно
izbjegavati	избегать
objašnjenja	объяснения
obnovljen	обновленный
kritičar	критик
sediment	отстой
trgovi	квадраты
kombija	фургоны
konus	конус
preživio	переживший
rasprostranjenost	распространенность
fragment	фрагмент
obvezuje	совершает
kobra	кобра
bacio	бросил
hoc	специальная
izvođači	исполнители
desert	Десерт
disertacija	диссертация
deveti	девятый
entuzijazam	энтузиазм
slavlja	празднования
guverneri	губернаторы
atomi	атомы
tkiva	тканей
rampa	скат
lijepo	мило
della	делла
dominacija	доминирование
akordi	аккорды
poremećaj	нарушение
molekula	молекула
