von	of
zu	että
im	sisään
zum	varten
ist	on
auf	päällä
Das	että
durch	mennessä
Dies	Tämä
mit	kanssa
ich	minä
Sie	sinä
es	se
oder	tai
Sein	olla
sind	olemme
beim	at
alle	kaikki
haben	omistaa
Neu	Uusi
wir	me
werden	tahtoa
Zuhause	Koti
uns	meille
Über	noin
ob	jos
Seite	sivu
meine	minun
hat	on
Suche	Hae
frei	vapaa
aber	mutta
unser	meidän
ein	yksi
andere	muut
machen	tehdä
Information	tiedot
Zeit	aika
er	hän
welche	joka
ihr	heidän
Nachrichten	uutiset
benutzen	käyttää
Dort	siellä
sehen	nähdä
damit	niin
Wer	Kuka
Netz	verkko
ebenfalls	myös
bekommen	saada
pm	pm
Aussicht	näkymä
c	C
e	e
zuerst	ensimmäinen
gewesen	ollut
würde	olisi
wurden	olivat
s	s
mögen	Kuten
x	x
als	kuin
finden	löytö
Preis	hinta
zurück	takaisin
oben	ylin
Menschen	ihmiset
hätten	oli
Liste	lista
Name	nimi
gerade	vain
Jahr	vuosi
Tag	päivä
in	osaksi
zwei	kaksi
Gesundheit	terveys
n	n
Re	re
benutzt	käytetty
gehen	mennä
b	b
letzte	kestää
machen	tehdä
Sie	niitä
sollte	pitäisi
Produkt	tuote
System	järjestelmä
Post	lähettää
ihr	hänen
Stadt	kaupunki
t	T
Politik	politiikka
Nummer	määrä
Unterstützung	tuki
Botschaft	viesti
nach	jälkeen
dann	sitten
Januar	tammikuu
gut	hyvä
d	d
woher	missä
Info	tiedot
Rechte	oikeudet
Bücher	kirjat
hoch	korkea
Schule	koulu
m	m
jeder	kukin
Links	linkit
sie	hän
Jahre	vuotta
Auftrag	tilata
sehr	erittäin
Buch	kirja
Artikel	kohdetta
Unternehmen	yhtiö
r	R
lesen	lukea
Gruppe	ryhmä
Sex	sukupuoli
viele	monet
Benutzer	käyttäjä
de	de
einstellen	sarja
Allgemeines	yleinen
Forschung	tutkimus
Universität	yliopisto
Januar	tammikuu
Post	posti
voll	koko
Bewertungen	arvostelut
Programm	ohjelmoida
kennt	tietää
Spiele	pelit
Weg	tapa
Tage	päivää
p	p
Teil	osa
könnte	voisi
groß	loistava
vereinigt	yhdistynyt
echt	todellinen
f	f
International	kansainvälinen
Center	keskusta
Reise	matkustaa
Bemerkungen	kommentit
gemacht	tehty
Entwicklung	kehitys
Bericht	raportti
Mitglied	jäsen
Einzelheiten	yksityiskohdat
Linie	linja
Bedingungen	ehdot
Vor	ennen
Hotels	hotellit
tat	teki
senden	lähettää
Recht	oikea
Art	tyyppi
lokal	paikallinen
jene	nuo
Ergebnisse	tulokset
Büro	toimisto
National	kansallinen
Auto	auto
Design	design
nehmen	ottaa
Gesendet	lähetetty
Adresse	osoite
Gemeinschaft	Yhteisö
innerhalb	sisällä
Zustände	valtiot
wollen	haluta
Telefon	puhelin
DVD	DVD
Gegenstand	aihe
zwischen	välillä
Forum	foorumi
Familie	perhe
l	l
lange	pitkä
w	w
Show	show
O	O
sogar	jopa
schwarz	musta
Besondere	erityinen
Index	indeksi
Sein	ollessa
Frau	naiset
viel	paljon
Schild	merkki
Datei	tiedosto
Verknüpfung	linkki
öffnen	avata
Süd	etelä
Fall	tapaus
Projekt	projekti
Seiten	sivut
Ausführung	versio
Sektion	jakso
besitzen	oma
Haus	talo
Sicherheit	turvallisuus
G	g
Bezirk	lääni
amerikanisch	amerikkalainen
Foto	kuva
Spiel	peli
Mitglieder	jäsenet
Leistung	teho
Netzwerk	verkko
Computer	tietokone
Systeme	järjestelmät
drei	kolme
Ort	paikka
Ende	pää
h	h
ihm	häntä
pro	kohti
Zugriff	pääsy
denken	ajatella
Norden	pohjoinen
Ressourcen	voimavarat
Strom	nykyinen
groß	iso
Medien	tiedotusvälineet
Recht	laki
Steuerung	ohjaus
Wasser	vesi
Geschichte	historia
Größe	koko
persönlich	henkilökohtainen
führen	opas
Geschäft	myymälä
Verzeichnis	hakemisto
Veränderung	muuttaa
Weiß	valkoinen
Text	teksti
klein	pieni
Wertung	luokitus
Bewertung	nopeus
Regierung	hallitus
Kinder	lapset
Rückkehr	palata
Studenten	opiskelijoille
v	v
Konto	tili
mal	ajat
Niveau	taso
Digital	digitaalinen
Profil	profiili
Bisherige	Edellinen
bilden	muoto
Veranstaltungen	Tapahtumat
Liebe	rakkaus
alt	vanha
John	Johannes
Main	tärkein
Anruf	puhelu
Bild	kuva
Abteilung	osasto
Titel	otsikko
nicht	ei
k	K
y	y
Versicherung	vakuutus
soll	on
Eigentum	omaisuus
Klasse	luokka
CD	CD
Qualität	laatu
jeden	joka
Auflistung	listaus
Inhalt	pitoisuus
Land	maa
wenig	vähän
Werkzeuge	Työkalut
niedrig	matala
Antworten	Vastaa
Kunde	asiakas
Dezember	joulukuu
vergleichen	vertailla
Filme	elokuvat
Hochschule	college
Wert	arvo
Artikel	artikla
Mann	mies
Arbeitsplätze	työpaikkaa
j	j
Lebensmittel	ruoka
Autor	kirjailija
anders	eri
u	U
lernen	oppia
Verkauf	myynti
drucken	Tulosta
Kurs	kurssi
Job	Job
Zimmer	huone
Stock	kalusto
Ausbildung	koulutus
auch	liian
Kredit	luotto
Punkt	kohta
Wissenschaft	tiede
Männer	miehet
Kategorien	luokat
Westen	länsi
aussehen	Katso
Englisch	Englanti
Mannschaft	tiimi
Gut	omaisuus
Box	laatikko
Bedingungen	olosuhteet
Fotos	Valokuvat
Fröhlich	homo
Faden	lanka
Kategorie	kategoria
Hinweis	Huomautus
Leben	elää
groß	suuri
Galerie	galleria
Tabelle	pöytä
jedoch	kuitenkin
Juni	kesäkuu
Oktober	lokakuu
November	marraskuu
Markt	markkinoida
Bibliothek	kirjasto
Aktion	toiminta
Anfang	alkaa
Serie	sarja
Eigenschaften	ominaisuudet
Luft	ilma
Industrie	ala
planen	suunnitelma
Mensch	ihmisen
Ja	Joo
zweite	toinen
heiß	kuuma
Kosten	kustannus
Film	elokuva
Foren	foorumit
März	maaliskuu
la	la
September	syyskuu
sagen	sanoa
gehen	menossa
medizinisch	lääketieteellinen
Freund	ystävä
Dezember	joulukuu
Server	palvelin
Anwendung	hakemus
Mitarbeiter	henkilöstö
abspielen	pelata
Probleme	kysymykset
April	huhtikuu
Benutzer	käyttäjät
Straße	katu
Thema	aihe
gegen	vastaan
bekam	sai
Blog	blogi
Party	juhla
Zahlung	maksu
Ausrüstung	laitteet
Lassen	antaa
Programme	ohjelmat
legal	oikeudellinen
kürzlich	viimeaikainen
Park	pysäköidä
Handlung	toimia
Problem	ongelma
rot	punainen
geben	antaa
Erinnerung	muisti
Performance	esitys
Sozial	sosiaalinen
q	q
Geschichte	tarina
verkaufen	myydä
Optionen	vaihtoehtoja
Erfahrung	kokea
Schlüssel	avain
Karosserie	ruumis
jung	nuori
wichtig	tärkeä
Feld	ala
wenige	harvat
Osten	itään
Single	yksittäinen
ii	ii
Alter	ikä
Verein	klubi
Beispiel	esimerkki
Mädchen	tytöt
z	z
Straße	tie
Geschenk	lahja
Frage	kysymys
ca	ca
hart	kova
Zahlen	maksaa
vier	neljä
Poker	pokeri
Problem	ongelma
Angebot	alue
Gebäude	rakennus
Verkäufer	myyjä
Gericht	tuomioistuin
Februar	helmikuu
Ergebnis	tulos
Licht	valo
schreiben	kirjoittaa
Krieg	sota
Angebot	tarjous
Blau	sininen
Gruppen	ryhmät
al	ai
einfach	helppo
gegeben	tietty
anfordern	pyyntö
Fax	faksi
China	Kiina
Herstellung	tehdä
Bild	kuva
Bedürfnisse	tarpeisiin
möglich	mahdollinen
Monat	kuukausi
Haupt	suuri
Star	tähti
Zukunft	tulevaisuus
Raum	tila
Ausschuss	komitea
Hand	käsi
Sonne	aurinko
Karten	kortit
London	Lontoo
Treffen	tapaaminen
werden	tulla
Kind	lapsi
behalten	pitää
Porno	porno
Aktie	Jaa
ähnlich	samankaltainen
Garten	puutarha
Schulen	koulut
Million	miljoona
hinzugefügt	lisättyä
Referenz	viite
Firmen	yritykset
Baby	vauva
Lernen	oppiminen
Energie	energia
Lauf	juosta
Lieferung	toimitus
Beliebt	suosittu
Begriff	termi
Film	elokuva
Geschichten	tarinoita
stellen	laittaa
Tagebuch	päiväkirja
Berichte	raporttien
co	co
Versuchen	yrittää
Bilder	kuvien
beachten	ilmoitus
Gott	Jumala
Original	alkuperäinen
Kopf	pää
Radio	radio
Zelle	solu
Rat	neuvosto
enthält	sisältää
Spur	seurata
Diskussion	keskustelu
Archiv	arkisto
Andere	toiset
Zustimmung	sopimus
Format	muoto
Gesellschaft	yhteiskunta
Monate	kuukaudet
Sicherheit	turvallisuus
Freunde	ystävät
sicher	varma
Auflage	painos
Mitteilungen	viestien
Marketing	markkinointi
sagen	kertoa
Verband	yhdistys
bietet	tarjoaa
Spaß	hauska
bereits	jo
Grün	vihreä
Studien	opinnot
schließen	kiinni
verbreitet	yhteinen
Spezifisch	erityinen
mehrere	useat
Leben	elävä
Sammlung	kokoelma
namens	nimeltään
kurz	lyhyt
Kunst	arts
Menge	erä
Fragen	kysyä
begrenzt	rajallinen
Lösungen	ratkaisut
Direktor	johtaja
Strand	ranta
Vergangenheit	menneisyys
natürlich	luonnollinen
Elektronik	elektroniikka
auf	päälle
Zeitraum	aika
Planung	suunnittelu
sagt	sanoo
offiziell	virallinen
beschädigen	maaliskuu
erledigt	tehty
technisch	tekninen
Fenster	ikkuna
Profi	ammattilainen
Region	alue
Insel	saari
Aufzeichnung	ennätys
Direkte	suoraan
Konferenz	konferenssi
Aufzeichnungen	asiakirjat
st	st
Kreis	piiri
Kalender	kalenteri
Kosten	kustannukset
Stil	tyyli
Erklärung	selvitys
Meilen	mailia
Ressource	resurssi
Anwendungen	sovellukset
Dokument	asiakirja
Wort	sana
Werk	teokset
Material	materiaali
Rechnung	laskuttaa
geschrieben	kirjallinen
Regeln	säännöt
Finale	lopullinen
Ding	asia
Center	keskusta
Anforderungen	vaatimuksista
WAHR	TOTTA
Protokoll	minuutit
sonst	muu
Kennzeichen	merkki
Rock	rock
Schlecht	huono
Individuell	yksilö
Plus	plus
Auto	auto
Abdeckung	peite
bearbeiten	muokata
zusammen	yhdessä
Videos	Videot
schnell	nopeasti
Funktion	toiminto
Tatsache	tosiasia
bekommen	saada
global	maailmanlaajuinen
Technik	teknologia
Treffen	tavata
weit	pitkälle
wirtschaftlich	taloudellinen
en	fi
Spieler	pelaaja
Projekte	hankkeet
Menge	määrä
Uhr	katsella
inbegriffen	Sisältää
Gefühl	tuntea
Bank	pankki
Risiko	riski
Angebote	tarjoukset
verschiedene	eri
Wörter	sanat
Produktion	tuotanto
kommerziell	kaupallinen
Gewicht	paino
Herz	sydän
Behandlung	hoito
Punkte	pistettä
Wissen	tuntemus
Zeitschrift	aikakauslehti
Error	virhe
Kamera	kamera
Mädchen	tyttö
Konstruktion	rakentaminen
Spielzeuge	lelut
Eingetragen	kirjattu
Domain	verkkotunnuksen
Methoden	menetelmät
Kapitel	luku
Schutz	suojaus
Politik	politiikkaa
breit	leveä
Schönheit	kauneus
Manager	johtaja
Indien	Intia
Position	asento
genommen	otettu
Sortieren	järjestellä
Inserate	listat
bekannt	tunnettu
Hälfte	puoli
Fälle	tapauksissa
Schritt	vaihe
Ingenieurwesen	tekniikka
einfach	yksinkertainen
schnell	nopea
Lizenz	lisenssi
See	järvi
ganze	koko
jährlich	vuotuinen
veröffentlicht	julkaistu
Kirche	kirkko
Methode	menetelmä
aktiv	aktiivinen
Antwort	vastaus
Zahl	kuva
Materialien	tarvikkeet
genug	tarpeeksi
entworfen	suunnitellut
unter	keskuudessa
Tod	kuolema
Verlust	menetys
Gesicht	kasvot
Marke	brändi
Rabatt	alennus
Auswirkungen	tehosteet
erstellt	luotu
Normen	standardit
Bit	bitti
politisch	poliittinen
Königreich	kuningaskunta
Base	pohja
tun	tekemässä
Darlehen	lainat
Schuhe	kengät
Eintrag	merkintä
bleibe	pysyä
Aufträge	tilaukset
Verfügbarkeit	saatavuus
Zusammenfassung	yhteenveto
Wende	vuoro
Wachstum	kasvu
Agentur	toimisto
König	kuningas
europäisch	eurooppalainen
Aktivität	aktiviteetti
Kopieren	kopio
Western	Läntinen
Macht	pakottaa
Beschäftigung	työllisyys
Bucht	lahti
Fluss	joki
Kommission	komissio
Paket	paketti
gesehen	nähdään
Spieler	pelaajat
Motor	moottori
Hafen	portti
Album	albumi
regional	alueellinen
halt	Stop
gestartet	aloitti
Verwaltung	antaminen
Bar	baari
Institut	instituutti
Ansichten	näkymät
doppelt	kaksinkertainen
Hund	koira
bald	pian
Linien	linjat
elektronisch	elektroninen
Leistungen	hyötyjä
erforderlich	tarvittu
Drucker	kirjoitin
Bedingung	kunto
Wirksam	tehokas
glauben	uskoa
Organisation	organisaatio
bewirken	vaikutus
Verstand	mieli
Auswahl	valinta
Kasino	kasino
pdf	PDF
Tour	kiertue
Kreuz	ylittää
Hoffnung	toivoa
Konzern	yhtiö
Wunsch	toive
Lösung	ratkaisu
reifen	kypsä
Rolle	rooli
Wochen	viikkoa
sicher	tietty
niedriger	alempi
notwendig	välttämätön
Union	liitto
mon	mon
com	com
besonders	tietty
fein	hieno
Stunde	tunnin
Gas	kaasu
Kompetenzen	taidot
sechs	kuusi
Buchse	Puska
Inseln	saaret
Rat	neuvot
Werdegang	ura
Entscheidung	päätös
verlassen	jättää
Vor	pre
enorm	valtava
Frau	nainen
Anlagen	laitteisto
bieten	tarjous
Mitte	keskimmäinen
Kabel	kaapeli
Chancen	mahdollisuudet
Einnahme	ottaen
Werte	arvot
Aufteilung	jako
Kommen	tuleva
Objekt	esine
lesbisch	lesbo
angemessen	sopiva
Maschine	kone
Logo	logo
Länge	pituus
nett	kiva
Ergebnis	pisteet
Statistiken	tilasto
Klient	asiakas
Probe	näyte
Investition	investointi
geschickt	lähetetty
gezeigt	esitetty
Weihnachten	joulu
Kultur	kulttuuri
Blitz	salama
Frau	neiti
Wahl	valinta
Kurse	kurssit
Verbraucher	kuluttaja
Hallo	Moi
fremd	ulkomainen
Künstler	taiteilija
Möbel	huonekalut
Kanal	kanava
Brief	kirje
Modus	tila
Telefone	puhelimet
Ideen	ideoita
Struktur	rakenne
Grad	aste
Vertrag	sopimus
Super	Super
männlich	Uros
Angelegenheit	asia
fast	melkein
gelegen	sijaitsevat
mehrere	moninkertainen
Verteilung	jakelu
Editor	toimittaja
Gasthaus	majatalo
industriell	teollinen
Potenzial	mahdollinen
Lied	laulu
los	los
fallen	pudota
Idee	ajatus
Räume	Huoneet
Kommunikations	viestintä
Sieg	voittaa
primär	ensisijainen
Krebs	syöpä
Zahlen	numerot
Grund	syy
Werkzeug	työkalu
Frühling	kevät
Stiftung	perusta
Antworten	vastaus
Stimme	ääni
Zeitplan	ajoittaa
Unterlagen	asiakirjat
Zweck	tarkoitus
Feature	ominaisuus
Bett	sänky
kommt	tulee
Polizei	Poliisi
unabhängig	itsenäinen
Ansatz	lähestyä
braun	ruskea
physikalisch	fyysinen
Hügel	mäki
Karten	kartat
halt	pitää
Bewertungen	luokitukset
glücklich	onnellinen
Schmied	seppä
entwickelt	kehittyneillä
danken	kiittää
sicher	turvallinen
einzigartig	ainutlaatuinen
Umfrage	tutkimus
vor	ennen
Telefon	puhelin
Sport	Urheilu
bereit	valmis
Tier	eläin
Quellen	lähteet
Population	väestö
pa	pa
regulär	säännöllinen
sichern	turvallinen
Geschäftstätigkeit	toiminnot
einfach	yksinkertaisesti
Beweis	näyttö
Bahnhof	asema
verstehen	ymmärtää
Möglichkeit	vaihtoehto
Tal	laakso
wahrscheinlich	todennäköisesti
Meer	meri
Publikationen	Julkaisut
verbessern	parantaa
Verbindung	yhteys
Herausgeber	kustantaja
Halle	sali
Anti	anti
Netzwerke	verkot
Erde	maa
Eltern	vanhemmat
Auswirkung	vaikutus
Transfer	siirtää
Einführung	esittely
Küche	keittiö
stark	vahva
Hochzeit	häät
Eigenschaften	ominaisuudet
Krankenhaus	sairaala
Boden	maa
Schiff	alus
Unterkunft	majoitus
Krankheit	tauti
Ausgezeichnet	erinomainen
perfekt	täydellinen
Haar	hiukset
Gelegenheit	tilaisuus
Ausrüstung	pakki
klassisch	klassikko
Basis	perusta
Befehl	komento
Städte	kaupungit
ausdrücken	ilmaista
vergeben	myöntää
Entfernung	etäisyys
Baum	puu
Bewertung	arviointi
Mauer	seinä
beteiligt	osallistuva
el	el
extra	ylimääräinen
insbesondere	erityisesti
Budget	talousarvio
Führungen	oppaita
Erfolg	menestys
maximal	enimmäismäärä
ma	äiti
Betrieb	operaatio
bestehende	nykyinen
ganz	melko
ausgewählt	valittu
Junge	poika
Restaurants	ravintolat
schön	kaunis
Warnung	Varoitus
Standorte	sijainnit
Pferd	hevonen
Abstimmung	äänestys
Blumen	kukat
Sterne	tähdet
Listen	luettelot
Inhaber	omistaja
Tiere	eläimet
Wege	tapoja
Sohn	poika
Bereitstellen	tarjoaminen
Regel	sääntö
Gehäuse	kotelo
nimmt	kestää
bringen	tuoda
Katalog	luettelo
max	max
Mutter	äiti
Behörde	auktoriteetti
erzählte	kertoi
Programm	ohjelmoida
beigetreten	liittyi
Eingang	panos
Strategie	strategia
Füße	jalkaa
Agent	agentti
gültig	pätevä
modern	moderni
Senior	vanhempi
sexy	seksikäs
Lehren	opetus
Tür	ovi
großartig	suuri
Versuch	oikeudenkäynti
Einheiten	yksiköt
cool	viileä
normal	normaali
Unternehmen	yritys
Schiffe	laivat
ganz	koko
positiv	positiivinen
Fitness	kunto
Chinesisch	Kiinalainen
Meinung	lausunto
Fußball	jalkapallo
abstrakt	abstrakti
Ausgabe	ulostulo
Mittel	varat
Herr	Herra
wahrscheinlich	todennäköisesti
entwickeln	kehittää
Künstler	Taiteilijat
Alternative	vaihtoehto
Verantwortung	vastuu
Java	Jaava
Gast	vieras
Veröffentlichung	julkaisu
bestehen	kulkea
Verhältnis	suhteet
Vertrauen	luottamus
Transporter	pakettiauto
enthält	sisältää
Mehr	multi
Republik	tasavalta
Gebühren	palkkiot
Komponenten	komponentit
Ferien	loma
Jahrhundert	vuosisata
akademisch	akateeminen
Hilfe	apu
abgeschlossen	valmistunut
Haut	iho
Grafik	grafiikka
indisch	intialainen
Ring	rengas
Klasse	arvosana
Berg	vuori
Organisationen	organisaatioiden
Filter	suodattaa
Platte	paneeli
Fußboden	lattia
Kauf	ostaminen
Spiel	ottelu
vorgeschlagen	ehdotettu
benötigen	vaatia
Jungen	pojat
Morgen	aamu
erlaubt	sallii
Eiweiß	proteiini
Pflanze	kasvi
berichtet	raportoitu
schlagen	osuma
Millimeter	mm
Schwimmbad	pool
Mini	mini
Politik	politiikka
Partner	kumppani
Autoren	kirjoittajat
Bretter	levyt
Fisch	kalastaa
Mitgliedschaft	jäsenyys
Mission	tehtävä
Auge	silmä
Schnur	jono
Sinn	tunne
geändert	muokattu
freigegeben	julkaisi
Bühne	vaihe
intern	sisäinen
geboren	syntynyt
ausführlich	yksityiskohtainen
japanisch	japanilainen
Rennen	rotu
genehmigt	hyväksytty
Ziel	kohde
außer	paitsi
Charakter	merkki
Instandhaltung	ylläpito
Fähigkeit	kyky
ed	toim
vergewaltigen	raiskata
Batterie	akku
Jugend	nuoret
Druck	paine
eingereicht	toimitettu
Schuld	velka
Mittel	keskikokoinen
Fernsehen	televisio
interessiert	kiinnostunut
Ader	ydin
Unterbrechung	tauko
Zwecke	tarkoituksiin
Sets	setit
tanzen	tanssi
Holz	puu
definiert	määritellyt
Papiere	paperit
Auszeichnungen	palkinnot
Gebühr	maksu
Studio	studio
Leser	lukija
Gerät	laite
etabliert	perusti
Antworten	vastauksia
Miete	vuokrata
las	las
dunkel	tumma
extern	ulkoinen
Apfel	omena
le	le
Anleitung	ohjeet
Mindest	min
angeboten	tarjotaan
Theorie	teoria
Löschen	poistaa
Hilfe	apu
visuell	visuaalinen
Gastgeber	isäntä
Vielfalt	lajike
Lehrer	opettajat
Handbuch	manuaalinen
Block	lohko
Fächer	aiheita
Mittel	aineet
Reparatur	korjaus
Messe	oikeudenmukainen
stehlen	teräs
Verstehen	ymmärtäminen
Lieder	lauluja
Fest	kiinteä
falsch	väärä
Anfang	alku
Hände	käsissä
az	az
Paris	Pariisi
wird	saa
Sektor	sektori
Kapazität	kapasiteetti
un	un
Fett	rasva
Vater	isä
elektrisch	sähköinen
sah	näin
Instrumente	välineet
Offizier	upseeri
Treiber	kuljettaja
Unternehmen	yritykset
tot	kuollut
unbekannte	tuntematon
Restaurant	ravintola
Mike	mikrofoni
Ausflug	matka
mi	mi
Arm	huono
Beziehung	yhteys
Arbeitskräfte	työntekijöiden
Frieden	rauha
traditionell	perinteinen
zeigt	osoittavat
kreativ	luova
Küste	rannikko
Vorteil	hyöty
Finanzierung	rahoitus
Geräte	laitteet
Herr	herra
gewähren	myöntää
Unter	sub
Fiktion	kaunokirjallisuus
Uhren	kellot
Karriere	uraa
geht	menee
LED	led
Museum	museo
Ventilator	tuuletin
Transport	kuljetus
interessant	mielenkiintoista
Blogs	blogit
Auswertung	arviointi
ehemalige	entinen
Zone	vyöhyke
Komplex	monimutkainen
th	th
Katze	kissa
sterben	kuolla
vorgeführt	esittelyyn
eben	tasainen
fließen	virtaus
Agenturen	virastojen
Literatur	kirjallisuus
Elternteil	vanhempi
Rahmen	asetus
DR	DR
Rahmen	asteikko
Wirtschaft	talous
hilfreich	hyödyllinen
monatlich	kuukausittain
kritisch	kriittinen
Rahmen	kehys
Musical	musikaali
Definition	määritelmä
Sekretär	sihteeri
Pfad	polku
Chef	päällikkö
gibt	antaa
Pakete	paketit
Detail	yksityiskohta
Gesetze	lait
geändert	muutettu
Start	alkaa
königlich	kuninkaallinen
reinigen	puhdas
Kerl	kaveri
Titel	otsikot
relevant	merkityksellinen
Gerechtigkeit	oikeudenmukaisuus
verbinden	kytkeä
Tasse	kuppi
Korb	kori
angewandt	soveltava
wöchentlich	viikoittain
vol	vol
Installation	asennus
pp	pp
Beachtung	huomio
vorrücken	edetä
überspringen	hyppiä
Diät	ruokavalio
Armee	armeija
Ausrüstung	vaihde
Unterschied	ero
dürfen	sallittu
richtig	oikea
Nation	kansakunta
Verkauf	myynti
viele	paljon
Stück	pala
Blatt	arkki
Feste	yritys
Sieben	seitsemän
Elemente	elementtejä
Spezies	laji
springen	hypätä
Zellen	solut
Modul	moduuli
Urlaubsort	lomakeskus
Zertifikat	todistus
Minister	ministeri
Bewegung	liike
Mode	muoti
Richtungen	ohjeet
Besucher	vierailijat
Dokumentation	dokumentointi
Handel	kaupankäynti
Wald	metsä
Anrufe	puhelut
Berichterstattung	kattavuus
Paar	pari
Angabe	antaminen
Chance	mahdollisuus
Vision	näkemys
Ball	pallo
Ende	pääte
Kunden	asiakkaat
Aktionen	toimet
diskutieren	keskustella
Tor	tavoite
erfolgreich	onnistunut
verkauft	myyty
Wind	tuuli
Gemeinden	yhteisöt
klinisch	kliininen
Lage	tilanne
Märkte	markkinat
Verlagswesen	kustannustoiminta
erscheinen	ilmestyä
Entwicklung	kehittämällä
Leben	elämää
bestimmen	määrittää
Temperatur	lämpötila
Ankündigungen	ilmoitukset
geduldig	potilas
tatsächlich	todellinen
historisch	historiallinen
Stein	kivi
Bob	Bob
Handel	kaupankäynti
Personen	henkilöt
schwer	vaikea
wissenschaftlich	tieteellinen
Satellit	satelliitti
Tests	testit
Dorf	kylä
Konten	tilit
Amateur	amatööri
Ex	entinen
getroffen	tavannut
Schmerzen	kipu
Faktoren	tekijät
Kaffee	kahvi
Käufer	ostaja
Poster	juliste
Kante	reuna
funktional	toiminnallinen
Wurzel	juuri
fi	fi
geschlossen	suljettu
Ferien	juhlapäivät
Rosa	vaaleanpunainen
Balance	saldo
Überwachung	seuranta
Antworten	vastaukset
Schuss	laukaus
Initiale	alkukirjain
Etikette	etiketti
Sekunde	sec
Kanon	kaanon
Liga	liiga
Abfall	jätteet
Minute	minuutti
Bus	bussi
Anbieter	toimittaja
Wörterbuch	sanakirja
Buchhaltung	kirjanpito
Herstellung	valmistus
Abschnitte	osiot
Stuhl	tuoli
Anstrengung	ponnistus
Phase	vaihe
Fantasie	fantasia
po	po
va	va
Professor	professori
Installieren	Asentaa
Hemd	paita
Kleider	vaatteet
Fuß	jalka
Brust	rinta
Techniken	tekniikat
Dollar	dollaria
Religion	uskonto
Genehmigung	lupa
wild	villi
Generation	sukupolvi
Fräulein	neiti
chemisch	kemiallinen
Arzt	lääkäri
Aufgabe	tehtävä
reduzieren	vähentää
gebracht	toi
Übung	liikunta
Fehler	vika
Garantie	takuu
Führer	johtaja
se	SE
Prozesse	prosessit
weich	pehmeä
Treffen	kokoukset
Sekunden	sekuntia
Flug	lento
Kongress	kongressi
Treibstoff	polttoaine
gehen	kävellä
hergestellt	valmistettu
Heilige	pyhimys
Streit	Perustelu
Wettbewerb	kilpailu
Drogen	huumeita
Joint	yhteinen
Prämie	palkkio
frisch	tuore
Figuren	merkkiä
Rechtsanwalt	asianajaja
di	di
Faktor	tekijä
tausende	tuhansia
km	km
Strom	virta
Wohnungen	huoneisto
pflücken	valita
Hören	kuulo
östlich	itäinen
Therapie	terapia
Einträge	merkinnät
unterzeichnet	allekirjoitettu
administrativ	hallinnollinen
ernst	vakava
Grenze	raja
Schritte	askeleet
Geschäfte	kaupat
Knechtschaft	orjuus
del	del
Anstrengungen	pyrkimyksiä
informiert	ilmoitti
ga	ga
Gedanken	ajatuksia
Bach	puro
ft	ft
Menge	määrä
wesentlich	olennainen
Touren	matkat
Belastung	ladata
sofort	heti
Maschinen	koneet
vorgesehen	nimetty
schwer	raskas
bedeckt	katettu
Wiederherstellung	elpyminen
integriert	integroitu
Aufbau	kokoonpano
Schwanz	kukko
Händler	kauppias
umfassend	kattava
Experte	asiantuntija
schützen	suojella
solide	vankka
Präsentation	esittely
wurde	tuli
Orange	oranssi
Beachtung	noudattaminen
Thema	teema
Reich	rikas
Kampagne	kampanja
vs	vs
Gitarre	kitara
finden	havainto
Beispiele	esimerkkejä
Geist	henki
ar	ar
Ansprüche	vaatimukset
Annahme	hyväksyminen
Strategien	strategiat
mo	mo
Angelegenheiten	asioihin
beabsichtigt	tarkoitettu
sa	sa
Tore	tavoitteet
mieten	vuokraus
Wahl	vaalit
vorschlagen	ehdottaa
Ast	haara
Dienen	palvella
Mitgliedsorganisationen	Kumppanit
montieren	asentaa
Latein	Latina
Multimedia	multimedia
verwalten	hoitaa
Ecke	kulma
Rang	arvo
Element	elementti
Geburt	syntymä
Virus	virus
interaktiv	interaktiivinen
Anfragen	pyynnöt
trennen	erillinen
Quartal	neljännes
Verfahren	menettely
Führung	johto
definieren	määritellä
religiös	uskonnollinen
Fakten	tosiasiat
Frühstück	aamiainen
Säule	sarake
Glauben	usko
Kette	ketju
identifizieren	tunnistaa
Avenue	katu
fehlt	puuttuva
Empfehlungen	suosituksia
gerührt	siirretty
erreichen	saavuttaa
Vergleich	vertailu
Moment	hetki
verlängert	laajennettu
Sequenz	jakso
Zoll	tuuma
Attacke	hyökkäys
Zentren	keskuksissa
Öffnung	aukko
Labor	laboratorio
Reservieren	varata
Gamma	gamma
produzieren	tuottaa
Wahrheit	totuus
Zähler	laskuri
Fehler	vika
folgt	seuraa
Dollar	dollari
Lager	leiri
die	des
Filme	elokuvat
Brücke	silta
füllen	täyttää
Bewegung	liike
Drucken	painaminen
Entwurf	luonnos
Diagramm	kartoittaa
gespielt	pelataan
Kontakte	yhteystiedot
Leser	lukijoita
Clubs	risti
wa	wa
Abenteuer	seikkailu
Opfer	uhri
profitieren	voitto
Führung	johtajat
Poster	Julisteet
Institutionen	laitokset
Assistent	avustaja
Variable	muuttuja
dj	dj
Parken	pysäköinti
gestern	eilen
entschlossen	määritetty
Werkstatt	työpaja
Weg	mennyt
Codes	koodit
Arten	Erilaisia
Erweiterung	laajentaminen
Aussagen	lausuntoja
vollständig	täysin
Mannschaften	joukkueet
Fort	linnake
cm	cm
Senat	senaatti
komisch	hauska
Gen	geeni
gedreht	kääntyi
Scheibe	levy
Muster	kuvio
Boot	vene
Theater	teatteri
Hersteller	valmistajat
Sponsor	sponsori
klassisch	klassinen
Symbol	ikoni
Garantie	takuu
gewidmet	omistautunut
Richtung	suunta
Basketball	koripallo
Objekte	esineet
löschen	poistaa
Abend	ilta
Versammlung	kokoonpano
nuklear	ydinaseiden
Maus	hiiri
Signal	signaali
Verbrecher	rikollinen
ausgegeben	annettu
mächtig	voimakas
Traum	unelma
FALSCH	VÄÄRÄ
da	da
Besetzung	heittää
Blume	kukka
Personal	henkilöstö
bestanden	läpäissyt
geliefert	toimitetaan
Stürze	Falls
Seele	sielu
fördern	edistää
angegeben	totesi
Statistiken	tilastot
Profis	ammattilaisten
erscheint	näyttää
tragen	kuljettaa
Flagge	lippu
Abdeckungen	kannet
em	em
Vorteil	etu
Hallo	Hei
Design	malleja
pflegen	ylläpitää
Tourismus	matkailu
Priorität	prioriteetti
Erwachsene	aikuiset
Grafik	graafinen
Atom	atomi
Zahlungen	maksut
Bindung	sitova
kurz	lyhyt
beendet	päättyi
gewinnt	voittoisa
anonym	anonyymi
Skript	käsikirjoitus
serviert	palveli
will	haluaa
bereit	valmis
Leere	mitätön
Etikett	tag
Interview	haastatella
mischen	sekoittaa
Rahmen	puitteet
Scheibe	levy
Eingerichtet	asennetut
Königin	kuningatar
Kredite	ov
deutlich	selvästi
Fix	korjata
Griff	kahva
Süss	makea
Kriterien	kriteeri
assoziieren	kumppani
ne	NE
Verhalten	käytös
vergrößern	suurentaa
Strahl	säde
Einnahmen	tulot
messen	mitata
Stimmen	ääntä
du	du
Pflicht	velvollisuus
Diskussionen	keskustelut
Bär	karhu
gewinnen	saada
Festival	festivaali
Labor	laboratorio
Ozean	valtameri
Flüge	lennot
Fachwelt	asiantuntijat
Zeichen	merkkejä
Tiefe	syvyys
Zug	kouluttaa
trocken	kuiva
erkunden	tutkia
Spa	kylpylä
Konzept	konsepti
fast	lähes
Handhabung	käsittely
Ursprung	alkuperä
Milliarde	miljardi
Intelligenz	älykkyys
gekauft	ostettu
con	huijaus
Nationen	kansakunnat
Route	reitti
gebrochen	rikki
Schlacht	taistelu
sprechen	puhua
Protokoll	protokolla
Abfrage	tiedustelu
Partnerschaft	kumppanuus
Ausdruck	ilmaisu
es	es
Rede	puhe
Draht	johdin
Vorschläge	ehdotukset
Ersatz	korvaus
Band	nauha
strategisch	strateginen
Richter	tuomari
Acid	happo
Bytes	tavua
Cent	sentti
gezwungen	pakko
kompatibel	yhteensopiva
Wohnung	huoneisto
Null	tyhjä
Null	nolla
Redner	kaiutin
Beratung	konsultointi
Konstrukteur	suunnittelija
pr	PR
Ehe	avioliitto
rollen	rulla
Banken	pankit
fr	FR
Teilnehmer	osallistujaa
Geheimnis	salaisuus
Negativ	negatiivinen
Favoriten	suosikit
Theater	teatteri
Federung	jouset
var	var
ausführen	suorittaa
Übersetzung	käännös
Schätzungen	arvioiden
Verletzung	vahinko
Ministerium	ministeriö
Treiber	kuljettajat
Anwalt	lakimies
Figuren	luvut
geschützt	suojattu
Vorschlag	ehdotus
teilen	jakaminen
Portal	portaali
Beta	beeta
gratis	ilmaiseksi
zu	kohti
leicht	hieman
helfen	avustaa
Verhalten	käytös
enthalten	sisälsi
Gesetzgebung	lainsäädäntö
Berufung	kutsumus
Parameter	parametrit
Profile	profiilit
Angelegenheiten	asioissa
Häuser	talot
Steuerung	ohjaimet
kombiniert	Yhdistetty
letzte	perimmäinen
Vertreter	edustaja
geringer	vähäinen
Abteilungen	osastot
Bewohner	asukkaat
angezeigt	näyttöön
Mama	äiti
reduziert	pelkistetty
Selten	harvinainen
durchgeführt	suoritettu
extrem	äärimmäinen
Proben	näytteet
Riegel	baarit
Prognose	ennuste
entfernt	poistettu
Zyklus	sykli
enthalten	sisältää
Richtigkeit	tarkkuus
Schlaf	nukkua
mg	mg
Vogel	lintu
Apotheke	apteekki
Schaffung	luominen
statisch	staattinen
Jäger	metsästäjä
Adressen	osoitteet
Dame	nainen
Kristall	kristalli
berühmt	kuuluisa
Schriftsteller	kirjailija
Vorsitzende	puheenjohtaja
Getränk	juoda
Akademie	akatemia
dynamisch	dynaaminen
Essen	syödä
permanent	pysyvä
Reinigung	puhdistus
bildet	muodostaa
Mappe	salkku
praktisch	käytännöllinen
geliefert	toimitetaan
Infrastruktur	infrastruktuuri
Farbe	väri
Verkäufer	myyjä
Philosophie	filosofia
Verordnung	säätö
Offiziere	upseerit
Ziel	tavoite
Gebote	tarjouksia
Ernährung	ravitsemus
Aufzeichnung	äänite
Junior	nuorempi
les	les
Kap	viitta
Ringe	renkaat
Spitze	kärki
wunderbar	ihana
Fahrkarte	lippu
angekündigt	ilmoitti
vermuten	arvaus
wem	ketä
Fußball	jalkapallo
Mathematik	matematiikka
einführen	tuonti
Entsendung	komennus
Gegenwart	läsnäolo
automatisch	Automaattinen
Besichtigung	katselu
gepflegt	säilyy
CH	ch
Dan	dan
Hunde	koirat
Direktoren	johtajat
Aspekte	näkökohdat
voraus	eteenpäin
Mond	kuu
Beteiligung	osallistumista
planen	ohjelma
Fliege	lentää
Weise	tapa
Matrix	matriisi
Kombination	yhdistelmä
Änderung	muutos
Stärke	vahvuus
Truthahn	Turkki
Bibliotheken	kirjastot
richtig	asianmukainen
Grad	astetta
Unternehmen	yrityksille
Delta	delta
Angst	pelko
suche	etsiä
Zoll	tuumaa
Konvention	sopimus
Anteile	osakkeiden
Schulleiter	pääasiallinen
Komfort	mukavuus
Farben	värit
Kriege	sodat
Bestellung	tilaaminen
gehalten	säilytetään
Alpha	alfa
Beschwerde	valitus
Kreuzfahrt	risteily
Bonus	bonus
Hallo	Hei
Gebäude	rakennukset
Angebote	tarjoukset
schlagen	lyödä
Batterien	akut
wird	tulee
fährt	asemat
Waffen	aseet
Tee	tee
verbessert	parantunut
leisten	saavuttaa
Positionen	kannat
Kleid	pukeutua
Abonnement	tilaus
Händler	jakaja
zeitgenössisch	nykyajan
Himmel	taivas
Rom	rom
getragen	kuljettaa
Exposition	valotus
verbergen	piilottaa
Unterschrift	allekirjoitus
Müller	mylläri
Bereitstellung	säännös
Kleider	vaatteet
Rahmen	kehyksiä
bestimmt	varmasti
Zeitung	sanomalehti
Spielzeug	lelu
Schicht	kerros
gedruckt	painettu
langsam	hidas
Entfernung	poistaminen
Haftung	vastuu
Drucker	tulostimet
Hinzufügen	lisäämällä
Stelle	täplä
verbringen	viettää
Fabrik	tehdas
Innere	sisusta
wachsen	kasvaa
optisch	optinen
Beförderung	edistäminen
relativ	suhteellinen
tolle	hämmästyttävä
Punkt	piste
Identität	identiteetti
Umwandlung	muuntaminen
Gefühl	tunne
versteckt	kätketty
angemessen	kohtuullinen
Revision	tarkistus
beeinflussen	vaikutus
Verhältnis	suhde
Bedeutung	merkitys
Regen	sade
Planet	planeetta
Kopien	kappaletta
erlauben	lupa
Sehen	koska
Beweis	todiste
Bass	basso
Rezept	resepti
leer	tyhjä
Beispiel	ilmentymä
Loch	reikä
Reiten	ratsastaa
Büro	toimisto
Erhaltung	säilyttäminen
Paar	pari
Ideal	ihanteellinen
Brille	silmälasit
verzeichnet	tallennettu
Don	Don
Stücke	kappaletta
fertig	päättynyt
Parks	puistot
Rechtsanwälte	lakimiehet
Stress	stressi
Sahne	kerma
ss	ss
läuft	ajot
entdecken	löytää
ap	ap
Muster	kuviot
Hügel	Hills
nm	nm
Berater	neuvonantaja
bewusst	tietoinen
gestalten	muoto
Evolution	evoluutio
Zertifikate	todistukset
Ziele	tavoitteet
Stationen	asemat
empfohlen	ehdotti
op	op
Überreste	jäännökset
Firmen	yritykset
Euro	euro
Operator	operaattori
Strukturen	rakenteet
generisch	yleinen
Enzyklopädie	tietosanakirja
Verwendung	käyttö
Tinte	muste
gemischt	sekoitettu
Volkszählung	väestönlaskenta
Rad	pyörä
Lieferanten	toimittajat
kompakt	kompakti
Poesie	runous
Beleuchtung	valot
Verfolgung	seuranta
Engel	enkeli
Vorbereitung	valmistautuminen
Versuch	yrittää
Empfang	vastaanotetaan
Streichhölzer	Ottelut
Übereinstimmung	mukaisesti
Breite	leveys
Motoren	moottorit
vergessen	unohtaa
Feld	ryhmä
diskutiert	keskusteltiin
genau	tarkka
Klima	ilmasto
griechisch	kreikkalainen
Anweisung	ohje
Verwaltung	hallinnassa
roh	raaka
Unterschiede	erot
erklären	selittää
Gründen	perustaa
ausgedrückt	ilmaisi
Umfang	laajuus
Scharf	terävä
ben	ben
Absatz	kohta
töten	tappaa
Mathematik	matematiikka
Vergütung	korvaus
Export	viedä
Manager	johtajat
Module	moduulit
geführt	suoritettu
Versionen	versiot
weiß	tietää
beschreiben	kuvata
Bürger	kansalaiset
Erbe	perintö
Ärger	vaivata
Trainer	valmentaja
landwirtschaftlich	maatalous
erweitern	laajentaa
Publikum	yleisö
zugewiesen	osoitettu
Sammlungen	kokoelmat
Ewigkeit	iät
Spezialist	asiantuntija
Koch	kokki
beeinflussen	vaikuttaa
Jungfrau	Neitsyt
erfahren	kokenut
Ermittlung	tutkimus
angehoben	nosti
Hut	hattu
Institution	instituutio
gerichtet	suunnattu
betroffen	vaikuttaa
Fahrrad	pyörä
total	täysin
Teller	levy
Kosten	kulut
zeigen	osoittaa
blond	vaalea
Verfahren	menettely
Favorit	suosikki
Eigenschaften	ominaisuudet
der	der
verlieren	menettää
organisch	orgaaninen
suchen	etsiä
Erfahrungen	kokemukset
Alben	albumit
Verträge	sopimuksia
Gäste	vieraita
Gastgeber	isännöi
Krankheiten	sairaudet
über	koskevat
äquivalent	vastaava
Chemie	kemia
Kits	sarjat
Logik	logiikka
Prinz	prinssi
Kreis	ympyrä
Boden	maaperä
Psychologie	psykologia
nass	märkä
Umstände	olosuhteet
Investor	sijoittaja
elementar	perus
Sponsoren	sponsorit
Fuchs	kettu
unbegrenzt	rajoittamaton
reagieren	vastata
Größen	koot
einfach	tavallinen
Ausfahrt	poistuminen
Arm	käsivarsi
Schlüssel	näppäimet
Welle	Aalto
heilig	pyhä
Handlungen	säädökset
Beratung	opastus
Weg	polku
Symbol	symboli
Autobahn	valtatie
beobachtete	havaitun
Dean	dekaani
Konfiguration	perustaa
Umfrage	äänestys
Arten	tyylit
gefüllt	täynnä
Bindung	side
Kanäle	kanavat
Blinddarm	liite
Schokolade	suklaa
Portion	osa
Umfang	laajuus
Lieferant	toimittaja
Kabel	kaapelit
Baumwolle	puuvilla
Anforderung	vaatimus
getötet	surmattu
Rand	reunus
alt	muinainen
Debatte	keskustelu
Vertreter	edustajia
beginnt	alkaa
Schwangerschaft	raskaus
Sehenswürdigkeiten	nähtävyydet
gelernt	oppinut
Transaktionen	liiketoimet
Forscher	tutkimusmatkailija
historisch	historiallinen
Mann	aviomies
autorisiert	valtuutettu
verrückt	hullu
bevorstehende	tuleva
Konzert	konsertti
Partituren	tulokset
Wirksamkeit	tehokkuus
Komödie	komedia
angenommen	hyväksyttiin
effizient	tehokas
linear	lineaarinen
Engagement	sitoutuminen
Spezialität	erikoisuus
Bären	karhut
hüpfen	hypätä
Träger	kantaja
Konstante	jatkuva
Visa	Visa
Mund	suu
Meter	mittari
verbunden	sidoksissa
Interviews	haastattelut
Konzepte	käsitteet
Gewehr	ase
reflektieren	heijastaa
rein	puhdas
Hölle	helvetti
Obst	hedelmä
beginnt	alkaa
qualifiziert	pätevä
Reform	uudistaa
Linse	linssi
behandelt	käsitelty
Entdeckung	löytö
zeichnen	piirtää
klassifiziert	luokiteltu
annehmen	olettaa
Allianz	liitto
bestätigen	vahvistaa
Ingenieur	insinööri
konsistent	johdonmukainen
ersetzen	korvata
Spielraum	raivaaminen
Konverter	muunnin
Organisation	organisaatio
Baby	tyttö
Schecks	tarkastuksia
erreicht	saavuttanut
Werden	tulossa
Zielsetzung	tavoite
angezeigt	osoitettu
Zucker	sokeri
Crew	miehistö
Beine	jalat
Stock	tikku
Beziehung	suhde
aktiviert	käytössä
Genre	laji
Freiwillige	vapaaehtoinen
Rückseite	takaosa
demokratisch	demokraattinen
verbessern	parantaa
genau	tarkka
gebunden	sidottu
Parameter	parametri
Prozessor	suoritin
Knoten	solmu
formal	muodollinen
Sturm	myrsky
Mikro	mikro
Hochschulen	oppilaitokset
Meile	maili
Herausforderungen	haasteet
Redakteure	Editors
höchste	ylin
Brüder	veljet
Anerkennung	tunnustus
ref	viite
schätzen	arvio
Kind	lapsi
Inspektion	tarkastus
Verbraucher	kuluttajien
Grenzen	rajoja
Gebiet	alue
Bewaffnung	aseet
verzögern	viive
Pilot	lentäjä
Beiträge	maksut
kontinuierlich	jatkuva
Initiative	aloite
Roman	uusi
Ausführung	suoritus
Behinderung	vammaisuus
Ultra	ultra
Gewinner	voittaja
Folge	episodi
Töpfer	savenvalaja
Gericht	ruokalaji
Theaterstücke	pelaa
Bekanntmachung	tiedotuslehti
ia	ia
ändern	muuttaa
wirklich	todella
Universum	maailmankaikkeus
Kandidat	ehdokas
Slot	aukko
hervorragend	maksamatta
Ha	ha
geplant	suunnitellut
Hütte	jättää
Spiegel	peili
Turnier	turnaus
Berücksichtigung	harkinta
Sitzungen	istuntoja
Kern	ydin
Käufer	ostajien
Zeitschriften	lehdet
grau	harmaa
Katalog	luettelo
berechnet	peritään
breit	laaja
und	und
gewählt	valittu
Demo	esittely
Hass	vihata
Terminal	pääte
Verlag	julkaisijat
Nächte	öisin
Flüssigkeit	neste
Reis	riisi
Reservierung	varaus
Lebensmittel	elintarvikkeet
bewachen	vartija
Einsparung	tallentaa
Reich	imperiumi
neu	hiljattain
erziehen	nostaa
illegal	laiton
Erweiterung	laajeneminen
Premier	johtava
Morgen	huomenna
Milch	maito
Theater	draama
Besuch	vierailevat
Wettbewerb	kilpailu
gesammelt	koottu
Bands	bändejä
geeignet	sopiva
absolut	ehdottomasti
Prüfung	tarkastaa
Kammer	kammio
Guinea	Guinea
Ergebnisse	tulokset
iso	ISO
typisch	tyypillinen
Summe	summa
Hähnchen	kana
vorübergehend	tilapäinen
besuchen	käydä
Dusche	suihku
Versendung	lähettäminen
ausreichend	riittävä
Schale	kuori
Provinz	maakunta
katholisch	katolinen
Gouverneur	kuvernööri
Bier	olut
Beitrag	panos
Formel	kaava
Verfassung	perustuslaki
Verpackung	pakkaus
zuverlässig	luotettava
Zweifel	epäillä
verdienen	ansaita
Perioden	aikoja
Anschläge	iskut
Waren	kauppatavara
Symptome	oireet
Denkmal	muistomerkki
Zwilling	twin
einfügen	lisätä
Tor	portti
Zeichnung	piirustus
Kandidaten	ehdokkaat
bestellt	tilasi
biologisch	biologinen
Kampf	taistelevat
Übergang	siirtyminen
Vorlieben	mieltymykset
Spion	vakooja
Romantik	romanssi
Instrument	väline
Teilt	jakaa
Themen	teemat
Befugnisse	valtuudet
Himmel	taivas
Bits	bitit
schwanger	raskaana
Einstufung	luokittelu
konzentriert	keskittynyt
Arzt	lääkäri
fragen	pyytäminen
Blöcke	lohkot
lo	katso
geistig	hengellinen
Diabetes	diabetes
ml	ml
Verschiebung	siirtää
sitzen	istua
Körper	elinten
Fotos	valokuvat
Schneiden	leikkaus
Schriftsteller	kirjailijat
flexibel	joustava
liebte	rakastettu
Favoriten	suosikit
Kartierung	kartoitus
zahlreich	useat
verhältnismäßig	suhteellisesti
repräsentiert	edustaa
überlegen	esimies
bevorzugt	edullinen
Gerettet	tallennettu
intellektuelle	älyllinen
gewährt	myönnetty
Kohlenstoff	hiili
gemütlich	mukava
magnetisch	magneettinen
Interaktion	vuorovaikutus
Hören	kuuntelee
Krise	kriisi
Ausblick	näkymät
massiv	massiivinen
hell	kirkas
gebildet	muodostettu
Klavier	piano
Echo	kaiku
Revolution	vallankumous
Displays	näytöt
Plasma	plasma
Verdienste	tulot
Geheimnis	mysteeri
Landschaft	maisema
mechanisch	mekaaninen
Reise	matka
Banner	lippu
Feige	kuva
Grafschaften	maakunnat
Erwerb	hankinta
anerkannt	tunnistettu
Träume	unelmat
Benachrichtigung	ilmoitus
kg	kg
lehren	opettaa
schnell	nopea
ziehen	Vedä
ut	ut
Seminar	seminaari
Investitionen	investoinnit
Räder	pyörät
angeben	eritellä
empfindlich	herkkä
Vorlagen	malleja
Formate	formaatit
hält	pitää
Router	reititin
Beton	betoni
si	si
Mappe	kansio
Fertigstellung	valmistuminen
Impuls	pulssi
Technik	tekniikka
Wählen	äänestys
Justiz	tuomioistuimet
umgewandelt	muunnettu
Metro	metro
Jahrestag	vuosipäivä
Verbesserungen	parannuksia
Streifen	kaistale
Spezifikation	määrittely
Unfall	onnettomuus
Kerbe	lovi
zugänglich	saatavilla
Bewohner	asukas
Handlung	juoni
typisch	tyypillisesti
Darstellung	edustus
Pumpe	pumppu
existiert	olemassa
Vereinbarungen	järjestelyt
Konferenzen	konferenssit
Verbrauch	kulutus
eng	kapea
Bedrohung	uhkaus
Umfragen	tutkimukset
Sitzung	istuva
Berater	konsultti
Regler	ohjain
Ausschüsse	valiokunnat
Penis	penis
Schloss	linna
Gardens	puutarhat
Etiketten	tarrat
bereit	halukas
bio	bio
Schauspielkunst	näytteleminen
Köpfe	päät
Prüfung	koe
Residenz	asuinpaikka
Dichte	tiheys
hundert	sata
seltsam	outo
nachhaltig	kestävä
statistisch	tilastollinen
erwähnen	mainita
Innovation	innovaatio
grau	harmaa
parallel	rinnakkainen
arbeiten	toimia
Banknoten	setelit
stabil	vakaa
Definitionen	määritelmät
von	von
Ärzte	lääkärit
Lektion	oppitunti
Kino	elokuva
Wahlen	vaalit
Reaktion	reaktio
leer	tyhjä
verbessert	tehostettu
berechtigt	oikeutettu
schwer	vaikea
generieren	Tuottaa
Zeitungen	sanomalehdet
Krankenhäuser	sairaalat
vi	vi
Humor	huumori
alt	ikäinen
Monitore	näytöt
Ausnahme	poikkeus
Dauer	kesto
Masse	pääosa
Besuche	käyntiä
Fähigkeiten	kyvyt
Empfehlung	suositus
Sünde	synti
organisiert	järjestetty
ba	ba
para	kappale
Annahme	hyväksyminen
Verbesserung	parantaminen
teuer	kallis
Büffel	puhveli
Organisationen	organisaatioiden
Ebene	kone
Programme	ohjelmat
Mechanismus	mekanismi
ee	ee
markiert	merkitty
Gefahren	ajettu
Flasche	pullo
innovativ	innovatiivinen
Massage	hieronta
Fazit	johtopäätös
Schließen	sulkeminen
tausend	tuhat
Legende	legenda
Villa	huvila
Knochen	luu
Säulen	pylväät
Störungen	häiriöt
Zusammenarbeit	yhteistyö
Entdeckung	havaitseminen
innere	sisäinen
Formation	muodostus
med	med
Ingenieure	insinöörien
Entität	kokonaisuus
Kreuzfahrten	risteilyt
Tor	portti
römisch	roomalainen
Aufgaben	tehtävät
erotisch	eroottinen
Ton	sävy
Ethik	etiikka
Drachen	lohikäärme
beschäftigt	kiireinen
Kapitän	kapteeni
bringt	tuo
Heizung	lämmitys
Bein	jalka
Hals	niska
Flügel	siipi
Skripte	skriptejä
ABC	ABC
ernannt	nimitetty
Behandlung	tekemisissä
verpflichten	sitoutumaan
Schiene	kisko
Reisen	matkat
Spalt	aukko
Seiten	sivut
Tube	putki
dazugehörigen	vastaava
Beschreibungen	kuvaukset
Gürtel	vyö
Jacke	takki
Animation	animaatio
Orakel	oraakkeli
er	er
Produktionen	tuotannot
Luftfahrt	ilmailu
stolz	ylpeä
Katastrophe	katastrofi
Konsole	konsoli
Befehle	komennot
jr	jr
Telekommunikation	tietoliikenne
Lehrer	ohjaaja
Riese	jättiläinen
erreicht	saavutettu
Verletzungen	vammat
Ansätze	lähestymistavat
gewöhnlich	tavallinen
Briefmarken	postimerkkejä
Winkel	kulma
rauben	ryöstää
Designer	suunnittelijat
Freiheit	vapaus
Epoche	aikakausi
Konvertieren	muuntaa
Möglichkeit	mahdollisuus
Analytiker	analyytikko
gefährlich	vaarallinen
Zuverlässigkeit	luotettavuus
beziehungsweise	vastaavasti
Freiwillige	vapaaehtoiset
abgeleiteten	johdettu
Vergnügen	ilo
Ehre	kunnia
orientiert	suuntautunut
Adler	kotka
Gebet	rukous
Workshops	työpajat
Hurrikan	Hurrikaani
ruhig	hiljainen
Hersteller	tuottaja
repräsentiert	edustettuina
Verantwortlichkeiten	vastuut
Käse	juusto
vorsichtig	huolellisesti
Produktivität	tuottavuus
Krone	kruunu
Par	par
Diagnose	diagnoosi
Hersteller	valmistaja
Riss	crack
Prinzip	periaate
Picks	poimii
Gang	jengi
Fetisch	fetissi
Aussehen	ulkomuoto
Rauch	savu
Filter	suodattimet
inkorporiert	yhdistetty
Kunst	alus
Gefährte	kaveri
blind	sokea
Salon	aula
wütend	hullu
Algorithmus	algoritmi
stark	voimakkaasti
Cafe	kahvila
ken	ken
Proteine	proteiineja
su	su
familiär	tuttu
fähig	kykenevä
Eintritt	pääsy
Schuh	kenkä
gewählt	valittiin
Tragen	kuljettaa
Terrorismus	terrorismi
Freude	ilo
Ausgaben	painokset
ethnisch	etninen
Parlament	eduskunta
Darsteller	näyttelijä
Funde	löydöt
Dichtung	tiiviste
Situationen	tilanteita
fünfte	viides
Bürger	kansalainen
vertikal	pystysuora
Korrekturen	korjaukset
beschreibt	kuvailee
Behinderungen	vammaiset
Substanz	aine
verboten	kielletty
Rohr	putki
Soldaten	sotilaat
Wächter	holhooja
Vorlesung	luento
Simulation	simulointi
Layout	layout
Initiativen	aloitteita
krank	sairas
Konzentration	keskittyminen
legen	asettaa
Deutung	tulkinta
dreckig	likainen
unterrichtet	opettanut
Arbeitnehmer	työntekijä
Optimierung	optimointi
Tempel	temppeli
Substanzen	aineet
beweisen	todistaa
entdeckt	löydetty
Flügel	siivet
genetisch	geneettinen
Beschränkungen	rajoituksia
dünn	ohut
Ausstellung	näyttely
Grat	harjanne
Modem	modeemi
bringen	tuoden
krank	sairas
bewerten	arvioida
tropisch	trooppinen
sammeln	kerätä
Vektor	vektori
bestimmt	ehdottomasti
Drehung	kääntyminen
Existenz	olemassaolo
Kommentar	selostus
Entwicklungen	kehitys
Einwanderung	maahanmuutto
Reiseziele	kohteet
gegenseitig	keskinäinen
Syntax	syntaksi
li	li
Attribut	ominaisuus
Gefängnis	vankila
Fertigkeit	taito
Stühle	tuolit
Umgebung	ympäröivä
Berge	vuoret
Popularität	suosio
Anfrage	tiedustelu
geprüft	tarkistettu
Ausstellungsstück	näyttely
werfen	heittää
Trend	trendi
Katzen	kissat
Wüste	aavikko
ya	ya
Koordinator	koordinaattori
Quecksilber	elohopea
Verbrennung	palaa
Flucht	paeta
Empfänger	vastaanotin
progressiv	etenevä
Boote	veneet
Meisterschaft	mestaruus
Arkade	arkadi
unmöglich	mahdoton
erzählt	kertoo
offensichtlich	ilmeinen
Depression	masennus
Graph	kaavio
Abdeckung	päällyste
Platin	platina
Beurteilung	tuomio
Gespräche	neuvottelut
Einreichung	arkistointi
fördern	edistää
ausgezeichnet	palkittiin
Versuche	tutkimuksissa
Meister	Masters
Patrone	patruuna
Erläuterung	selitys
org	Org
Betrug	petos
Elektrizität	sähkö
Spektrum	spektri
Ankunft	saapuminen
Keramik	keramiikka
Betonung	painotus
genial	mahtava
Bestätigt	vahvistettu
zählt	laskee
Absturz	romahdus
Aufzug	hissi
inter	inter
Höhen	korkeudet
Schatten	varjo
Ausgabe	kulu
wagen	hanke
Klinik	klinikka
Heilung	paranemista
Prinzessin	prinsessa
Eingeben	kirjoittamalla
Paket	paketti
Studios	studiot
Beteiligung	osallistuminen
Papa	isä
Tasten	painikkeet
Platzierung	sijoitus
Beobachtungen	havainnot
Gewinner	voittajat
Straßen	tiet
anschließend	myöhempi
Garten	piha
Bekanntgabe	julkistaminen
Einrichtung	perustaminen
Erinnerungen	muistoja
te	te
schafft	luo
Gesichter	kasvoja
Tourist	turisti
Mord	murhata
angemessene	riittävä
Senator	senaattori
Präsentationen	esitykset
verdauen	sulattaa
Staub	pöly
Wiki	wiki
ersetzt	vaihdettu
Radar	tutka
Verluste	tappiot
Kampf	taistelu
Reduzierung	vähentäminen
gestoppt	pysäytetty
Besetzung	ammatti
eng	tarkasti
Strahlung	säteily
Könige	kuninkaat
Schießen	ammunta
Ohr	korva
Flaggen	liput
Bäcker	leipuri
konservativ	konservatiivinen
Schock	järkyttää
Wirksamkeit	tehokkuuden
Krawatte	solmio
Dach	katto
zeigen	osoittaa
Atmosphäre	ilmapiiri
Kuss	suudella
Tier	peto
ra	ra
betrieben	toimi
Experiment	koe
Ziele	tavoitteet
Einkäufe	ostot
Föderation	liittovaltio
Pizza	pizza
eingeladen	kutsuttu
Zuordnung	toimeksianto
modern	mod
Abfragen	kyselyt
Abwesenheit	poissaolo
Anbieter	myyjät
Yoga	jooga
dient	palvelee
Überraschung	yllätys
Lampe	lamppu
Witze	vitsit
Beratung	neuvonta
Palast	palatsi
zufrieden	vakuuttunut
Gewinnt	voittoa
Warenhaus	varasto
soll	oletettu
gewöhnliche	tavallinen
Geist	aave
Verstoß	rikkominen
Boss	pomo
Stolz	ylpeys
Erwartungen	odotukset
Unabhängigkeit	itsenäisyys
wissend	tietäen
Reporter	reportteri
Stoffwechsel	aineenvaihdunta
Champion	mestari
persönlich	henkilökohtaisesti
reichlich	paljon
Solo	soolo
Kehle	kurkku
Reichtum	rikkaus
Vakuum	tyhjiö
Tanzen	tanssi
erkenne	tunnistaa
schreibt	kirjoittaa
Piazza	aukio
Suche	etsintä
veröffentlichen	julkaista
Abschirmung	seulonta
trans	trans
Pionier	pioneeri
Vergessene	unohdettu
Akrobat	akrobaatti
Platten	levyt
Aufsätze	esseitä
Verhalten	käytös
erzählen	kertominen
ziemlich	melko
intelligent	älykäs
Modi	tilat
Verpflichtung	vaatimus
Hafen	satama
Reisende	matkustaja
Segment	segmentti
Feind	vihollinen
Puzzle	palapeli
Brunnen	kaivot
beschränkt	rajoitettu
Republikaner	tasavaltalainen
Geheimnisse	salaisuudet
Syndrom	oireyhtymä
Teilnahme	läsnäolo
Elfmeter	rangaistus
Trommel	rumpu
ermöglicht	mahdollistaa
Baumeister	rakentaja
Aussicht	näköala
Flut	tulva
Leichtigkeit	helppous
Argumente	argumentit
Arena	areena
Abenteuer	seikkailuja
Schüler	oppilaat
Ankündigung	ilmoitus
Ergebnis	tulokset
schätzen	arvostaa
ergänzt	laajennettu
gewachsen	täysikasvuinen
schön	ihana
Zentren	keskuksissa
Klausel	lauseke
Lächeln	hymy
Länder	maat
Truppen	joukot
bewaffnet	aseistettu
Kiefer	mänty
Kühlung	jäähdytys
Golf	kuilu
LKW	autot
Mechanismen	mekanismit
Scheidung	avioero
Tradition	perinne
Pillen	pillereitä
Tiger	tiikeri
Leute	ihmiset
Sensor	sensori
ausgesetzt	avoin
Jagd	metsästää
Engel	enkelit
Stellvertreter	sijainen
thailändisch	thaimaalainen
Emissionen	päästöt
Ärzte	lääkärit
Beschwerde	valitus
Szenen	kohtaukset
Experimente	kokeiluja
Auftrieb	edistää
Führung	hallintotavan
Mühle	mylly
Gegründet	perustettu
chronisch	krooninen
Höhle	den
Finger	sormi
hält	pitää
Pfund	punta
Lokalisieren	paikantaa
pl	pl
trainiert	koulutettu
Umsetzung	toteuttamisessa
Brot	leipä
Motoren	moottorit
zäh	kova
Vorfall	tapaus
Dynamik	dynamiikka
Lüge	valehdella
Konversation	keskustelu
verringern	pienentää
Anbetung	palvonta
Fähigkeit	valmiudet
ak	ak
Präzision	tarkkuus
Schadenersatz	vahingonkorvaus
Reserve	varaukset
lösen	ratkaista
Minderheit	vähemmistö
vielfältig	monipuolinen
Zutaten	ainekset
Ah	Ah
Töne	sävyt
Rehabilitation	kuntoutus
Sicht	näky
Lehm	savi
schwach	heikko
geteilt	jaettu
Rezeption	vastaanotto
weise	viisas
Chancen	todennäköisyys
Seminare	seminaarit
Folgen	seuraukset
Entscheidungsträger	päättäjille
Erdkunde	maantiede
Integrität	eheys
Erbe	perintö
zufrieden	tyytyväinen
Achtung	vaara
Vitamin	vitamiini
verarbeitet	jalostettu
Phrase	fraasi
erziehen	nostaminen
Auswirkungen	vaikutukset
Funktionalität	toiminnallisuus
Paradies	paratiisi
hybrid	hybridi
liest	lukee
emotional	tunteellinen
Ruhm	kunnia
ja	ja
geographisch	maantieteellinen
überschreiten	ylittää
Stange	sauva
Seide	silkki
Babys	vauvat
Bi	bi
romantisch	romanttinen
aufgedeckt	paljastui
Spezialisten	asiantuntijat
Generator	generaattori
Suspension	jousitus
traurig	surullinen
Korrektur	korjaus
Wolf	susi
langsam	hitaasti
Ergänzung	täydentää
Teile	osat
Säugling	pikkulasten
Branchen	aloilla
Flüssigkeit	neste
Begründung	perusteet
Mahlzeit	ateria
ta	ta
Maschinen	koneet
Gleichung	yhtälö
Körbe	korit
Wahrscheinlichkeit	todennäköisyys
Abmessungen	ulottuvuus
studierte	tutkittu
Gewinne	voitot
Teufel	paholainen
Gras	ruoho
illustriert	kuvitettu
Kirsche	kirsikka
kontinental	mannermainen
Leistung	saavutus
Einschränkungen	rajoituksia
Beerdigung	hautajaiset
Kapitel	luvuissa
Passagier	matkustaja
praktisch	mukava
Mars	Mars
Größe	kokoinen
Ei	muna
Signale	signaalit
Orientierung	suuntautuminen
Diebstahl	varkaus
Kindheit	lapsuus
Symbole	symbolit
lat	lat
Meta	meta
Analog	analoginen
Talent	lahjakkuus
datiert	päivätty
Weisheit	viisaus
Grenze	raja
Elite	eliitti
gi	gi
glaubt	uskoo
Gedichte	runoja
Zuständigkeit	toimivalta
Roboter	robotti
Anzeige	näyttämällä
Zeuge	todistaja
ausgestattet	varustettu
Stufen	vaiheet
sur	sur
erworben	hankittu
beurteilen	arvioida
waschen	pestä
Eingang	Sisäänkäynti
Erklärung	ilmoitus
verlieren	menettää
Versuche	yrityksiä
edel	jalo
Automatisierung	automaatio
Auswirkungen	vaikutukset
Umdrehung	kierros
Vorteile	edut
Ritter	ritari
Ziele	tavoitteet
Erweiterungen	laajennukset
Einsprüche	valitukset
Krankheit	sairaus
ho	ho
Alternativen	vaihtoehtoja
Sch	sh
Seife	saippua
Marmelade	hillo
ungewöhnlich	epätavallinen
antwortete	vastasi
Zerstörung	tuho
Migration	muutto
Störung	häiriö
konventionell	tavanomainen
tragen	yllään
Achse	akseli
gesucht	pyrittiin
Gene	geenit
Median	mediaani
Scanner	skanneri
hierin	tässä
lebhaft	eloisa
Einstellung	säätö
Held	sankari
Behandlungen	hoidot
Haltung	asenne
Teppich	matto
Linsen	linssit
besucht	osallistui
Schwierigkeit	vaikeus
Punk	punk
Koalition	koalitio
Einschreibung	rekisteröinti
Herzog	herttua
Tempo	vauhti
Produzenten	tuottajia
Bogen	kaari
Schnittstellen	rajapinnat
Atlas	kartasto
Überwachung	havainto
Folter	kiduttaa
gelöscht	Poistetaan
Mantel	takki
Wiederherstellung	entisöinti
Bequemlichkeit	sopivuus
Rückkehr	palaavat
Opposition	oppositio
Container	kontti
Beklagte	vastaaja
Supervisor	valvoja
Korps	joukot
Schauspieler	toimijoiden
Leber	maksa
haftbar	velvollinen
Petition	adressi
Antenne	antenni
gepflückt	poimitaan
Glauben	uskomus
Tötung	tappaminen
Schulter	olkapää
Dekor	sisustus
Ion	ioni
Durchmesser	halkaisija
Podcast	podcast
Wechselwirkungen	vuorovaikutukset
Sänger	laulaja
Herold	airut
Altern	vanheneminen
Intervention	interventio
Plugin	kytkeä
Attraktion	vetovoima
Tauchen	sukellus
Änderung	muutos
annehmen	olettaa
Schilf	ruoko
betreffen	sisältää
mäßig	kohtalainen
Mäuse	hiiret
verstanden	ymmärsi
schnell	nopeasti
Verbot	kieltää
Sicherheit	varmuus
Ereignis	happening
weit	valtava
Mühlen	myllyt
Gliederung	ääriviivat
erhält	vastaanottaa
Jeans	farkut
Zusammenstellung	kokoelma
ungerade	outo
sigma	sigma
GR	gr
attraktiv	viehättävä
Gelegenheit	tilaisuus
Aufnahmen	tallenteet
Opfer	uhri
Forderungen	vaatii
Vorsichtig	varovainen
Strahl	palkki
Gartenarbeit	puutarhanhoito
Verbindlichkeiten	velvoitteet
ankommen	saapua
Orchester	orkesteri
Lizenz	lisenssi
einstellbar	säädettävä
Zuweisung	jako
Aufsatz	essee
gezeigt	osoittivat
Dialog	vuoropuhelu
Lager	leirit
erklärt	julistettu
Spur	jäljittää
geschlossen	sulkea
Packungen	pakkauksissa
ge	ge
Installation	asennus
Schalter	kytkimet
freiwillig	vapaaehtoinen
du	sinä
sehr	suuresti
ng	ng
häufig	yleisesti
pe	pe
Fotograf	valokuvaaja
Schrei	itkeä
Quant	kvantti
konstruiert	rakennettava
Ergänzungen	lisäykset
erforderlich	edellyttävät
Pfeil	nuoli
Engagement	sitoumus
Rau	karkea
seltsam	outo
Löwe	leijona
Hochzeiten	häät
Sauerstoff	happi
Schlucht	kanjoni
Meter	metriä
nur	vain
Kalender	kalenterit
Anordnung	järjestely
Schlussfolgerungen	päätelmät
Literaturverzeichnis	bibliografia
Zeiger	osoitin
Kompatibilität	yhteensopivuus
strecken	venyttää
Genehmigungen	luvat
Kooperative	osuuskunta
Ernährung	ruokinta
Gemeinde	kauppala
Ranglisten	rankingissa
Messung	mittaus
Gurt	hihna
Menge	väkijoukko
Transfers	siirrot
olympisch	olympia
Transformation	muutos
dir	dir
Zoll	tulli
Administratoren	ylläpitäjät
Persönlichkeit	persoonallisuus
Haken	koukku
Roulette	ruletti
Ablehnen	aleneminen
Kabel	johto
Wolke	pilvi
erleichtern	helpottaa
val	Val
erklärt	selittää
Vorgehen	edetä
Gefühle	tunteet
Messer	veitsi
adoptieren	hyväksyä
verweigert	evätty
Spende	lahjoitus
äußere	ulompi
Ernte	sato
Flüsse	joet
Knoten	solmut
zitiert	mainittu
Nabe	napa
gezielt	kohdennettu
erkannte	tajusi
Gründer	perustaja
Dekade	vuosikymmen
Streit	riita
müde	väsynyt
negativ	haitallinen
Auszug	ote
entladen	purkaa
Getränke	juomat
As	ässä
Stimmen	äänet
Kletterei	kiipeily
Tonnen	tonnia
Parfüm	hajuvesi
gefährlich	vaarallinen
wiederherstellen	palauttaa
Stapel	pino
Methodik	metodologia
Ruf	maine
Demokraten	demokraatteja
aufhängen	ripustaa
Kurve	käyrä
Schöpfer	luoja
Bernstein	keltainen
Museen	museot
Verschlüsselung	koodaus
Tracker	seuraaja
Variation	vaihtelu
Passage	kulku
übertragen	siirretty
Kofferraum	runko
Foto	valokuva
Wellen	aallot
Kamel	kameli
Verteiler	jakelija
chi	chi
Versammlung	keräys
Projektion	projektio
mathematisch	matemaattinen
logisch	looginen
Soße	kastike
Ruhm	kuuluisuus
spezialisiert	erikoistunut
Unternehmen	yritykset
Kritik	kritiikki
Automobil	auto
Jury	tuomarit
Bemerkungen	huomautukset
detektiert	havaittu
Gemälde	maalaukset
ging	käveli
entstehen	aiheutuvat
Populationen	populaatiot
ängstlich	peloissaan
akustisch	akustinen
Kassette	kasetti
Indikator	indikaattori
jpg	jpg
Fehler	virhe
beseitigen	poistaa
Mineral	mineraali
Rubin	rubiini
Perlen	helmet
Vermögen	onni
Segeltuch	kangas
Schwelle	kynnys
Gemeinde	seurakunta
Bildschirme	näytöt
Friedhof	hautausmaa
Stadion	stadion
Erkundung	tutkiminen
min	min
Stengel	varsi
Astronomie	tähtitiede
Wettbewerbe	kilpailut
Grippe	flunssa
Kostüm	puku
Fahrräder	polkupyörää
Bischof	piispa
zog	veti
Mais	maissi
Kompression	puristus
Festlegung	perustamisesta
Farmer	viljelijä
Zinn	tina
Sklave	orja
sofort	heti
Coaching	valmennus
geprüft	tutkitaan
Codierung	koodaus
Einreichungen	huomautukset
Helden	sankareita
gemalt	maalannut
Porträt	muotokuva
Terrorist	terroristi
ethisch	eettinen
Träger	harjoittajat
Mobilität	liikkuvuus
Kampf	taistelu
Regelungen	järjestelmiä
Leiden	kärsimys
neutral	neutraali
Fischer	kalastaja
Ratte	rotta
Speere	keihäitä
Beitritt	tuloaan
Überschrift	otsikko
künstlich	keinotekoinen
Lager	laakeri
spektakulär	mahtava
Welten	maailmoja
schuldig	syyllinen
Aktivierung	aktivointi
Oase	satama
Tablette	tabletti
Jury	tuomaristo
DOS	dos
Schwanz	pyrstö
Charme	viehätys
heftig	väkivaltainen
möglicherweise	mahdollisesti
Ranch	karjatila
Einschränkungen	rajoitteet
Kreuzung	ylitys
inklusive	täydellinen
Hütte	mökki
betrunken	humalassa
beträchtlich	huomattava
Verbrechen	rikokset
aufgelöst	ratkaistu
Byte	tavu
Nase	nenä
Geäst	oksat
Ausländer	ulkomaalainen
Prozessoren	prosessorit
Pleite	mursi
Komplexität	monimutkaisuus
ständig	alituisesti
Entschlossenheit	ratkaista
Gebiete	alueiden
These	tutkielma
Scheiben	levyt
häufig	tiheä
Decke	katto
Pixel	pikseliä
gen	gen
Diamanten	ruutu
Flotte	laivasto
Bündel	kimppu
theoretisch	teoreettinen
Verweisung	lähete
Verlassen	lopettaa
Protokolle	protokollat
Lunge	keuhko
Ersatz	korvike
brillant	loistava
ti	ti
Gel	geeli
gesprochen	puhuttu
Omega	omega
bewertet	arvioitu
blieb	jäi
sieht	näkee
Beendigung	päättyminen
schaute	katsoi
Haushalte	kotitalouksien
einlösen	lunastaa
Korn	jyvä
Regime	järjestelmä
Stier	sonni
architektonisch	arkkitehtoninen
abweichen	erota
Bewegungen	liikkeet
Reparaturen	korjaus
Atem	hengitys
Komfort	palveluihin
virtuell	käytännössä
Markt	kauppapaikka
Kerze	kynttilä
hängend	riippuva
farbig	värillinen
Geschichte	tarina
früher	ennen
Beamer	projektori
gelegen	sijaitseva
sucht	etsii
streng	tiukasti
psychologisch	psykologinen
Vitamine	vitamiinit
elegant	tyylikäs
Gewinne	voitto
Erneuerung	uusiminen
Genealogie	sukututkimus
als	katsotaan
Wertung	pisteytys
Ausgaben	menot
Kritik	kriitikot
Algorithmen	algoritmit
Hacker	hakkeri
Salon	salonki
Turbo	turbo
heilen	parantaa
ni	ni
denkt	ajattelee
Vorschlag	ehdotus
Soldat	sotilas
Bombe	pommi
Schaden	vahingoittaa
Intervall	aikaväli
Spiegel	peilit
untersuchen	tutkia
deine	sinun
Platten	paneelit
wiederholt	toistettu
Angriff	hyökkäys
Hirsch	Peura
Zunge	kieli
Bowling	keilailu
tri	tri
Affe	apina
Anteil	osa
Rock	hame
Analysen	analyysit
Zeichnungen	piirustukset
Bedeutung	merkitys
Szenario	skenaario
Ihr	te
Arabisch	arabialainen
Spur	arvioida
Schutz	suojaava
konfrontiert	kohtasi
Auflösung	ratkaiseminen
produziert	tuottaa
intensiv	intensiivinen
Ketten	kahleet
sechste	kuudes
engagieren	sitoutua
Schaltung	kytkentä
Korrespondenz	kirjeenvaihto
Importe	tuonti
Aufsicht	valvonta
Ausgaben	menot
Trennung	erottaminen
Zeugnis	todistus
vermuten	epäilty
verpflichtend	pakollinen
Grenzen	rajoja
Feier	juhla
Filter	suodatus
Ehepartner	puoliso
exotisch	eksoottinen
Zuschauer	katsoja
reichend	päästäisiin
Lachen	nauraa
chirurgisch	kirurginen
zerstören	tuhota
Zitat	lainaus
yo	yo
Lokal	tilat
bewährt	osoittautui
beleidigend	hyökkäys
Kaiserliche	keisarillinen
Dutzend	tusina
Einsatz	käyttöönotto
Stoff	kangas
Lotus	lootus
Lachs	lohi
Ladung	lasti
Direktive	direktiivi
Kamerad	perämies
Butter	voi
Pfeffer	pippuri
Waffe	ase
Belastung	taakka
Bänder	nauhat
Zonen	vyöhykkeet
Insel	saari
schlank	hoikka
Ahorn	vaahtera
Lebensmittelgeschäft	ruokakauppa
Regierungs	hallitseva
Depot	varikko
alt	alt
Kuchen	piirakka
Mischung	sekoitus
Emission	päästö
ersichtlich	näennäinen
Lehr	neuvonta
Berechtigungen	käyttöoikeudet
Toilette	WC
Platz	sijoittui
Routen	reitit
Montage	asennus
gebunden	sidottu
ausgewogen	tasapainoinen
verspätet	myöhässä
Tal	laakso
Berechnung	laskeminen
Villen	huvilat
Gelegenheiten	Tilaisuudet
Gleichungen	yhtälöt
Öl	öljyt
September	syyskuu
außergewöhnlich	poikkeuksellinen
Angst	levottomuus
räumlich	tila
Befragten	vastaajat
Überlegungen	näkökohdat
zahlt	maksaa
sonnig	aurinkoinen
liefert	toimittaa
je	je
Halskette	kaulakoru
zusammengesetzt	yhdistelmä
lang	lang
Theater	teatterit
Entwerfen	suunnittelu
Hoffnungen	toivoo
Beurteilungen	arvioinnit
Diagramm	kaavio
Schuhwerk	jalkineet
sg	SG
Völker	kansojen
Sieger	voittaja
Lizenzen	lisenssejä
Bereiche	vaihtelee
Paare	paria
Empfindlichkeit	herkkyys
Erhaltung	säilytys
isoliert	yksittäinen
Interim	väliaikainen
unterstützt	avustaa
göttlich	jumalallinen
genehmigen	hyväksyä
Verbindung	yhdiste
Intensität	intensiteetti
technologisch	teknologinen
Abtreibung	abortti
Dialog	dialogi
Veranstaltungsorte	tapahtumapaikat
sprengen	räjähdys
Adressierung	käsitellään
Pole	napa
Schild	kilpi
Membran	kalvo
verzweifelt	epätoivoinen
Mütter	äidit
Demonstration	esittely
Regierungs	valtiosta
hergestellt	valmistettu
Kerzen	kynttilät
Variationen	muunnelmat
Mütter	äidit
heilig	pyhä
Sucht	riippuvuus
Chrom	kromi
verweigert	kieltäytyi
Bremse	jarru
Außen	ulkopuoli
Gruß	tervehdys
Ökologie	ekologia
Tal	laakso
Arbeitslosigkeit	työttömyys
erzielter	sijoitettiin
Erweiterung	lisälaite
Klon	klooni
Geschwindigkeit	nopeus
Lambda	lambda
zusammengesetzt	kokoonpanossa
Tränen	kyyneleet
Oase	keidas
Taxi	ohjaamo
Fa	fa
Gesellschaften	yhteiskunnissa
Silizium	pii
identisch	identtinen
Petroleum	maaöljy
konkurrieren	kilpailla
ist	ist
Liebhaber	rakastaja
gehören	kuulua
Lippen	huulet
begleiten	saattaja
Teich	lampi
Fähre	lautta
Hase	kani
Beruf	ammatti
Damm	pato
Physiologie	fysiologia
Ausfuhr	vientiä
Reifen	Rengas
Teilnehmer	osallistuja
Elektron	elektroni
Ladungen	kuormat
Heidekraut	kanerva
Motel	motelli
Gewerkschaften	ammattiliitot
Fiskus	valtiovarainministeriö
belegt	miehitetty
Waage	asteikot
Belastung	rasitus
verhaftet	pidätetty
Untersuchungen	tutkimuksia
gewonnen	sai
Wäsche	pesula
Erteilung	saattamisesta
einstellen	säätää
bewertet	arvioitu
Verschlüsselung	salaus
Füllung	täyte
auferlegte	määrätty
Schweigen	hiljaisuus
sowjetisch	Neuvostoliiton
Besitz	hallinta
Vertrag	sopimus
Trainer	kouluttaja
Organ	urut
Zitrone	sitruuna
Dunkelheit	pimeys
Spanne	jänneväli
Scherz	vitsi
Verpackung	pakkaus
Satzung	säädös
abgelehnt	hylätty
Schutz	suoja
Kapelle	kappeli
Herstellung	valmistus
Lagen	kerroksia
feiern	juhlia
Gerät	laite
Mischung	seos
Fahrer	ratsastaja
Radius	säde
beeindruckend	vaikuttava
Schaf	lammas
Architekt	arkkitehti
Vorlesungen	luennot
Weine	viinit
Tassen	kupit
Asche	tuhka
Beiträger	avustajat
Salat	salaatti
Verletzungen	rikkomuksia
Temperaturen	lämpötilat
Wettbewerbe	kilpailut
erhalten	säilyttää
Gedicht	runo
bleiben	pysyminen
Ostern	pääsiäinen
Theorien	teoriat
Repository	säilytyspaikka
Strom	virtoja
Landung	lasku
hingerichtet	teloitettiin
Verhandlungen	neuvottelut
realistisch	realistinen
fragt	kysyy
Zusammenfassung	tiivistelmä
Komponist	säveltäjä
Bohne	papu
Schwert	miekka
Modifikationen	muutoksia
Koralle	koralli
Pixel	pikselin
Wegen	polut
Blase	kupla
por	por
erwerben	hankkia
Gegenteil	päinvastainen
Tribun	Tribune
Schiff	alus
Säuren	hapot
Viren	virukset
Aufkleber	tarroja
Reaktionen	reaktiot
Glauben	uskomukset
Kader	ryhmä
analysieren	analysoida
Divisionen	alueet
schwimmen	uida
nano	nano
Konzerte	konsertit
Männchen	urokset
behalten	säilyttää
Farben	värit
ausführen	suorittaa
Tunnel	tunneli
Genre	tyylilajit
Patente	patentit
Weizen	vehnä
Chroniken	aikakirjat
Beschaffung	saada
Biber	majava
Lesungen	lukemat
Erweiterung	laajennus
Adler	Eagles
Basen	emäkset
Angeklagte	syytetty
Kampagnen	kampanjat
Einheit	yhtenäisyys
definiert	määritellään
Instanzen	tapauksissa
einheimisch	kotoperäinen
begonnen	alkaneet
Pakete	paketit
Anker	ankkuri
Socken	sukat
auslösen	laukaista
Cholesterin	kolesteroli
Differential	ero
Oberflächen	pinnat
furchtbar	kauhea
Router	reitittimet
Uhren	kellot
Arthritis	niveltulehdus
BIOS	BIOS
Weibchen	naaraat
spiegelt	heijastaa
Besteuerung	verotus
Fieber	kuume
Küche	keittiö
sicherlich	varmasti
Praktiker	harjoittajat
Satz	lause
Inflation	inflaatio
dich	sinua
Verbindungen	yhdisteet
Schlagzeug	rummut
vernünftig	kohtuullisen
blank	paljas
Radikale	radikaali
empfiehlt	suosittelee
Regelung	valvontaan
Schatz	aarre
Flamme	liekki
Grube	kuoppa
Mono	mono
Partikel	hiukkasia
schwimmend	kelluva
Koordinate	koordinoida
ausschließlich	yksinomaan
Einschränkung	rajoitus
geschlagen	iski
Illustration	kuva
Warnungen	varoitukset
bauen	rakentaa
Apps	sovellukset
Anfragen	kyselyt
annektieren	liite
Inspiration	inspiraatio
Fracht	rahti
Finsternis	pimennys
wirkt	vaikuttaa
Prognosen	ennusteet
entdecken	havaita
aktiv	aktiivisesti
kompliziert	monimutkainen
verletzt	loukkaantunut
Ausdrücke	ilmauksia
Tonne	tonni
Kurier	kuriiri
Hinweise	vihjeitä
gif	gif
Konflikte	konfliktit
Getränk	juoma
Tribut	kunnianosoitus
immun	immuuni
Forstwirtschaft	metsänhoito
Barrieren	rajat
kippen	kallistus
selten	harvoin
Angebote	tarjoukset
Barriere	este
Fahrrad	polkupyörä
Einrichtung	kalusteet
entstehen	nousta
keltisch	kelttiläinen
Partikel	hiukkanen
Feuchtigkeit	kosteus
Flaschen	pullot
dm	dm
Renaissance	renessanssi
Verordnung	määräys
Fotografen	valokuvaajat
Infektionen	infektiot
Schach	shakki
arbeitet	toimii
Feste	festivaalit
Möglichkeiten	mahdollisuuksia
Ente	Ankka
Kanal	kanava
Beitrag	myötävaikuttaa
Kuh	lehmä
analytisch	analyyttinen
Kostüme	puvut
streng	tiukka
Verkehr	verenkierto
Delikt	rikkomus
Annahme	olettamus
Hobby	harraste
Versuche	yrittää
Erfindung	keksintö
Techniker	teknikko
Führungskräfte	johtajat
Anfragen	kyselyt
kognitiv	kognitiivinen
erforschen	tutkia
Trick	temppu
Anfrage	tiedustelu
Schließung	päättäminen
Bauholz	puutavara
Volt	voltti
heftig	voimakas
Unterstützer	kannattajat
Satzung	säädökset
eingeschrieben	kirjoilla
Sensoren	anturit
Schraube	ruuvi
Minister	ministerit
öffentlich	julkisesti
litt	kärsi
Aufnahme	otto
Schmetterling	perhonen
Mechanik	mekaniikka
Header	otsikot
Fehler	virheitä
numerisch	numeerinen
definieren	määrittelemällä
Zählen	laskenta
Betrachtung	heijastus
Einladung	kutsu
Natrium	natrium
Hormon	hormoni
Kinder	lasten
Backstein	tiili
Griff	pito
mittelalterlich	keskiaikainen
Porzellan	posliini
gefangen	kaapattu
anständig	kunnollinen
Guss	valu
übersetzt	käännetty
Donna	donna
Krieger	soturi
Kabine	hytti
Scannen	skannaus
Polo	poolo
Kopieren	kopiointi
Horn	sarvi
Journalismus	journalismi
Frosch	sammakko
Grammatik	kielioppi
Absicht	tarkoitus
Reifen	renkaat
unternommen	toteutetut
Gefahr	vaara
Folgen	jaksot
kreisförmig	pyöreä
Zorn	suututtaa
Abbildungen	kuvitukset
Chancen	mahdollisuudet
Glück	onnellisuus
bizarr	outo
ur	Ur
Früchte	hedelmät
Kennzeichnung	tunnisteen
Band	nauha
Berechnungen	laskelmat
jpeg	jpeg
Anfang	aloittaa
praktisch	kätevä
Wechsel	vaihtaa
befreit	vapauttaa
Pflanzen	viljelykasvien
reduziert	vähentää
durchgeführt	aikaan
Geometrie	geometria
Eindruck	vaikutus
Gilde	kilta
Korrelation	korrelaatio
sim	sim
nervös	hermostunut
Duft	tuoksu
Replik	kopio
Stamm	heimo
Trades	kaupat
hervorragend	loistava
loswerden	eroon
Dreieinigkeit	kolminaisuus
abgewickelt	käsiteltävä
Legenden	legendoja
Boom	puomi
Ruhe	rauhoittaa
Meister	Mestarien
Etagen	lattiat
Auswahlen	valinnat
Vergleichen	verrataan
spricht	puhuu
beruflich	ammatillinen
Apotheken	apteekit
ln	ln
Rolle	rulla
Stapel	erä
organisieren	järjestää
geschätzt	Ymmärretään
ändern	muuttaa
Kanten	reunat
Vermischung	sekoittaminen
Griffe	kahvat
Harmonie	harmonia
vornehm	hienostunut
Asthma	astma
Annahmen	oletukset
geregelt	säännelty
Dreieck	kolmio
ändern	muuttaa
erwartet	ennakoitua
orientalisch	itämainen
Belohnung	palkinto
Wasserstoff	vety
vergleichbar	vertailukelpoinen
befürworten	puolestapuhuja
Verwechslung	sekaannus
Eingänge	tulot
Garantien	takuut
Genom	perimä
Medaille	mitali
Trainer	valmentajat
Schiffe	alukset
Hafen	satama
Öko	Eco
verletzlich	haavoittuva
ordnen	järjestää
künstlerisch	taiteellinen
Ehrungen	kunnianosoitukset
reflektiert	heijastunut
einheitlich	yhdistynyt
Rasse	rotu
Detektor	ilmaisin
ignoriert	huomiotta
präzise	täsmällinen
Auswertung	arviointiin
Lippe	huuli
versammeln	kerätä
Bildung	muodostaen
Journalisten	toimittajat
leicht	hienoinen
indirekt	epäsuora
unter	keskuudessa
Stiftungen	perustukset
Horizont	horisontti
nu	nu
tief	syvään
Verbindlichkeiten	velat
Preise	palkinnot
verringert	vähentynyt
beschreiben	kuvaava
Optik	optiikka
verfolgen	jatkaa
Blitz	salama
ou	ou
Zitate	lainaukset
Inspektor	tarkastaja
Schlange	käärme
Erinnerung	muistutus
gesucht	etsinyt
Flachland	Plains
Einblicke	oivalluksia
Fähigkeiten	kyvyt
initiiert	aloitettu
Karaoke	karaoke
Falle	ansa
einsam	yksinäinen
ve	ve
beobachten	tarkkailla
Behälter	kontit
Einstellungen	asenteet
Beere	marja
Halsband	kaulus
integrieren	yhdistää
Soziologie	sosiologia
Exponate	näytteille
stirbt	kuolee
Terrasse	terassi
Bakterien	bakteerit
sollen	pitäisi
köstlich	herkullinen
Traditionen	perinteet
endlich	rajallinen
sendet	lähettää
dauerhaft	kestävä
verbündet	liittoutunut
Feuchtigkeit	kosteus
verwandeln	muuttaa
Timer	ajastin
Tablets	tabletit
bekommen	saatu
Erzieher	kasvattajat
Gemüse	vihannes
Vers	jae
unabhängig	itsenäisesti
Konkurrenz	kilpailijat
Rakete	raketti
Ja	kyllä
Kugel	luoti
Türme	tornit
Sichtweite	näkyvyys
Breite	leveysaste
Bewusstsein	tajunta
Tumor	kasvain
hässlich	ruma
Einlagen	talletukset
Herrin	emäntä
Begegnung	kohdata
Watt	wattia
vierzig	neljäkymmentä
Röhren	putket
versucht	yritettiin
Priester	pappi
Analysten	analyytikot
Hammer	vasara
Invasion	invaasio
Läufer	juoksija
Reihen	riviä
verabreicht	annettuna
Begriff	käsite
Rechtschreibung	oikeinkirjoitus
Arktis	arktinen
Belohnt	palkintoja
unter	alla
stärken	vahvistaa
verteidigen	puolustaa
infrarot	infrapuna
siebte	seitsemäs
Bauch	vatsa
aggressiv	aggressiivinen
Anzeigen	mainoksia
Quartier	neljäsosaa
gestohlen	varastettu
bestimmt	määrittää
Skulptur	veistos
Poly	poly
Ohren	korvat
Faust	nyrkki
Neo	neo
Motivation	motivaatio
Passagiere	matkustajien
konsequent	johdonmukaisesti
Überschuss	ylijäämä
graben	kaivaa
Taxi	Taksi
Anerkennung	arvostus
om	om
Beschränkung	rajoitus
Gitarren	kitarat
Wesen	olemus
mächtig	mahtava
Menschheit	ihmiskunta
Transkription	transkriptio
Komplikationen	komplikaatioita
Wissenschaftler	tutkijat
Galaxis	galaksi
Pflege	huolehtiva
Testament	testamentti
Dominant	hallitseva
Bauch	vatsa
teilweise	osittain
minimieren	minimoida
Reihen	rivit
Debüt	debyytti
Generationen	sukupolvet
Turniere	turnaukset
verweigern	kieltää
Anatomie	anatomia
Kopfhörer	kuulokkeet
Fraktion	jae
Trio	trio
Vorgehen	menettely
Würfel	kuutio
Defekte	vikoja
Unsicherheit	epävarmuus
Nervenzusammenbruch	hajota
geregelt	ratkaistu
Impfstoff	rokote
Schicksal	kohtalo
Buchungen	varaukset
Republikaner	republikaanit
Dschungel	viidakko
Zen	zen
dis	dIS
Prognose	ennustus
ökologisch	ekologinen
Oval	soikea
impliziert	viittaa
ser	ser
Bewertung	arviointi
Aussicht	näkymä
geographisch	maantieteellinen
Spender	luovuttaja
Spannung	jännitys
Müll	roska
Formen	muodot
Stufe	porras
Graf	jaarli
Heimat	kotimaa
Meisterschaft	mestaruutta
Rassen	rodut
Disko	disko
aus	aus
Veredelung	viimeistely
Emotionen	tunteet
ewig	ikuinen
Drehung	kierto
nam	nam
produktiv	tuottava
Boulevard	bulevardi
Schwein	sika
metrisch	metrinen
Strafen	seuraamukset
abwechslungsreicher	monipuolinen
grande	grande
Darstellerin	näyttelijä
zuordnen	luovuttaa
unterbringen	majoittaa
Tiger	Tiikerit
Dörfer	kyliä
Schatten	sävy
Chor	kertosäe
Rhythmus	rytmi
Ziffer	numero
Symphonie	sinfonia
plötzlich	äkillinen
Annehmen	hyväksymisestä
Schwimmbäder	altaat
lyrisch	lyyrinen
Isolierung	eristäminen
Geschwindigkeiten	nopeudet
nachhaltig	jatkuva
abgestimmt	Hyväksytty
ungefähr	lähentää
Seil	köysi
rational	järkevä
Programmierer	ohjelmoija
Kämpfer	taistelijat
vererbt	peritty
unvollständig	epätäydellinen
Gesang	laulu
Brunnen	suihkulähde
legitim	laillinen
Biographien	elämäkerrat
Ermittler	tutkija
Kläger	kantaja
sanft	lempeä
würdig	arvokas
Architekten	arkkitehdit
Heilige	pyhimykset
Unternehmer	yrittäjä
trägt	kuljettaa
Duo	duo
überhöht	liiallinen
spart	säästää
angesehen	pitää
Bewertung	arvostus
unerwartet	odottamaton
Nebel	sumu
charakteristisch	luonteenomainen
Empfangshalle	aula
skizzierte	hahmoteltu
enorm	valtava
Karma	karma
bestehen	muodostuvat
Königinnen	kuningattaret
Wissenschaftler	tutkijoita
Stämme	heimot
Unterscheidung	ero
Gefahren	vaarat
Befreiung	vapautus
Mieter	vuokralainen
Nachhaltigkeit	kestävyys
Tätowierung	tatuointi
Algebra	algebra
Schatten	varjot
dumm	typerä
frei	vapaasti
mild	lievä
Pelz	turkis
leicht	helposti
Zugehörigkeit	kuuluminen
Zaun	aita
unendlich	ääretön
Clan	klaani
Revolutionär	vallankumouksellinen
Armbänder	ranneketta
Abhilfe	parannuskeino
Atmung	hengittäminen
kurz	lyhyesti
Dicke	paksuus
grafische	graafinen
Genius	nero
Diskussion	keskustella
Kämpfer	taistelija
sinnvoll	mielekäs
adaptiert	muokattu
Ländereien	säädyt
Teppich	matto
Demokrat	demokraatti
Bezirk	kauppala
hält	ylläpitää
ka	ka
beibehalten	säilytetään
Marmor	marmori
DM	dem
Meditation	meditaatio
Mikrofon	mikrofoni
Vereinigung	Yhdistämällä
Riesen	jättiläiset
organisieren	organisointi
Memo	muistio
Schinken	kinkku
gelöst	ratkaistu
Tide	vuorovesi
Trennwand	väliseinä
unsichtbar	näkymätön
Konsolen	konsolit
Magnet	magneetti
Übersetzungen	käännökset
Jaguar	jaguaari
Ware	hyödyke
Kilometer	kilometriä
Garantien	takeita
gotisch	gotiikka
Zylinder	sylinteri
Hexe	noita
Bock	pukki
Feinde	viholliset
Beratung	konsultointi
genießen	nauttii
patrouillieren	partio
Geruch	haju
Karneval	karnevaali
grob	karkeasti
Aufkleber	tarra
Versprechen	lupauksia
Riff	riutta
Teilen	jakaa
aufeinanderfolgenden	peräkkäinen
bon	Bon
Vorstellungen	esitykset
chan	chan
Melodien	sävelet
mas	mas
Sätze	lausekkeet
kai	kai
Halbinsel	niemimaa
langweilig	tylsää
dom	dom
Reden	puheet
erreicht	saavuttaa
Schema	kaavio
Kataloge	luettelot
Ministerien	ministeriöiden
parlamentarisch	parlamentin
Präfix	etuliite
Savanne	savanni
Fass	tynnyri
Nerv	hermo
dans	dans
Planeten	planeetat
Defizit	alijäämä
erneuern	uudistaa
gekoppelt	kytketty
Schaltungen	piirit
Textur	rakenne
bestätigen	tunnustaa
Zelt	teltta
identifiziert	tunnistaa
Qualifikation	pätevyys
Schlösser	lukot
Miniatur	miniatyyri
Euro	euroa
Piraten	merirosvot
Antenne	antenni
Falke	haukka
Folge	seuraus
systematisch	systemaattinen
wahrgenommen	koettu
Ursprünge	alkuperä
gemietet	palkattu
bilden	meikki
ui	ui
Gewichte	painot
geologisch	geologinen
dauerhaft	kestävä
böse	paha
einleitet	esittelee
geschoben	työntää
ro	ro
Steigung	rinne
Dichter	runoilija
Verschwörung	salaliitto
Theologie	teologia
Nägel	kynnet
offensichtlich	ilmeinen
Fahrten	ratsastaa
Epos	eeppinen
Veranstalter	järjestäjä
Allergie	allergia
Sake	vuoksi
Kombinationen	yhdistelmät
vorangestellt	edeltävä
verdienen	ansio
Enzym	entsyymi
Flugzeuge	lentokoneita
Scheiben	levyt
Verstärker	vahvistin
willkürlich	mielivaltainen
prominent	näkyvä
sans	sans
baut	rakentaa
kontaktiert	yhteyttä
Welle	akseli
lehnen	nojata
gelegentlich	satunnainen
Innovationen	innovaatiot
Überprüfung	tarkistetaan
Panik	paniikki
Staatsbürgerschaft	kansalaisuus
Ausrede	tekosyy
Reformen	uudistuksia
Zwiebel	sipuli
Sandwich	voileipä
Alt	altto
Hierarchie	hierarkia
verlassen	hylätty
Kreise	piireissä
Beats	lyöntiä
fröhlich	iloinen
Kult	kultti
Strich	kojelauta
passiv	passiivinen
geschätzt	arvostettu
Käfig	häkki
Mut	rohkeus
Elevation	korkeus
Runde	kierros
Nutzung	käyttö
Getränke	juomat
Klingeln	ping
unterhaltsam	viihteellinen
Voraussetzung	edellytys
Grenze	raja
Flüchtlinge	pakolaisten
Ritter	ritarit
Hypothese	hypoteesi
Medikamente	lääkkeet
geändert	muuttunut
Lehre	oppi
szenisch	luonnonkaunis
Erweiterungen	parannuksia
Überschneidung	leikkauspiste
Nähen	ompelu
Sammler	keräilijät
anerkannt	tunnistettu
Rage	raivo
prix	prix
Astrologie	astrologia
Berater	neuvonantajat
Pavillon	paviljonki
Taktik	taktiikka
Zusatz	täydentäviä
talentiert	lahjakas
Kissen	tyyny
Verbreitung	leviäminen
Provinzen	maakunnat
stehlen	varastaa
Paket	paketti
Vorfall	esiintyvyys
Ängste	pelot
vorhersagen	ennustaa
Geschmack	maku
hungrig	nälkäinen
metallisch	metallinen
Interferenz	häiriö
Krieger	soturit
atmosphärisch	ilmakehän
Heiligenschein	sädekehä
Eltern	vanhempien
verwiesen	viitattu
Streiks	lakkoja
Ameise	muurahainen
Vorschlag	ehdotus
geeignet	osuva
behandelt	käsitelty
Händler	kauppias
geworfen	heitetään
Kriterium	kriteeri
Abzeichen	kunniamerkki
Zivilisation	sivistys
Heide	nummi
enorm	valtava
führt	suorittaa
Reich	valtakunta
korrigiert	korjattu
Helm	kypärä
angetroffen	kohdanneet
Tsunami	tsunami
Gelehrte	tutkija
umgeben	ympäröimä
Geologie	geologia
Kreaturen	oliot
gelöscht	selvitetty
erreichen	suorittaa
Ecken	kulmat
Vegetarier	kasvissyöjä
Hefe	hiiva
pas	pas
sucht	tutkitaan
Botschafter	suurlähettiläs
beschichtete	päällystetty
Untergang	tuho
Routinen	rutiinit
Wesen	olentoja
Vertrauen	riippuvuus
Mythos	myytti
Bach	puro
fu	fu
Phänomen	ilmiö
Ensemble	kokonaisuus
versicherte	varma
bewusst	tajuissaan
Akzent	aksentti
Ehefrauen	vaimot
nutzen	käyttää
Versprechen	pantti
Vampir	vampyyri
Dock	telakka
organisiert	järjestetty
Musiker	muusikko
Begrenzung	rajoittamalla
restauriert	palautettu
Hinweis	vihje
Rüstung	panssari
Anmerkung	huomautus
Dutzende	kymmeniä
variiert	vaihtelee
Argumentation	perustelut
Wächter	vartijat
Öffnungen	aukot
Ersetzung	korvaa
Forscher	tutkija
Räte	valtuustot
Berufe	Ammatit
anerkannt	tunnustettu
Schweinefleisch	sianliha
zu	zu
Gleichgewicht	tasapaino
Rohre	putket
Hütten	mökit
verschmelzen	yhdistää
Privileg	etuoikeus
entwickelt	kehittyy
Chassis	alusta
Einschätzung	arvio
Scheune	lato
Frost	halla
Institute	laitokset
Schimmel	muotti
Freifrau	rouva
Yacht	jahti
bevorzugt	mieluummin
Bohrung	poraus
Kraut	yrtti
Bruch	rikkominen
Wal	valas
Reisende	matkustaja
Mittel	määrärahat
vermutlich	epäillään
Tomaten	tomaatit
Lehrer	ohjaajien
Schwung	vauhti
Flosse	evä
Pastor	pastori
Schlamm	muta
Smaragd	smaragdi
wächst	kasvaa
Traktat	alue
ul	ul
Ballett	baletti
Journalist	toimittaja
Religionen	uskonnot
Knoblauch	valkosipuli
scheinen	paistaa
Explosion	räjähdys
Slip	alushousut
Unterschriften	allekirjoituksia
Ozon	otsoni
Disziplinen	tieteenalojen
casa	Casa
Gespräche	keskustelut
Radios	radiot
Tarif	tulli
vereinfachte	yksinkertaistettu
Muskeln	lihakset
schnell	nopea
Vagina	emätin
Champagner	samppanja
Abweichung	poikkeama
Samba	samba
beschäftigen	käyttää
Pinguin	pingviini
magisch	maaginen
Einflüsse	vaikutteita
Inspektionen	tarkastukset
Bewässerung	kastelu
Wunder	ihme
hydraulisch	hydraulinen
Penetration	tunkeutuminen
Wunde	haava
Schöne	kaunotar
rosa	rosa
Überzeugung	vakaumus
faul	laiska
Qualitäten	ominaisuudet
Väter	isät
Lade	latauksen
wichtig	merkittävästi
zierlich	siro
Gerät	laitteet
Terrain	maasto
Erläuterung	selitetään
Streifen	nauhat
Nominierung	nimitys
empirisch	empiirinen
Wurm	mato
Abhängigkeit	riippuvuus
diskret	erillinen
Anfänger	aloittelija
Deckel	kansi
Sexualität	seksuaalisuus
Saphir	safiiri
Privilegien	etuoikeudet
spezialisiert	erikoistunut
Markierung	merkki
Sheriff	seriffi
abgelehnt	vähentynyt
Spion	vakoojia
Motorräder	moottoripyörät
wählen	valita
Autobahnen	valtatiet
konzentrieren	keskittää
intim	intiimi
Moleküle	molekyylit
Runde	kierrosta
Kühlschrank	jääkaappi
Intervalle	väliajoin
Sätze	lauseet
Holocaust	holokausti
Flieger	lentäjä
Erbsen	herneet
Dosierung	annostus
Unterschied	vaihtelu
Navigator	Navigator
Nadel	neula
Bad	kylpylä
Bremsen	jarrut
og	og
ko	tyrmäys
besitzt	omistaa
Schicksal	kohtalo
Landschaften	Maisemat
Berechnung	laskeminen
Heu	heinä
Heil	pelastus
Vorhersagen	ennustukset
Lern	oppijat
Zeichen	symbolinen
Zink	sinkki
Opfern	uhrata
Sucher	etsijät
Guru	guru
geeignet	sopiva
numerisch	numeerinen
Anthropologie	antropologia
Kaiser	keisari
grad	Grad
Gürtel	vyöt
Schwarze	mustat
gebildet	sivistynyt
stolz	ylpeänä
Notwendigkeit	välttämättömyys
Kurven	käyrät
Touren	farmari
Scheitel	kärki
Tomate	tomaatti
Reisen	matkustaa
blass	kalpea
Funktion	toiminta
Wirtschaft	talouksien
unternehmen	sitoutuvat
erklären	julistaa
Ventile	venttiilit
Lücken	aukkoja
Erfolge	saavutukset
reißen	repiä
lehrt	opettaa
Null	nolla
Fremder	muukalainen
Nest	pesä
Gericht	tuomioistuin
ausgeschlossen	sulkea
Pensionen	eläkkeet
Gebete	rukoukset
Polizist	poliisi
Jugendliche	nuori
Nominierungen	ehdokkaat
Banane	banaani
einleitend	alustava
Reservoir	varasto
Auftreten	esiintyminen
Idol	idoli
blutig	verinen
erinnern	muistuttaa
reizend	viehättävä
Zahn	hammas
respektierte	arvostettu
Aufenthalte	pysyy
Affäre	asia
beschränken	rajoittaa
Minen	kaivokset
Porträts	muotokuvia
interpretiert	tulkita
Auswertungen	arvioinnit
Beseitigung	eliminointi
Meter	metriä
hypothetisch	hypoteettinen
Hubschrauber	helikopteri
Bleistift	lyijykynä
Künstler	esiintyjä
Provisionen	palkkiot
Kugel	pallo
Moos	sammal
Verhältnisse	suhteet
Eintracht	sopu
graduierte	porrastettu
unterstützt	hyväksyttiin
überraschend	yllättävä
Lanze	peitsi
Leiter	tikapuut
Kork	korkki
Senatoren	senaattorit
Blutung	verenvuoto
Charakterisierung	luonnehdinta
Wahrscheinlichkeit	todennäköisyys
Bahnen	kaistat
Grundlage	perusteet
Kontamination	saastuminen
Kuppel	kupoli
segnen	siunata
Verhandlung	neuvottelu
Kamm	harja
Gegner	vastustajat
Triumph	riemuvoitto
nominiert	nimitetty
Schweißen	hitsaus
Orgasmus	orgasmi
Legierung	metalliseos
Stellplätze	tontteja
sanft	kevyesti
Sperrung	lukitus
umstritten	kiistanalainen
Unentschieden	kiinnittää
Kühlschrank	jääkaappi
Klingen	terät
Schlaufen	silmukoita
Schwall	aalto
Trauma	trauma
Inserat	ilmoitus
Defensive	puolustava
verboten	kielletty
Vanille	vanilja
Programmierer	ohjelmoijat
überwacht	seurataan
Installationen	laitteistot
Seelen	sielut
motiviert	motivoitunut
Dumm	tyhmä
hohl	ontto
Gewölbe	holvi
Rille	ura
Offenbarung	paljastus
Verfolgung	pyrkimys
Delegation	valtuuskunta
Drähte	johdot
Wörterbücher	sanakirjoja
Transparenz	läpinäkyvyys
Orbit	kiertorata
Währungen	valuutat
Niger	Niger
Positionierung	paikannus
Kolonie	siirtomaa
Kanone	tykki
Zirkus	sirkus
gefördert	ylennetty
Forelle	taimen
Leistung	saavutus
vorübergehend	väliaikaisesti
gekocht	valmistettu
übertragen	lähettää
Frequenzen	taajuudet
Reflexionen	ajatukset
Hunger	nälkä
Gemeinde	kunta
Detektiv	etsivä
Zement	sementti
erleben	kokee
Kamin	takka
Billigung	merkintä
Textilien	tekstiilit
Rakete	ohjus
Psychiatrie	psykiatria
Assists	avustaa
Rechnungsprüfer	tilintarkastaja
Geige	viulu
Prophet	profeetta
Oxid	oksidi
ausgezeichnet	upea
sofort	viipymättä
Anpassung	sovittaminen
schädlich	haitallinen
sexuell	seksuaalisesti
Gehege	liite
Glucose	glukoosi
Norm	normi
Wiedergabe	toisto
Schildkröte	kilpikonna
Entfernungen	etäisyydet
Absorption	imeytyminen
Schätze	aarteita
Fossil	fossiili
schlecht	huonosti
Kommunist	kommunistinen
Unternehmer	yrittäjät
Roboter	robotit
Foul	virhe
Biodiversität	biodiversiteetti
Aufregung	jännitys
verbal	sanallinen
Meere	meret
mysteriös	salaperäinen
Neuheit	uutuus
Fliesen	laatat
Bibliothekar	kirjastonhoitaja
schaltet	kytketty
ru	ru
Pose	aiheuttaa
Gramm	grammaa
Therapeut	terapeutti
Budget	budjetit
Ziege	vuohi
machen	tehdä
Segel	purjehtia
Kommissare	komissaarit
dicht	tiheä
mutig	urhea
Spedition	huolinta
furchtbar	hirveä
Flugzeug	lentokone
Organismen	organismit
Fernrohr	teleskooppi
Asbest	asbesti
Förderung	edistäminen
Weide	paju
Bewerbungen	jatkuu
existierte	olemassa
Generatoren	generaattorit
erzeugt	synnyttää
Kartoffeln	perunat
gründlich	perusteellinen
Rezeptoren	reseptorit
Optimum	optimaalinen
Kreatur	olento
einsam	yksinäinen
subtil	hienovarainen
Streifen	raidat
Firmware	firmware
Schäfer	paimen
Wiege	kehto
Kanzler	liittokansleri
Mehl	jauhot
Kontroverse	kiista
legendär	legendaarinen
Chor	kuoro
Vermeidung	välttää
schön	kauniisti
erwartet	odottaa
Springen	hyppy
Stoffe	kankaat
Polymer	polymeeri
Hygiene	hygienia
Tugend	hyve
Chirurgen	kirurgit
Mandat	mandaatti
Korpus	corpus
Terminologie	terminologia
Gentleman	herrasmies
verurteilt	tuomittu
Jet	suihkukoneet
Indizes	indeksit
qui	qui
bedrohlich	uhkaava
Aktivisten	aktivistit
Häftling	vanki
ermutigt	kannustaa
gebaut	koolla
Terminals	terminaalit
roh	raaka
Untersucht	tutkii
Wikinger	viikinki
Aufräumen	siivota
bedingt	ehdollinen
angegriffen	hyökkäsi
kommt	saapuu
Übersetzer	kääntäjä
Automobil	autojen
Traktor	traktori
Kontinent	maanosa
Tarife	hintoja
Längengrad	pituusaste
hoffte	toivoneet
Einfügung	lisäys
Zwang	rajoite
Stärkung	vahvistaminen
wünschen	haluaa
Isolierung	eristys
Verletzung	rikkominen
gebogen	taipunut
subjektiv	subjektiivinen
Monster	hirviöt
Asyl	turvapaikka
Anteil	panos
Cocktail	cocktail
Sorten	lajikkeet
Gift	myrkyttää
dominiert	hallitsi
teuer	kallis
Derivate	johdannaiset
verhindert	estää
Gewehr	kivääri
Rassismus	rasismi
interpretieren	tulkita
Übereinstimmung	sopimus
bescheiden	vaatimaton
Spieler	pelaajat
Sortierung	lajittelu
Liaison	yhteys
Glühbirnen	sipulit
Touristen	turistit
Verhaltensweisen	käyttäytymistä
klären	selventää
Taille	vyötärö
zugeschrieben	johtuvan
Eule	pöllö
Kristalle	kiteet
überschreitet	ylittää
komplementär	täydentävä
Kämpfe	taistelut
bitter	katkera
Memorandum	muistio
Drachen	lohikäärmeitä
Lärm	melu
unglaublich	uskomattoman
Delegierte	osanottajaa
psychiatrisch	psykiatrinen
Jugendliche	nuoret
Hof	piha
Präsidenten	presidentit
abfahren	lähteä
ausdrücklich	nimenomaan
Lilie	lilja
Aufsicht	erehdys
Harz	hartsi
Alliierte	liittoutuneet
konserviert	säilytetty
gekreuzt	ristissä
aufsteigend	nouseva
nominal	nimellinen
zerfallen	rappeutuminen
Quarz	kvartsi
Register	rekisterit
achte	kahdeksas
autorisiert	valtuutettu
verbessert	parantaa
Befürworter	kannattaa
Phänomene	ilmiöitä
Neigung	kallistaa
Granit	graniitti
Volk	massat
Athlet	urheilija
Franc	frangi
Ähnlichkeit	samankaltaisuus
Leck	vuotaa
Berater	neuvonantaja
Broschüre	kirjanen
erwartet	odottaa
Umsatz	liikevaihto
Urin	virtsa
Handtuch	pyyhe
Ingwer	inkivääri
Chromosom	kromosomi
als	als
Fliegen	kärpäset
Kompetenz	pätevyys
Weinen	huutava
Amateure	amatöörit
Kran	nosturi
Untersuchung	tutkii
faul	mätä
Gewohnheit	tapa
Ehre	kunnia
schützt	suojaa
Iris	iiris
verwaltet	hallinnoi
Erosion	eroosio
Zimmermann	puuseppä
Khan	kaani
unzureichend	riittämätön
Formulierung	muotoilu
klug	taitava
Herren	ylähuone
angenehm	nautittava
Halbmond	puolikuu
sechzig	kuusikymmentä
konzentriert	keskitetty
unterscheiden	erottaa
ei	EI
Projektionen	ennusteet
Funke	kipinä
Sicherung	turvaaminen
Weg	polku
Detektoren	ilmaisimet
Spitze	piikki
Zutat	ainesosa
Vorhang	verho
offenbart	julkaisussa
taktisch	taktinen
Piloten	lentäjät
Expedition	retkikunta
operativ	operatiivinen
Humor	huumori
mol	mol
Impressum	jälki
Unterstützung	avustaminen
Defekt	vika
schlecht	huonosti
Göttin	jumalatar
Beobachter	tarkkailijat
Magneten	magneetit
Formeln	kaavat
geräumig	tilava
argumentiert	väittää
Böden	maaperä
Organe	elimet
det	det
Loyalität	uskollisuus
treu	luotettava
Delikt	rikkomus
Lithium	litium
Sprung	harppaus
Gründung	perustamisen
Schwan	joutsen
Pflanzung	istutus
Bündnis	liitto
Archäologie	arkeologia
Matrose	merimies
Sorgen	huolet
Heiligtum	pyhäkkö
Statue	patsas
Zitat	lainaus
Majors	suurten
Manipulation	manipulointi
Glocken	kelloja
Toxizität	myrkyllisyys
Sender	lähetin
Nachbarschaften	lähiöissä
Trophäe	palkinto
Emotion	tunne
Sehenswürdigkeiten	nähtävyydet
Uniformen	univormut
verwundet	haavoittunut
Derivat	johdannainen
Belegung	käyttöaste
Dosen	annokset
erziehen	kouluttaa
Vorurteil	ennakkoluulo
Techniker	teknikot
wahrscheinlich	todennäköinen
Ausgabe	liikkeeseen
Dekoration	koriste
Angehörige	kansalaisten
Trojaner	troijalainen
Assistenten	avustajat
Berater	neuvonantaja
erlassen	sääti
instabil	epävakaa
gedrängt	kehotti
reflektierenden	heijastava
Gewinnung	saamassa
endgültig	lopullinen
gereist	matkusti
anpassen	sopeuttaa
Beitritt	liittymistä
Regler	säädin
Brennstoffe	polttoaineet
Soja	soija
ordentlich	siisti
Benennung	nimeäminen
Stern	perä
gearbeitete	muotoillun
Dummkopf	idiootti
besteht	käsitti
Aliens	ulkomaalaisten
Änderungen	muokkaukset
Rabe	korppi
Wohnung	asunto
symbolisch	symbolinen
Winkel	kulmat
Drücke	paineet
Venus	Venus
Flammen	liekit
Primitive	primitiivinen
Strumpf	sukka
Ökosystem	ekosysteemi
Hallen	hallit
Einfachheit	yksinkertaisuus
Dämon	demoni
begrüßt	tyytyväinen
Notation	merkintätapa
Tante	täti
Krähe	varis
semantisch	semanttinen
abgesetzt	lopetettu
entscheidet	päättää
Globalisierung	globalisaatio
Esel	aasit
Kompass	kompassi
gewachsen	kehittynyt
Infanterie	jalkaväki
berühmt	kuuluisa
Gang	käytävä
philosophisch	filosofinen
Rechtfertigung	oikeutus
unbesetzt	vapaa
Festsetzung	vahvistamisesta
Gramm	gramma
versteckt	piilossa
Farbstoff	väriaine
Alphabet	aakkoset
gereinigt	puhdistettu
geehrt	kunnioitettava
optisch	optinen
Telefone	puhelimet
Tagebücher	päiväkirjat
Trauer	suru
Schweiß	hiki
Delphin	delfiini
Wunder	ihmeitä
Belüftung	ilmanvaihto
Masken	maskit
Büste	rintakuva
Gasse	kuja
Bahnen	reittejä
Telegraph	lennätin
Monument	monumentti
formal	muodollisesti
Tau	kaste
zurückgezogen	peruutettu
Debatten	keskustelut
Identitäten	identiteetit
Mangel	puute
Sattel	satula
Malaria	malaria
treu	uskollinen
Tendenz	suuntaus
verwendet	hyödynnetty
ein	ein
Fernglas	kiikari
einleiten	aloittaa
rein	puhtaasti
lebendig	eloisa
Behauptungen	väitteitä
entspricht	vastaa
Daemon	demoni
gefeiert	juhlittu
Jäger	metsästäjät
handelten	toimi
Koeffizient	kerroin
Schädel	kallo
Fortsetzung	jatkaminen
Diener	palvelija
Falke	haukka
gemeinsam	yhdessä
vermieden	välttää
Erklärungen	selitykset
erneuert	uudistunut
Kritiker	kriitikko
Sediment	sedimentti
Quadrate	neliöt
Lieferwagen	pakettiautot
Kegel	kartio
überlebt	selviytyi
Häufigkeit	yleisyys
Fragment	kappale
verpflichtet	sitoutuu
Kobra	kobra
warf	heitti
hoc	hoc
Darsteller	esiintyjät
Dessert	jälkiruoka
Dissertation	väitöskirja
neunte	yhdeksäs
Begeisterung	innostusta
Feierlichkeiten	juhlia
Gouverneure	kuvernöörit
Atome	atomia
Gewebe	kudokset
Rampe	ramppi
schön	kauniisti
della	della
Vorherrschaft	ylivalta
Akkorde	sointuja
Beeinträchtigung	vajaatoiminta
Molekül	molekyyli
