von	arasında
zu	için
im	içinde
zum	için
ist	olduğu
auf	üzerinde
Das	o
durch	tarafından
Dies	bu
mit	ile
ich	ben
Sie	sen
es	o
oder	veya
Sein	olmak
sind	Hangi
beim	en
alle	herşey
haben	var
Neu	yeni
wir	Biz
werden	irade
Zuhause	ev
uns	bize
Über	hakkında
ob	Eğer
Seite	sayfa
meine	benim
hat	vardır
Suche	arama
frei	ücretsiz
aber	fakat
unser	bizim
ein	bir
andere	diğer
machen	yap
Information	bilgi
Zeit	zaman
er	o
welche	hangi
ihr	onların
Nachrichten	haber
benutzen	kullanım
Dort	Orada
sehen	görmek
damit	yani
Wer	kim
Netz	ağ
ebenfalls	Ayrıca
bekommen	almak
pm	pm
Aussicht	görünüm
c	c
e	e
zuerst	ilk
gewesen	olmuştur
würde	olur
wurden	idi
s	s
mögen	sevmek
x	x
als	göre
finden	bulmak
Preis	fiyat
zurück	geri
oben	üst
Menschen	insanlar
hätten	vardı
Liste	liste
Name	isim
gerade	sadece
Jahr	yıl
Tag	gün
in	içine
zwei	iki
Gesundheit	sağlık
n	n
Re	yeniden
benutzt	Kullanılmış
gehen	gitmek
b	b
letzte	son
machen	Yapmak
Sie	onları
sollte	meli
Produkt	ürün
System	sistem
Post	posta
ihr	ona
Stadt	Kent
t	t
Politik	politika
Nummer	numara
Unterstützung	destek
Botschaft	mesaj
nach	sonra
dann	sonra
Januar	Ocak
gut	iyi
d	d
woher	nerede
Info	bilgi
Rechte	haklar
Bücher	kitaplar
hoch	yüksek
Schule	okul
m	m
jeder	her
Links	bağlantılar
sie	o
Jahre	yıl
Auftrag	sipariş
sehr	çok
Buch	kitap
Artikel	ürün
Unternehmen	şirket
r	r
lesen	okumak
Gruppe	grup
Sex	seks
viele	çok
Benutzer	kullanıcı
de	de
einstellen	set
Allgemeines	genel
Forschung	Araştırma
Universität	Üniversite
Januar	Ocak
Post	posta
voll	tam
Bewertungen	yorumlar
Programm	program
kennt	bilmek
Spiele	oyunlar
Weg	yol
Tage	günler
p	p
Teil	Bölüm
könnte	could
groß	harika
vereinigt	birleşmiş
echt	gerçek
f	f
International	Uluslararası
Center	merkez
Reise	seyahat
Bemerkungen	yorumlar
gemacht	yapılmış
Entwicklung	gelişme
Bericht	rapor
Mitglied	üye
Einzelheiten	ayrıntılar
Linie	hat
Bedingungen	şartlar
Vor	önce
Hotels	oteller
tat	did
senden	göndermek
Recht	sağ
Art	tip
lokal	yerel
jene	bu
Ergebnisse	Sonuçlar
Büro	ofis
National	Ulusal
Auto	araba
Design	dizayn
nehmen	almak
Gesendet	gönderildi
Adresse	adres
Gemeinschaft	topluluk
innerhalb	içinde
Zustände	devletler
wollen	istemek
Telefon	telefon
DVD	DVD
Gegenstand	konu
zwischen	arasında
Forum	forum
Familie	aile
l	l
lange	uzun
w	w
Show	göstermek
O	O
sogar	Üstelik
schwarz	siyah
Besondere	özel
Index	indeks
Sein	olmak
Frau	KADIN
viel	çok
Schild	işaret
Datei	dosya
Verknüpfung	bağlantı
öffnen	açık
Süd	güney
Fall	dava
Projekt	proje
Seiten	sayfalar
Ausführung	versiyon
Sektion	Bölüm
besitzen	kendi
Haus	ev
Sicherheit	güvenlik
G	g
Bezirk	kontluk
amerikanisch	Amerikan
Foto	Fotoğraf
Spiel	oyun
Mitglieder	üyeler
Leistung	güç
Netzwerk	ağ
Computer	bilgisayar
Systeme	sistemler
drei	üç
Ort	yer
Ende	son
h	h
ihm	onu
pro	başına
Zugriff	erişim
denken	düşünmek
Norden	kuzeyinde
Ressourcen	kaynaklar
Strom	şimdiki
groß	büyük
Medien	medya
Recht	kanun
Steuerung	kontrol
Wasser	Su
Geschichte	Tarihçe
Größe	boyut
persönlich	kişisel
führen	kılavuz
Geschäft	Dükkan
Verzeichnis	rehber
Veränderung	değişiklik
Weiß	beyaz
Text	Metin
klein	küçük
Wertung	değerlendirme
Bewertung	oran
Regierung	hükümet
Kinder	çocuklar
Rückkehr	dönüş
Studenten	öğrencilerin
v	v
Konto	hesap
mal	zamanlar
Niveau	seviye
Digital	dijital
Profil	profil
Bisherige	önceki
bilden	form
Veranstaltungen	olaylar
Liebe	Aşk
alt	eski
John	John
Main	ana
Anruf	aramak
Bild	görüntü
Abteilung	Bölüm
Titel	Başlık
nicht	olmayan
k	k
y	y
Versicherung	sigorta
soll	acak
Eigentum	özellik
Klasse	sınıf
CD	CD
Qualität	kalite
jeden	her
Auflistung	listeleme
Inhalt	içerik
Land	ülke
wenig	küçük
Werkzeuge	araçlar
niedrig	düşük
Antworten	cevap
Kunde	müşteri
Dezember	Aralık
vergleichen	karşılaştırmak
Filme	filmler
Hochschule	kolej
Wert	değer
Artikel	makale
Mann	adam
Arbeitsplätze	Meslekler
j	j
Lebensmittel	Gıda
Autor	yazar
anders	farklı
u	u
lernen	öğrenmek
Verkauf	satış
drucken	baskı
Kurs	kurs
Job	iş
Zimmer	oda
Stock	Stok
Ausbildung	Eğitim
auch	çok
Kredit	kredi
Punkt	puan
Wissenschaft	Bilim
Männer	erkekler
Kategorien	kategoriler
Westen	batı
aussehen	bak
Englisch	ingilizce
Mannschaft	takım
Gut	arazi
Box	Kutu
Bedingungen	koşullar
Fotos	fotoğraflar
Fröhlich	eşcinsel
Faden	iplik
Kategorie	kategori
Hinweis	Not
Leben	canlı
groß	büyük
Galerie	galeri
Tabelle	tablo
jedoch	ancak
Juni	Haziran
Oktober	Ekim
November	Kasım
Markt	Market
Bibliothek	kütüphane
Aktion	aksiyon
Anfang	başla
Serie	dizi
Eigenschaften	Özellikler
Luft	hava
Industrie	sanayi
planen	plan
Mensch	insan
Ja	Evet
zweite	ikinci
heiß	Sıcak
Kosten	maliyet
Film	film
Foren	forumlar
März	Mart
la	la
September	Eylül
sagen	söylemek
gehen	gidiyor
medizinisch	tıbbi
Freund	arkadaş
Dezember	Aralık
Server	sunucu
Anwendung	uygulama
Mitarbeiter	Personel
abspielen	oyun
Probleme	sorunlar
April	Nisan
Benutzer	kullanıcılar
Straße	sokak
Thema	konu
gegen	karşısında
bekam	var
Blog	Blog
Party	Parti
Zahlung	ödeme
Ausrüstung	ekipman
Lassen	let
Programme	programlar
legal	yasal
kürzlich	son
Park	park
Handlung	davranmak
Problem	sorun
rot	kırmızı
geben	vermek
Erinnerung	bellek
Performance	performans
Sozial	sosyal
q	q
Geschichte	Öykü
verkaufen	satmak
Optionen	seçenekleri
Erfahrung	deneyim
Schlüssel	anahtar
Karosserie	vücut
jung	genç
wichtig	önemli
Feld	alan
wenige	az
Osten	Doğu
Single	tek
ii	ii
Alter	yaş
Verein	kulüp
Beispiel	örnek
Mädchen	kızlar
z	z
Straße	yol
Geschenk	hediye
Frage	soru
ca	CA
hart	zor
Zahlen	ödeme
vier	dört
Poker	poker
Problem	konu
Angebot	menzil
Gebäude	bina
Verkäufer	satıcı
Gericht	mahkeme
Februar	Şubat
Ergebnis	sonuç
Licht	ışık
schreiben	yazmak
Krieg	savaş
Angebot	teklif
Blau	mavi
Gruppen	gruplar
al	ark
einfach	kolay
gegeben	verilmiş
anfordern	istek
Fax	faks
China	Çin
Herstellung	yapma
Bild	resim
Bedürfnisse	ihtiyaçlar
möglich	mümkün
Monat	ay
Haupt	majör
Star	star
Zukunft	gelecek
Raum	uzay
Ausschuss	Kurul
Hand	el
Sonne	Güneş
Karten	kartları
London	Londra
Treffen	toplantı
werden	olmak
Kind	çocuk
behalten	Tut
Porno	porno
Aktie	pay
ähnlich	benzer
Garten	Bahçe
Schulen	okullar
Million	milyon
hinzugefügt	katma
Referenz	referans
Firmen	şirketler
Baby	bebek
Lernen	öğrenme
Energie	enerji
Lauf	koşmak
Lieferung	teslim
Beliebt	popüler
Begriff	terim
Film	film
Geschichten	hikayeleri
stellen	koymak
Tagebuch	dergi
Berichte	raporlar
co	ko
Versuchen	Deneyin
Bilder	Görüntüler
beachten	ihbar
Gott	Allah
Original	orijinal
Kopf	kafa
Radio	radyo
Zelle	hücre
Rat	konsey
enthält	içerir
Spur	Izlemek
Diskussion	tartışma
Archiv	Arşiv
Andere	diğerleri
Zustimmung	anlaşma
Format	biçim
Gesellschaft	toplum
Monate	ay
Sicherheit	Emniyet
Freunde	Arkadaş
sicher	emin
Auflage	baskı
Mitteilungen	mesajları
Marketing	pazarlama
sagen	söylemek
Verband	birleşme
bietet	sağlar
Spaß	eğlence
bereits	zaten
Grün	yeşil
Studien	çalışmalar
schließen	kapat
verbreitet	ortak
Spezifisch	özel
