von	arasında
zu	için
im	içinde
zum	için
ist	olduğu
auf	üzerinde
Das	o
durch	tarafından
Dies	bu
mit	ile
ich	ben
Sie	sen
es	o
oder	veya
Sein	olmak
sind	Hangi
beim	en
alle	herşey
haben	var
Neu	yeni
wir	Biz
werden	irade
Zuhause	ev
uns	bize
Über	hakkında
ob	Eğer
Seite	sayfa
meine	benim
hat	vardır
Suche	arama
frei	ücretsiz
aber	fakat
unser	bizim
ein	bir
andere	diğer
machen	yap
Information	bilgi
Zeit	zaman
er	o
welche	hangi
ihr	onların
Nachrichten	haber
benutzen	kullanım
Dort	Orada
sehen	görmek
damit	yani
Wer	kim
Netz	ağ
ebenfalls	Ayrıca
bekommen	almak
pm	pm
Aussicht	görünüm
c	c
e	e
zuerst	ilk
gewesen	olmuştur
würde	olur
wurden	idi
s	s
mögen	sevmek
x	x
als	göre
finden	bulmak
Preis	fiyat
zurück	geri
oben	üst
Menschen	insanlar
hätten	vardı
Liste	liste
Name	isim
gerade	sadece
Jahr	yıl
Tag	gün
in	içine
zwei	iki
Gesundheit	sağlık
n	n
Re	yeniden
benutzt	Kullanılmış
gehen	gitmek
b	b
letzte	son
machen	Yapmak
Sie	onları
sollte	meli
Produkt	ürün
System	sistem
Post	posta
ihr	ona
Stadt	Kent
t	t
Politik	politika
Nummer	numara
Unterstützung	destek
Botschaft	mesaj
nach	sonra
dann	sonra
Januar	Ocak
gut	iyi
d	d
woher	nerede
Info	bilgi
Rechte	haklar
Bücher	kitaplar
hoch	yüksek
Schule	okul
m	m
jeder	her
Links	bağlantılar
sie	o
Jahre	yıl
Auftrag	sipariş
sehr	çok
Buch	kitap
Artikel	ürün
Unternehmen	şirket
r	r
lesen	okumak
Gruppe	grup
Sex	seks
viele	çok
Benutzer	kullanıcı
de	de
einstellen	set
Allgemeines	genel
Forschung	Araştırma
Universität	Üniversite
Januar	Ocak
Post	posta
voll	tam
Bewertungen	yorumlar
Programm	program
kennt	bilmek
Spiele	oyunlar
Weg	yol
Tage	günler
p	p
Teil	Bölüm
könnte	could
groß	harika
vereinigt	birleşmiş
echt	gerçek
f	f
International	Uluslararası
Center	merkez
Reise	seyahat
Bemerkungen	yorumlar
gemacht	yapılmış
Entwicklung	gelişme
Bericht	rapor
Mitglied	üye
Einzelheiten	ayrıntılar
Linie	hat
Bedingungen	şartlar
Vor	önce
Hotels	oteller
tat	did
senden	göndermek
Recht	sağ
Art	tip
lokal	yerel
jene	bu
Ergebnisse	Sonuçlar
Büro	ofis
National	Ulusal
Auto	araba
Design	dizayn
nehmen	almak
Gesendet	gönderildi
Adresse	adres
Gemeinschaft	topluluk
innerhalb	içinde
Zustände	devletler
wollen	istemek
Telefon	telefon
DVD	DVD
Gegenstand	konu
zwischen	arasında
Forum	forum
Familie	aile
l	l
lange	uzun
w	w
Show	göstermek
O	O
sogar	Üstelik
schwarz	siyah
Besondere	özel
Index	indeks
Sein	olmak
Frau	KADIN
viel	çok
Schild	işaret
Datei	dosya
Verknüpfung	bağlantı
öffnen	açık
Süd	güney
Fall	dava
Projekt	proje
Seiten	sayfalar
Ausführung	versiyon
Sektion	Bölüm
besitzen	kendi
Haus	ev
Sicherheit	güvenlik
G	g
Bezirk	kontluk
amerikanisch	Amerikan
Foto	Fotoğraf
Spiel	oyun
Mitglieder	üyeler
Leistung	güç
Netzwerk	ağ
Computer	bilgisayar
Systeme	sistemler
drei	üç
Ort	yer
Ende	son
h	h
ihm	onu
pro	başına
Zugriff	erişim
denken	düşünmek
Norden	kuzeyinde
Ressourcen	kaynaklar
Strom	şimdiki
groß	büyük
Medien	medya
Recht	kanun
Steuerung	kontrol
Wasser	Su
Geschichte	Tarihçe
Größe	boyut
persönlich	kişisel
führen	kılavuz
Geschäft	Dükkan
Verzeichnis	rehber
Veränderung	değişiklik
Weiß	beyaz
Text	Metin
klein	küçük
Wertung	değerlendirme
Bewertung	oran
Regierung	hükümet
Kinder	çocuklar
Rückkehr	dönüş
Studenten	öğrencilerin
v	v
Konto	hesap
mal	zamanlar
Niveau	seviye
Digital	dijital
Profil	profil
Bisherige	önceki
bilden	form
Veranstaltungen	olaylar
Liebe	Aşk
alt	eski
John	John
Main	ana
Anruf	aramak
Bild	görüntü
Abteilung	Bölüm
Titel	Başlık
nicht	olmayan
k	k
y	y
Versicherung	sigorta
soll	acak
Eigentum	özellik
Klasse	sınıf
CD	CD
Qualität	kalite
jeden	her
Auflistung	listeleme
Inhalt	içerik
Land	ülke
wenig	küçük
Werkzeuge	araçlar
niedrig	düşük
Antworten	cevap
Kunde	müşteri
Dezember	Aralık
vergleichen	karşılaştırmak
Filme	filmler
Hochschule	kolej
Wert	değer
Artikel	makale
Mann	adam
Arbeitsplätze	Meslekler
j	j
Lebensmittel	Gıda
Autor	yazar
anders	farklı
u	u
lernen	öğrenmek
Verkauf	satış
drucken	baskı
Kurs	kurs
Job	iş
Zimmer	oda
Stock	Stok
Ausbildung	Eğitim
auch	çok
Kredit	kredi
Punkt	puan
Wissenschaft	Bilim
Männer	erkekler
Kategorien	kategoriler
Westen	batı
aussehen	bak
Englisch	ingilizce
Mannschaft	takım
Gut	arazi
Box	Kutu
Bedingungen	koşullar
Fotos	fotoğraflar
Fröhlich	eşcinsel
Faden	iplik
Kategorie	kategori
Hinweis	Not
Leben	canlı
groß	büyük
Galerie	galeri
Tabelle	tablo
jedoch	ancak
Juni	Haziran
Oktober	Ekim
November	Kasım
Markt	Market
Bibliothek	kütüphane
Aktion	aksiyon
Anfang	başla
Serie	dizi
Eigenschaften	Özellikler
Luft	hava
Industrie	sanayi
planen	plan
Mensch	insan
Ja	Evet
zweite	ikinci
heiß	Sıcak
Kosten	maliyet
Film	film
Foren	forumlar
März	Mart
la	la
September	Eylül
sagen	söylemek
gehen	gidiyor
medizinisch	tıbbi
Freund	arkadaş
Dezember	Aralık
Server	sunucu
Anwendung	uygulama
Mitarbeiter	Personel
abspielen	oyun
Probleme	sorunlar
April	Nisan
Benutzer	kullanıcılar
Straße	sokak
Thema	konu
gegen	karşısında
bekam	var
Blog	Blog
Party	Parti
Zahlung	ödeme
Ausrüstung	ekipman
Lassen	let
Programme	programlar
legal	yasal
kürzlich	son
Park	park
Handlung	davranmak
Problem	sorun
rot	kırmızı
geben	vermek
Erinnerung	bellek
Performance	performans
Sozial	sosyal
q	q
Geschichte	Öykü
verkaufen	satmak
Optionen	seçenekleri
Erfahrung	deneyim
Schlüssel	anahtar
Karosserie	vücut
jung	genç
wichtig	önemli
Feld	alan
wenige	az
Osten	Doğu
Single	tek
ii	ii
Alter	yaş
Verein	kulüp
Beispiel	örnek
Mädchen	kızlar
z	z
Straße	yol
Geschenk	hediye
Frage	soru
ca	CA
hart	zor
Zahlen	ödeme
vier	dört
Poker	poker
Problem	konu
Angebot	menzil
Gebäude	bina
Verkäufer	satıcı
Gericht	mahkeme
Februar	Şubat
Ergebnis	sonuç
Licht	ışık
schreiben	yazmak
Krieg	savaş
Angebot	teklif
Blau	mavi
Gruppen	gruplar
al	ark
einfach	kolay
gegeben	verilmiş
anfordern	istek
Fax	faks
China	Çin
Herstellung	yapma
Bild	resim
Bedürfnisse	ihtiyaçlar
möglich	mümkün
Monat	ay
Haupt	majör
Star	star
Zukunft	gelecek
Raum	uzay
Ausschuss	Kurul
Hand	el
Sonne	Güneş
Karten	kartları
London	Londra
Treffen	toplantı
werden	olmak
Kind	çocuk
behalten	Tut
Porno	porno
Aktie	pay
ähnlich	benzer
Garten	Bahçe
Schulen	okullar
Million	milyon
hinzugefügt	katma
Referenz	referans
Firmen	şirketler
Baby	bebek
Lernen	öğrenme
Energie	enerji
Lauf	koşmak
Lieferung	teslim
Beliebt	popüler
Begriff	terim
Film	film
Geschichten	hikayeleri
stellen	koymak
Tagebuch	dergi
Berichte	raporlar
co	ko
Versuchen	Deneyin
Bilder	Görüntüler
beachten	ihbar
Gott	Allah
Original	orijinal
Kopf	kafa
Radio	radyo
Zelle	hücre
Rat	konsey
enthält	içerir
Spur	Izlemek
Diskussion	tartışma
Archiv	Arşiv
Andere	diğerleri
Zustimmung	anlaşma
Format	biçim
Gesellschaft	toplum
Monate	ay
Sicherheit	Emniyet
Freunde	Arkadaş
sicher	emin
Auflage	baskı
Mitteilungen	mesajları
Marketing	pazarlama
sagen	söylemek
Verband	birleşme
bietet	sağlar
Spaß	eğlence
bereits	zaten
Grün	yeşil
Studien	çalışmalar
schließen	kapat
verbreitet	ortak
Spezifisch	özel
mehrere	birkaç
Leben	yaşam
Sammlung	Toplamak
namens	denilen
kurz	kısa
Kunst	sanat
Menge	çok
Fragen	Sor
begrenzt	sınırlı
Lösungen	çözeltiler
Direktor	yönetmen
Strand	plaj
Vergangenheit	geçmiş
natürlich	doğal
Elektronik	elektronik
auf	üzerine
Zeitraum	dönem
Planung	planlama
sagt	diyor
offiziell	resmi
beschädigen	mar
erledigt	tamam
technisch	teknik
Fenster	pencere
Profi	profesyonel
Region	bölge
Insel	ada
Aufzeichnung	kayıt
Direkte	direkt
Konferenz	konferans
Aufzeichnungen	kayıtlar
st	st
Kreis	ilçe
Kalender	takvim
Kosten	maliyetler
Stil	stil
Erklärung	Beyan
Meilen	mil
Ressource	kaynak
Anwendungen	uygulamaları
Dokument	belge
Wort	sözcük
Werk	Eserleri
Material	malzeme
Rechnung	fatura
geschrieben	yazılı
Regeln	kurallar
Finale	nihai
Ding	şey
Center	merkez
Anforderungen	Gereksinimler
WAHR	DOĞRU
Protokoll	dakika
sonst	Başka
Kennzeichen	işaret
Rock	Kaya
Schlecht	kötü
Individuell	bireysel
Plus	artı
Auto	Oto
Abdeckung	kapak
bearbeiten	Düzenle
zusammen	birlikte
Videos	videolar
schnell	hızlı
Funktion	fonksiyon
Tatsache	gerçek
bekommen	alma
global	global
Technik	teknoloji
Treffen	karşılamak
weit	uzak
wirtschaftlich	ekonomik
en	tr
Spieler	oyuncu
Projekte	projeler
Menge	Miktar
Uhr	izlemek
inbegriffen	dahil
Gefühl	hissetmek
Bank	banka
Risiko	risk
Angebote	fırsatlar
verschiedene	çeşitli
Wörter	kelimeler
Produktion	üretim
kommerziell	ticari
Gewicht	ağırlık
Herz	kalp
Behandlung	tedavi
Punkte	makas
Wissen	bilgi
Zeitschrift	dergi
Error	hata
Kamera	kamera
Mädchen	kız
Konstruktion	inşaat
Spielzeuge	oyuncaklar
Eingetragen	kayıtlı
Domain	domain
Methoden	yöntemleri
Kapitel	bölüm
Schutz	koruma
Politik	politikaları
breit	geniş
Schönheit	güzellik
Manager	müdür
Indien	Hindistan
Position	pozisyon
genommen	alınmış
Sortieren	çeşit
Inserate	listeleri
bekannt	bilinen
Hälfte	yarım
Fälle	vakalar
Schritt	adım
Ingenieurwesen	mühendislik
einfach	basit
schnell	hızlı
Lizenz	lisans
See	göl
ganze	bütün
jährlich	yıllık
veröffentlicht	yayınlanan
Kirche	kilise
Methode	yöntem
aktiv	aktif
Antwort	tepki
Zahl	şekil
Materialien	malzemeler
genug	yeterli
entworfen	tasarlanmış
unter	arasında
Tod	ölüm
Verlust	kayıp
Gesicht	yüz
Marke	marka
Rabatt	indirim
Auswirkungen	Etkileri
erstellt	oluşturulan
Normen	standartlar
Bit	bit
politisch	siyasi
Königreich	krallık
Base	baz
tun	iş
Darlehen	krediler
Schuhe	ayakkabı
Eintrag	giriş
bleibe	kalmak
Aufträge	emirler
Verfügbarkeit	kullanılabilirlik
Zusammenfassung	özet
Wende	dönüş
Wachstum	büyüme
Agentur	Ajans
König	kral
europäisch	Avrupa
Aktivität	aktivite
Kopieren	kopya
Western	batı
Macht	Kuvvet
Beschäftigung	iş
Bucht	Defne
Fluss	nehir
Kommission	komisyon
Paket	paket
gesehen	görüldü
Spieler	oyuncu
Motor	motor
Hafen	Liman
Album	albüm
regional	bölgesel
halt	durdurmak
gestartet	başladı
Verwaltung	yönetim
Bar	bar
Institut	enstitü
Ansichten	görünümler
doppelt	çift
Hund	köpek
bald	yakında
Linien	hatlar
elektronisch	elektronik
Leistungen	faydaları
erforderlich	gerekli
Drucker	yazıcı
Bedingung	şart
Wirksam	etkili
glauben	inanmak
Organisation	organizasyon
bewirken	Efekt
Verstand	us
Auswahl	seçim
Kasino	kumarhane
pdf	pdf
Tour	tur
Kreuz	çapraz
Hoffnung	umut
Konzern	şirket
Wunsch	dilek
Lösung	çözüm
reifen	olgun
Rolle	rol
Wochen	haftalar
sicher	belli
niedriger	alt
notwendig	gerekli
Union	Birlik
mon	Pazartesi
com	com
besonders	belirli
fein	ince
Stunde	saat
Gas	gaz
Kompetenzen	becerileri
sechs	altı
Buchse	çalı
Inseln	adaları
Rat	tavsiye
Werdegang	kariyer
Entscheidung	karar
verlassen	ayrılmak
Vor	önceden
enorm	Kocaman
Frau	Kadın
Anlagen	tesisler
bieten	teklif
Mitte	orta
Kabel	kablo
Chancen	fırsatlar
Einnahme	alma
Werte	değerler
Aufteilung	bölünme
Kommen	gelecek
Objekt	nesne
lesbisch	lezbiyen
angemessen	uygun
Maschine	makine
Logo	logo
Länge	uzunluk
nett	Güzel
Ergebnis	Gol
Statistiken	istatistik
Klient	müşteri
Probe	Numune
Investition	yatırım
geschickt	gönderilen
gezeigt	gösterilen
Weihnachten	Noel
Kultur	kültür
Blitz	flaş
Frau	MS
Wahl	seçim
Kurse	dersler
Verbraucher	tüketici
Hallo	Merhaba
fremd	yabancı
Künstler	sanatçı
Möbel	mobilya
Kanal	kanal
Brief	mektup
Modus	kip
Telefone	telefonlar
Ideen	fikirler
Struktur	yapı
Grad	derece
Vertrag	sözleşme
Super	Süper
männlich	erkek
Angelegenheit	madde
fast	neredeyse
gelegen	bulunan
mehrere	çoklu
Verteilung	dağıtım
Editor	editör
Gasthaus	Han
industriell	Sanayi
Potenzial	potansiyel
Lied	şarkı
los	los
fallen	düşmek
Idee	Fikir
Räume	Odalar
Kommunikations	iletişim
Sieg	kazanmak
primär	birincil
Krebs	kanser
Zahlen	sayılar
Grund	neden
Werkzeug	araç
Frühling	bahar
Stiftung	vakıf
Antworten	Cevap
Stimme	ses
Zeitplan	program
Unterlagen	evraklar
Zweck	amaç
Feature	özellik
Bett	yatak
kommt	geliyor
Polizei	polis
unabhängig	bağımsız
Ansatz	yaklaşım
braun	kahverengi
physikalisch	fiziksel
Hügel	Tepe
Karten	haritalar
halt	ambar
Bewertungen	derecelendirme
glücklich	mutlu
Schmied	demirci
entwickelt	gelişmiş
danken	teşekkür
sicher	kasa
einzigartig	benzersiz
Umfrage	anket
vor	önceki
Telefon	telefon
Sport	spor
bereit	hazır
Tier	hayvan
Quellen	kaynaklar
Population	nüfus
pa	baba
regulär	düzenli
sichern	güvenli
Geschäftstätigkeit	operasyonlar
einfach	basitçe
Beweis	kanıt
Bahnhof	istasyon
verstehen	anlama
Möglichkeit	seçenek
Tal	vadi
wahrscheinlich	muhtemelen
Meer	deniz
Publikationen	yayınlar
verbessern	iyileştirmek
Verbindung	bağ
Herausgeber	Yayımcı
Halle	salon
Anti	anti
Netzwerke	ağlar
Erde	toprak
Eltern	ebeveyn
Auswirkung	darbe
Transfer	Aktar
Einführung	Giriş
Küche	mutfak
stark	kuvvetli
Hochzeit	düğün
Eigenschaften	özellikleri
Krankenhaus	hastane
Boden	zemin
Schiff	gemi
Unterkunft	Konaklama
Krankheit	hastalık
Ausgezeichnet	mükemmel
perfekt	mükemmel
Haar	saç
Gelegenheit	fırsat
Ausrüstung	malzeme
klassisch	klasik
Basis	temel
Befehl	komuta
Städte	şehirler
ausdrücken	ekspres
vergeben	ödül
Entfernung	mesafe
Baum	ağaç
Bewertung	değerlendirme
Mauer	duvar
beteiligt	ilgili
el	el
extra	ekstra
insbesondere	özellikle
Budget	bütçe
Führungen	kılavuzlar
Erfolg	başarı
maximal	maksimum
ma	anne
Betrieb	operasyon
bestehende	mevcut
ganz	oldukça
ausgewählt	seçilmiş
Junge	oğlan
Restaurants	restoranlar
schön	güzel
Warnung	uyarı
Standorte	yerleri
Pferd	at
Abstimmung	oy
Blumen	Çiçekler
Sterne	yıldızlar
Listen	listeleri
Inhaber	sahip
Tiere	hayvanlar
Wege	yolları
Sohn	oğul
Bereitstellen	sağlama
Regel	kural
Gehäuse	Konut
nimmt	alır
bringen	getirmek
Katalog	katalog
max	maksimum
Mutter	anne
Behörde	yetki
erzählte	söyledi
Programm	program
beigetreten	katıldı
Eingang	giriş
Strategie	strateji
Füße	ayaklar
Agent	ajan
gültig	geçerli
modern	modern
Senior	kıdemli
sexy	seksi
Lehren	öğretim
Tür	kapı
großartig	büyük
Versuch	Deneme
Einheiten	birimler
cool	güzel
normal	normal
Unternehmen	kuruluş
Schiffe	gemiler
ganz	tüm
positiv	pozitif
Fitness	Fitness
Chinesisch	Çince
Meinung	görüş
Fußball	Futbol
abstrakt	soyut
Ausgabe	çıktı
Mittel	para
Herr	Bay
wahrscheinlich	muhtemelen
entwickeln	geliştirmek
Künstler	sanatçılar
Alternative	alternatif
Verantwortung	sorumluluk
Java	java
Gast	konuk
Veröffentlichung	yayın
bestehen	pas
Verhältnis	ilişkiler
Vertrauen	güven
Transporter	kamyonet
enthält	içeren
Mehr	çok
Republik	cumhuriyet
Gebühren	harç
Komponenten	bileşenler
Ferien	tatil
Jahrhundert	yüzyıl
akademisch	akademik
Hilfe	yardım
abgeschlossen	tamamlanan
Haut	cilt
Grafik	grafik
indisch	Hintli
Ring	halka
Klasse	sınıf
Berg	dağ
Organisationen	organizasyonlar
Filter	filtre
Platte	panel
Fußboden	zemin
Kauf	alış
Spiel	maç
vorgeschlagen	önerilen
benötigen	gerektirir
Jungen	çocuklar
Morgen	sabah
erlaubt	verir
Eiweiß	protein
Pflanze	bitki
berichtet	rapor
schlagen	vurmak
Millimeter	aa
Schwimmbad	havuz
Mini	mini
Politik	siyaset
Partner	ortak
Autoren	yazarlar
Bretter	panoları
Fisch	balık
Mitgliedschaft	üyelik
Mission	misyon
Auge	göz
Schnur	sicim
Sinn	duyu
geändert	değiştirilmiş
freigegeben	yayınlandı
Bühne	evre
intern	iç
geboren	doğmuş
ausführlich	detaylı
japanisch	Japonca
Rennen	yarış
genehmigt	onaylı
Ziel	hedef
außer	dışında
Charakter	karakter
Instandhaltung	bakım
Fähigkeit	kabiliyet
ed	ed
vergewaltigen	kolza
Batterie	pil
Jugend	gençlik
Druck	basınç
eingereicht	gönderilen
Schuld	borç
Mittel	orta
Fernsehen	televizyon
interessiert	Ilgilenen
Ader	çekirdek
Unterbrechung	mola
Zwecke	amaçlar
Sets	kümeler
tanzen	dans
Holz	ahşap
definiert	tanımlanmış
Papiere	kâğıtlar
Auszeichnungen	ödülleri
Gebühr	ücret
Studio	stüdyo
Leser	okuyucu
Gerät	cihaz
etabliert	kurulmuş
Antworten	cevaplar
Miete	kira
las	las
dunkel	karanlık
extern	dış
Apfel	elma
le	le
Anleitung	Talimatlar
Mindest	min
angeboten	sunulan
Theorie	teori
Löschen	Kaldır
Hilfe	yardım
visuell	görsel
Gastgeber	evsahibi
Vielfalt	Çeşitlilik
Lehrer	öğretmenler
Handbuch	Manuel
Block	blok
Fächer	konular
Mittel	ajanları
Reparatur	onarım
Messe	adil
stehlen	çelik
Verstehen	anlayış
Lieder	şarkılar
Fest	sabit
falsch	yanlış
Anfang	başlangıç
Hände	eller
az	az
Paris	Paris
wird	alır
Sektor	sektör
Kapazität	kapasite
un	un
Fett	şişman
Vater	baba
elektrisch	elektrik
sah	testere
Instrumente	enstrümanlar
Offizier	subay
Treiber	sürücü
Unternehmen	işletmeler
tot	ölü
unbekannte	Bilinmeyen
Restaurant	restoran
Mike	mikrofon
Ausflug	gezi
mi	mi
Arm	fakir
Beziehung	ilişki
Arbeitskräfte	işçiler
Frieden	Barış
traditionell	geleneksel
zeigt	gösterme
kreativ	yaratıcı
Küste	sahil
Vorteil	yarar
Finanzierung	finansman
Geräte	cihazlar
Herr	Kral
gewähren	hibe
Unter	alt
Fiktion	kurgu
Uhren	saatler
Karriere	kariyer
geht	gider
LED	Led
Museum	müze
Ventilator	yelpaze
Transport	taşıma
interessant	ilginç
Blogs	bloglar
Auswertung	değerlendirme
ehemalige	eski
Zone	bölge
Komplex	karmaşık
th	inci
Katze	kedi
sterben	ölmek
vorgeführt	sunulan
eben	düz
fließen	akış
Agenturen	ajanslar
Literatur	Edebiyat
Elternteil	ebeveyn
Rahmen	ayar
DR	dr
Rahmen	ölçek
Wirtschaft	ekonomi
hilfreich	faydalı
monatlich	aylık
kritisch	kritik
Rahmen	çerçeve
Musical	müzikal
Definition	tanım
Sekretär	Sekreter
Pfad	yol
Chef	şef
gibt	verir
Pakete	paketler
Detail	detay
Gesetze	yasalar
geändert	değişmiş
Start	başla
königlich	royal
reinigen	temiz
Kerl	adam
Titel	başlıkları
relevant	uygun
Gerechtigkeit	adalet
verbinden	bağlamak
Tasse	Fincan
Korb	sepet
angewandt	uygulamalı
wöchentlich	haftalık
vol	cilt
Installation	Kurulum
pp	s
Beachtung	Dikkat
vorrücken	ilerlemek
überspringen	atlamak
Diät	diyet
Armee	ordu
Ausrüstung	vites
Unterschied	fark
dürfen	izin
richtig	doğru
Nation	ulus
Verkauf	satış
viele	çok
Stück	parça
Blatt	tabaka
Feste	firma
Sieben	Yedi
Elemente	elementler
Spezies	Türler
springen	atlama
Zellen	hücreler
Modul	modül
Urlaubsort	çare
Zertifikat	sertifika
Minister	bakan
Bewegung	hareket
Mode	moda
Richtungen	talimatlar
Besucher	Ziyaretçi
Dokumentation	belgeleme
Handel	ticari
Wald	orman
Anrufe	aramalar
Berichterstattung	kapsama
Paar	çift
Angabe	vererek
Chance	şans
Vision	vizyon
Ball	top
Ende	bitirme
Kunden	istemciler
Aktionen	eylemler
diskutieren	tartışmak
Tor	hedef
erfolgreich	başarılı
verkauft	satıldı
Wind	rüzgar
Gemeinden	topluluklar
klinisch	klinik
Lage	durum
Märkte	piyasalar
Verlagswesen	yayıncılık
erscheinen	görünmek
Entwicklung	gelişen
Leben	hayatları
bestimmen	belirlemek
Temperatur	sıcaklık
Ankündigungen	duyurular
geduldig	hasta
tatsächlich	gerçek
historisch	tarihi
Stein	taş
Bob	şilin
Handel	ticaret
Personen	kişiler
schwer	zor
wissenschaftlich	ilmi
Satellit	uydu
Tests	testler
Dorf	köy
Konten	hesapları
Amateur	amatör
Ex	eski
getroffen	met
Schmerzen	Ağrı
Faktoren	faktörler
Kaffee	Kahve
Käufer	alıcı
Poster	afiş
Kante	kenar
funktional	fonksiyonel
Wurzel	kök
fi	fi
geschlossen	kapalı
Ferien	Bayram
Rosa	pembe
Balance	denge
Überwachung	izleme
Antworten	cevaplar
Schuss	atış
Initiale	ilk
Etikette	etiket
Sekunde	sek
Kanon	kanon
Liga	lig
Abfall	atık
Minute	dakika
Bus	otobüs
Anbieter	sağlayan
Wörterbuch	sözlük
Buchhaltung	muhasebe
Herstellung	imalat
Abschnitte	bölümler
Stuhl	sandalye
Anstrengung	çaba
Phase	faz
Fantasie	fantezi
po	po
va	va
Professor	profesör
Installieren	kurmak
Hemd	gömlek
Kleider	giysi
Fuß	ayak
Brust	meme
Techniken	teknikleri
Dollar	dolar
Religion	din
Genehmigung	izin
wild	vahşi
Generation	nesil
Fräulein	bayan
chemisch	kimyasal
Arzt	doktor
Aufgabe	görev
reduzieren	azaltmak
gebracht	getirdi
Übung	egzersiz
Fehler	böcek
Garantie	garanti
Führer	lider
se	se
Prozesse	süreçler
weich	yumuşak
Treffen	toplantılar
Sekunden	saniye
Flug	uçuş
Kongress	kongre
Treibstoff	yakıt
gehen	yürümek
hergestellt	üretilmiş
Heilige	aziz
Streit	tartışma
Wettbewerb	yarışma
Drogen	ilaçlar
Joint	ortak
Prämie	ödül
frisch	taze
Figuren	karakterler
Rechtsanwalt	avukat
di	di
Faktor	faktör
tausende	binlerce
km	km
Strom	Akış
Wohnungen	daireler
pflücken	almak
Hören	işitme
östlich	doğu
Therapie	terapi
Einträge	girdileri
unterzeichnet	imzalı
administrativ	idari
ernst	ciddi
Grenze	sınır
Schritte	adımlar
Geschäfte	dükkanlar
Knechtschaft	esaret
del	del
Anstrengungen	çabaları
informiert	bilgili
ga	ga
Gedanken	düşünceler
Bach	dere
ft	ft
Menge	miktar
wesentlich	gerekli
Touren	turlar
Belastung	yük
sofort	hemen
Maschinen	makineler
vorgesehen	belirlenmiş
schwer	ağır
bedeckt	kapalı
Wiederherstellung	kurtarma
integriert	entegre
Aufbau	yapılandırma
Schwanz	horoz
Händler	tüccar
umfassend	kapsamlı
Experte	uzman
schützen	korumak
solide	katı
Präsentation	sunum
wurde	oldu
Orange	Portakal
Beachtung	uyma
Thema	tema
Reich	zengin
Kampagne	kampanya
vs	vs
Gitarre	gitar
finden	bulgu
Beispiele	örnekler
Geist	ruh
ar	ar
Ansprüche	iddialar
Annahme	kabul
Strategien	stratejiler
mo	mo
Angelegenheiten	işler
beabsichtigt	istenilen
sa	sa
Tore	hedefleri
mieten	kiralama
Wahl	seçim
vorschlagen	önermek
Ast	şube
Dienen	servis
Mitgliedsorganisationen	bağlı
montieren	dağ
Latein	Latince
Multimedia	multimedya
verwalten	yönetmek
Ecke	köşe
Rang	rütbe
Element	eleman
Geburt	doğum
Virus	virüs
interaktiv	interaktif
Anfragen	istekler
trennen	ayrı
Quartal	çeyrek
Verfahren	prosedür
Führung	liderlik
definieren	tanımlamak
religiös	dini
Fakten	Gerçekler
Frühstück	kahvaltı
Säule	kolon
Glauben	inanç
Kette	Zincir
identifizieren	belirlemek
Avenue	cadde
fehlt	eksik
Empfehlungen	tavsiyeler
gerührt	taşındı
erreichen	ulaşmak
Vergleich	karşılaştırma
Moment	an
verlängert	Genişletilmiş
Sequenz	sıra
Zoll	inç
Attacke	saldırı
Zentren	merkezleri
Öffnung	açılış
Labor	laboratuvar
Reservieren	rezerv
Gamma	gama
produzieren	üretmek
Wahrheit	hakikat
Zähler	sayaç
Fehler	başarısızlık
folgt	şu
Dollar	dolar
Lager	kamp
die	des
Filme	filmler
Brücke	köprü
füllen	doldurmak
Bewegung	hareket
Drucken	baskı
Entwurf	taslak
Diagramm	grafik
gespielt	Oyunun
Kontakte	kontaklar
Leser	okuyucular
Clubs	kulüpleri
wa	WA
Abenteuer	macera
Opfer	teklif
profitieren	kâr
Führung	liderler
Poster	afişler
Institutionen	kurumlar
Assistent	asistan
Variable	değişken
dj	dj
Parken	otopark
gestern	dün
entschlossen	belirlenen
Werkstatt	atölye
Weg	gitmiş
Codes	kodlar
Arten	çeşit
Erweiterung	uzantı
Aussagen	ifadeleri
vollständig	tamamen
Mannschaften	takımlar
Fort	kale
cm	santimetre
Senat	senato
komisch	komik
Gen	gen
gedreht	dönük
Scheibe	disk
Muster	Desen
Boot	tekne
Theater	tiyatro
Hersteller	üreticileri
Sponsor	sponsor
klassisch	klasik
Symbol	ikon
Garantie	garanti
gewidmet	adanmış
Richtung	yön
Basketball	Basketbol
Objekte	nesneleri
löschen	silmek
Abend	akşam
Versammlung	montaj
nuklear	nükleer
Maus	fare
Signal	işaret
Verbrecher	adli
ausgegeben	Veriliş
mächtig	güçlü
Traum	rüya
FALSCH	YANLIŞ
da	da
Besetzung	oyuncular
Blume	çiçek
Personal	personel
bestanden	geçti
geliefert	verilen
Stürze	düşme
Seele	ruh
fördern	desteklemek
angegeben	belirtilen
Statistiken	istatistikler
Profis	profesyoneller
erscheint	belirir
tragen	Taşımak
Flagge	bayrak
Abdeckungen	kapaklar
em	em
Vorteil	avantaj
Hallo	Merhaba
Design	tasarımlar
pflegen	sürdürmek
Tourismus	turizm
Priorität	öncelik
Erwachsene	yetişkinler
Grafik	grafik
Atom	atom
Zahlungen	ödemeler
Bindung	bağlayıcı
kurz	kısa
beendet	Bitti
gewinnt	kazanan
anonym	anonim
Skript	senaryo
serviert	hizmet
will	istiyor
bereit	hazırlanmış
Leere	geçersiz
Etikett	etiket
Interview	röportaj
mischen	karıştırmak
Rahmen	iskelet
Scheibe	disk
Eingerichtet	Kurulmuş
Königin	kraliçe
Kredite	kredi
deutlich	Açıkça
Fix	düzeltmek
Griff	sap
Süss	tatlı
Kriterien	kriterleri
assoziieren	ortak
ne	ne
Verhalten	davranış
vergrößern	büyütmek
Strahl	ışın
Einnahmen	gelir
messen	ölçmek
Stimmen	oy
du	du
Pflicht	görev
Diskussionen	tartışmalar
Bär	ayı
gewinnen	kazanç
Festival	Festival
Labor	laboratuvar
Ozean	okyanus
Flüge	uçuşlar
Fachwelt	uzmanlar
Zeichen	işaretler
Tiefe	derinlik
Zug	tren
trocken	kuru
erkunden	keşfetmek
Spa	spa
Konzept	kavram
fast	neredeyse
Handhabung	kullanma
Ursprung	Menşei
Milliarde	milyar
Intelligenz	zeka
gekauft	satın
con	aleyhte
Nationen	milletler
Route	rota
gebrochen	kırık
Schlacht	savaş
sprechen	konuşmak
Protokoll	protokol
Abfrage	sorgu
Partnerschaft	ortaklık
Ausdruck	ifade
es	es
Rede	konuşma
Draht	tel
Vorschläge	öneri
Ersatz	değiştirme
Band	bant
strategisch	stratejik
Richter	hakim
Acid	asit
Bytes	bayt
Cent	sent
gezwungen	zorunlu
kompatibel	uyumlu
Wohnung	apartman
Null	boş
Null	sıfır
Redner	konuşmacı
Beratung	Danışmanlık
Konstrukteur	tasarımcı
pr	pr
Ehe	evlilik
rollen	rulo
Banken	bankalar
fr	fr
Teilnehmer	katılımcılar
Geheimnis	gizli
Negativ	negatif
Favoriten	Favoriler
Theater	tiyatro
Federung	yaylar
var	var
ausführen	yapmak
Übersetzung	çeviri
Schätzungen	tahminler
Verletzung	hasar
Ministerium	bakanlık
Treiber	sürücüler
Anwalt	avukat
Figuren	rakamlar
geschützt	korumalı
Vorschlag	öneri
teilen	paylaşım
Portal	kapı
Beta	beta
gratis	bedava
zu	karşı
leicht	hafifçe
helfen	yardım
Verhalten	davranış
enthalten	içeriyordu
Gesetzgebung	mevzuat
Berufung	çağrı
Parameter	parametreler
Profile	profiller
Angelegenheiten	hususlar
Häuser	evler
Steuerung	kontroller
kombiniert	kombine
letzte	nihai
Vertreter	temsilci
geringer	küçük
Abteilungen	bölümler
Bewohner	sakinleri
angezeigt	görüntülenen
Mama	anne
reduziert	indirimli
Selten	nadir
durchgeführt	gerçekleştirilen
extrem	aşırı
Proben	örnekler
Riegel	Barlar
Prognose	tahmin
entfernt	çıkarıldı
Zyklus	Çevrim
enthalten	içermek
Richtigkeit	doğruluk
Schlaf	uyku
mg	mg
Vogel	kuş
Apotheke	eczane
Schaffung	oluşturma
statisch	statik
Jäger	avcı
Adressen	adresler
Dame	bayan
Kristall	kristal
berühmt	ünlü
Schriftsteller	yazar
Vorsitzende	başkan
Getränk	içki
Akademie	akademi
dynamisch	dinamik
Essen	yemek
permanent	kalıcı
Reinigung	temizlik
bildet	teşkil
Mappe	portföy
praktisch	pratik
geliefert	teslim
Infrastruktur	altyapı
Farbe	renk
Verkäufer	satıcı
Philosophie	Felsefe
Verordnung	düzenleme
Offiziere	görevlileri
Ziel	amaç
Gebote	teklifleri
Ernährung	beslenme
Aufzeichnung	kayıt
Junior	genç
les	les
Kap	pelerin
Ringe	halkalar
Spitze	bahşiş
wunderbar	olağanüstü
Fahrkarte	bilet
angekündigt	açıkladı
vermuten	tahmin
wem	kime
Fußball	Futbol
Mathematik	matematik
einführen	ithalat
Entsendung	gönderme
Gegenwart	varlık
automatisch	otomatik
Besichtigung	görüntüleme
gepflegt	muhafaza
CH	ch
Dan	dan
Hunde	köpekler
Direktoren	yönetmenler
Aspekte	yönleri
voraus	önde
Mond	ay
Beteiligung	katılım
planen	düzen
Fliege	sinek
Weise	tavır
Matrix	matris
Kombination	kombinasyon
Änderung	düzeltme
Stärke	kuvvet
Truthahn	Türkiye
Bibliotheken	kütüphaneler
richtig	uygun
Grad	derece
Unternehmen	işletmelerin
Delta	delta
Angst	korku
suche	arayan
Zoll	inç
Konvention	Kongre
Anteile	hisseleri
Schulleiter	asıl
Komfort	konfor
Farben	renkler
Kriege	savaşlar
Bestellung	sipariş
gehalten	tuttu
Alpha	alfa
Beschwerde	temyiz
Kreuzfahrt	seyir
Bonus	bonus
Hallo	Hey
Gebäude	binalar
Angebote	özel
schlagen	dövmek
Batterien	piller
wird	olur
fährt	sürücüler
Waffen	silâh
Tee	Çay
verbessert	gelişmiş
leisten	başarmak
Positionen	pozisyonları
Kleid	elbise
Abonnement	abone
Händler	satıcı
zeitgenössisch	çağdaş
Himmel	gökyüzü
Rom	ROM
getragen	taşınan
Exposition	poz
verbergen	saklamak
Unterschrift	imza
Müller	değirmenci
Bereitstellung	hüküm
Kleider	çamaşırlar
Rahmen	çerçeveler
bestimmt	kesinlikle
Zeitung	gazete
Spielzeug	oyuncak
Schicht	tabaka
gedruckt	basılı
langsam	yavaş
Entfernung	uzaklaştırma
Haftung	yükümlülük
Drucker	yazıcılar
Hinzufügen	ekleme
Stelle	yer
verbringen	harcamak
Fabrik	fabrika
Innere	iç
wachsen	büyümek
optisch	optik
Beförderung	tanıtım
relativ	bağıl
tolle	şaşırtıcı
Punkt	nokta
Identität	Kimlik
Umwandlung	dönüştürme
Gefühl	duygu
versteckt	gizli
angemessen	makul
Revision	revizyon
beeinflussen	etki
Verhältnis	oran
Bedeutung	önem
Regen	yağmur
Planet	gezegen
Kopien	kopyalar
erlauben	izin
Sehen	görme
Beweis	kanıt
Bass	bas
Rezept	reçete
leer	boş
Beispiel	örnek
Loch	delik
Reiten	binmek
Büro	büro
Erhaltung	koruma
Paar	çift
Ideal	ideal
Brille	gözlük
verzeichnet	kaydedilmiş
Don	don
Stücke	parçalar
fertig	bitmiş
Parks	parklar
Rechtsanwälte	avukatları
Stress	stres
Sahne	krem
ss	ss
läuft	koşar
entdecken	keşfetmek
ap	ap
Muster	desenler
Hügel	tepeler
nm	mil
Berater	danışman
bewusst	farkında
gestalten	şekil
Evolution	evrim
Zertifikate	sertifikalar
Ziele	hedefleri
Stationen	istasyonlar
empfohlen	önerdi
op	op
Überreste	kalıntılar
Firmen	firmalar
Euro	euro
Operator	Şebeke
Strukturen	yapıları
generisch	genel
Enzyklopädie	ansiklopedi
Verwendung	kullanım
Tinte	mürekkep
gemischt	karışık
Volkszählung	sayım
Rad	tekerlek
Lieferanten	tedarikçileri
kompakt	kompakt
Poesie	şiir
Beleuchtung	ışıklar
Verfolgung	izleme
Engel	melek
Vorbereitung	hazırlık
Versuch	girişim
Empfang	kabul
Streichhölzer	maçlar
Übereinstimmung	uyum
Breite	Genişlik
Motoren	motorlar
vergessen	unutmak
Feld	dizi
diskutiert	tartışılan
genau	doğru
Klima	iklim
griechisch	Yunan
Anweisung	talimat
Verwaltung	yönetme
roh	çiğ
Unterschiede	farklar
erklären	açıklamak
Gründen	kurmak
ausgedrückt	ifade
Umfang	derece
Scharf	keskin
ben	ben
Absatz	paragraf
töten	öldürmek
Mathematik	matematik
Vergütung	tazminat
Export	ihracat
Manager	yöneticileri
Module	modüller
geführt	yürütülen
Versionen	versiyonları
weiß	bilir
beschreiben	tanımlamak
Bürger	vatandaşlar
Erbe	miras
Ärger	sorun
Trainer	Koç
landwirtschaftlich	tarım
erweitern	genişletmek
Publikum	seyirci
zugewiesen	atanmış
Sammlungen	koleksiyonları
Ewigkeit	yaşlar
Spezialist	uzman
Koch	pişirmek
beeinflussen	etkilemek
Jungfrau	bakire
erfahren	deneyimli
Ermittlung	soruşturma
angehoben	kalkık
Hut	şapka
Institution	kurum
gerichtet	yönlendirilmiş
betroffen	etkilenmiş
Fahrrad	bisiklet
total	bütünüyle
Teller	plaka
Kosten	giderler
zeigen	belirtmek
blond	sarışın
Verfahren	kovuşturma
Favorit	favori
Eigenschaften	karakteristikleri
der	der
verlieren	kaybetmek
organisch	organik
suchen	aramak
Erfahrungen	deneyimler
Alben	albüm
Verträge	sözleşmeler
Gäste	misafir
Gastgeber	barındırılan
Krankheiten	hastalıklar
über	ilişkin
äquivalent	eşdeğer
Chemie	kimya
Kits	kitleri
Logik	mantık
Prinz	prens
Kreis	daire
Boden	toprak
Psychologie	Psikoloji
nass	ıslak
Umstände	koşullar
Investor	yatırımcı
elementar	temel
Sponsoren	sponsorlar
Fuchs	tilki
unbegrenzt	sınırsız
reagieren	yanıtlamak
Größen	boyutları
einfach	sade
Ausfahrt	çıkış
Arm	kol
Schlüssel	anahtarlar
Welle	dalga
heilig	kutsal
Handlungen	eylemler
Beratung	rehberlik
Weg	iz
Symbol	sembol
Autobahn	karayolu
beobachtete	gözlenen
Dean	dekan
Konfiguration	kurmak
Umfrage	anket
Arten	stilleri
gefüllt	dolu
Bindung	bağ
Kanäle	kanallar
Blinddarm	apandis
Schokolade	çikolata
Portion	kısım
Umfang	kapsam
Lieferant	satıcı
Kabel	kablolar
Baumwolle	pamuk
Anforderung	gereklilik
getötet	öldürdü
Rand	sınır
alt	eski
Debatte	tartışma
Vertreter	temsilcileri
beginnt	başlar
Schwangerschaft	gebelik
Sehenswürdigkeiten	konumlar
gelernt	bilgili
Transaktionen	işlemler
Forscher	kâşif
historisch	tarihi
Mann	koca
autorisiert	yetkili
verrückt	çılgın
bevorstehende	yaklaşan
Konzert	konser
Partituren	Skorlar
Wirksamkeit	verim
Komödie	komedi
angenommen	benimsenen
effizient	verimli
linear	doğrusal
Engagement	taahhüt
Spezialität	uzmanlık
Bären	ayılar
hüpfen	atlama
Träger	taşıyıcı
Konstante	sabit
Visa	Visa
Mund	ağız
Meter	metre
verbunden	bağlantılı
Interviews	görüşmeler
Konzepte	kavramlar
Gewehr	tabanca
reflektieren	yansıtmak
rein	saf
Hölle	cehennem
Obst	meyve
beginnt	başlar
qualifiziert	nitelikli
Reform	reform
Linse	lens
behandelt	işlenmiş
Entdeckung	keşif
zeichnen	çekmek
klassifiziert	sınıflandırılmış
annehmen	üstlenmek
Allianz	ittifak
bestätigen	onaylamak
Ingenieur	mühendis
konsistent	tutarlı
ersetzen	değiştirmek
Spielraum	Boşluk
Konverter	dönüştürücü
Organisation	organizasyon
Baby	bebek
Schecks	çekler
erreicht	ulaştı
Werden	olma
Zielsetzung	amaç
angezeigt	belirtilen
Zucker	şeker
Crew	mürettebat
Beine	bacaklar
Stock	Çubuk
Beziehung	ilişki
aktiviert	etkin
Genre	Tür
Freiwillige	gönüllü
Rückseite	arka
demokratisch	demokratik
verbessern	artırmak
genau	kesin
gebunden	ciltli
Parameter	parametre
Prozessor	işlemci
Knoten	düğüm
formal	biçimsel
Sturm	fırtına
Mikro	mikro
Hochschulen	kolejler
Meile	mil
Herausforderungen	zorluklar
Redakteure	editörler
höchste	yüce
Brüder	Kardeşler
Anerkennung	tanıma
ref	ref
schätzen	tahmin
Kind	çocuk
Inspektion	teftiş
Verbraucher	tüketicilerin
Grenzen	sınırları
Gebiet	bölge
Bewaffnung	silahlar
verzögern	gecikme
Pilot	pilot
Beiträge	katkıları
kontinuierlich	sürekli
Initiative	girişim
Roman	yeni
Ausführung	icra
Behinderung	sakatlık
Ultra	ultra
Gewinner	kazanan
Folge	bölüm
Töpfer	çömlekçi
Gericht	tabak
Theaterstücke	oyunlar
Bekanntmachung	bülten
ia	ia
ändern	değiştirmek
wirklich	gerçekten
Universum	Evren
Kandidat	aday
Slot	yarık
hervorragend	ödenmemiş
Ha	Ha
geplant	planlı
Hütte	loca
Spiegel	ayna
Turnier	turnuva
Berücksichtigung	düşünce
Sitzungen	oturumları
Kern	çekirdek
Käufer	alıcılar
Zeitschriften	dergi
grau	gri
Katalog	katalog
berechnet	yüklü
breit	geniş
und	und
gewählt	seçilmiş
Demo	gösteri
Hass	nefret
Terminal	terminal
Verlag	yayıncılar
Nächte	gece
Flüssigkeit	sıvı
Reis	pirinç
Reservierung	rezervasyon
Lebensmittel	gıdalar
bewachen	bekçi
Einsparung	tasarruf
Reich	imparatorluk
neu	yeni
erziehen	yükseltmek
illegal	yasadışı
Erweiterung	genişleme
Premier	başbakan
Morgen	yarın
Milch	Süt
Theater	dram
Besuch	ziyaret
Wettbewerb	yarışma
gesammelt	toplanmış
Bands	bantları
geeignet	uygun
absolut	kesinlikle
Prüfung	denetim
Kammer	bölme
Guinea	Gine
Ergebnisse	bulgular
iso	iso
typisch	tipik
Summe	toplam
Hähnchen	tavuk
vorübergehend	geçici
besuchen	katılmak
Dusche	duş
Versendung	gönderme
ausreichend	yeterli
Schale	kabuk
Provinz	il
katholisch	liberal
Gouverneur	Vali
Bier	bira
Beitrag	katkı
Formel	formül
Verfassung	anayasa
Verpackung	paketleme
zuverlässig	dürüst
Zweifel	şüphe
verdienen	kazanmak
Perioden	dönemleri
Anschläge	saldırılar
Waren	mal
Symptome	semptomlar
Denkmal	anıt
Zwilling	ikiz
einfügen	eklemek
Tor	geçit
Zeichnung	çizim
Kandidaten	adaylar
bestellt	düzenli
biologisch	biyolojik
Kampf	kavga
Übergang	geçiş
Vorlieben	tercihleri
Spion	casus
Romantik	romantik
Instrument	enstrüman
Teilt	Bölünmüş
Themen	temalar
Befugnisse	güçler
Himmel	cennet
Bits	bit
schwanger	hamile
Einstufung	sınıflandırma
konzentriert	odaklı
Arzt	doktor
fragen	sormak
Blöcke	bloklar
lo	bak
geistig	manevi
Diabetes	diyabet
ml	mi
Verschiebung	vardiya
sitzen	oturmak
Körper	bedenler
Fotos	fotoğraflar
Schneiden	kesim
Schriftsteller	yazarlar
flexibel	esnek
liebte	sevilen
Favoriten	Favoriler
Kartierung	haritalama
zahlreich	sayısız
verhältnismäßig	Nispeten
repräsentiert	temsil
überlegen	üstün
bevorzugt	tercihli
Gerettet	kaydedilmiş
intellektuelle	entellektüel
gewährt	verilmiş
Kohlenstoff	karbon
gemütlich	rahat
magnetisch	manyetik
Interaktion	etkileşim
Hören	dinleme
Krise	kriz
Ausblick	görünüm
massiv	masif
hell	parlak
gebildet	oluşturulan
Klavier	piyano
Echo	Eko
Revolution	devrim
Displays	görüntüler
Plasma	plazma
Verdienste	kazanç
Geheimnis	gizem
Landschaft	peyzaj
mechanisch	mekanik
Reise	seyahat
Banner	afiş
Feige	incir
Grafschaften	ilçeler
Erwerb	edinme
anerkannt	tanınan
Träume	rüyalar
Benachrichtigung	bildirim
kg	kilogram
lehren	öğretmek
schnell	hızlı
ziehen	Çek
ut	ut
Seminar	seminer
Investitionen	yatırımlar
Räder	tekerlekler
angeben	belirtmek
empfindlich	hassas
Vorlagen	şablonları
Formate	formatları
hält	tutar
Router	yönlendirici
Beton	beton
si	si
Mappe	Klasör
Fertigstellung	tamamlama
Impuls	nabız
Technik	teknik
Wählen	oylama
Justiz	mahkemeler
umgewandelt	dönüştürülmüş
Metro	metro
Jahrestag	yıldönümü
Verbesserungen	iyileştirmeler
Streifen	şerit
Spezifikation	Şartname
Unfall	kaza
Kerbe	Nick
zugänglich	ulaşılabilir
Bewohner	oturan
Handlung	arsa
typisch	tipik
Darstellung	temsil
Pumpe	pompa
existiert	var
Vereinbarungen	düzenlemeler
Konferenzen	konferanslar
Verbrauch	tüketim
eng	dar
Bedrohung	tehdit
Umfragen	anketler
Sitzung	oturma
Berater	danışman
Regler	kontrolör
Ausschüsse	komiteler
Penis	penis
Schloss	kale
Gardens	bahçeleri
Etiketten	etiketler
bereit	istekli
bio	biyo
Schauspielkunst	oyunculuk
Köpfe	kafaları
Prüfung	sınav
Residenz	Konut
Dichte	yoğunluk
hundert	yüz
seltsam	garip
nachhaltig	sürdürülebilir
statistisch	istatistiksel
erwähnen	Anma
Innovation	yenilik
grau	gri
parallel	paralel
arbeiten	işletmek
Banknoten	fatura
stabil	kararlı
Definitionen	tanımlar
von	von
Ärzte	doktorlar
Lektion	ders
Kino	sinema
Wahlen	seçimler
Reaktion	reaksiyon
leer	boş
verbessert	gelişmiş
berechtigt	adlı
schwer	şiddetli
generieren	üretmek
Zeitungen	gazeteler
Krankenhäuser	hastaneler
vi	vi
Humor	Mizah
alt	yaşlı
Monitore	monitör
Ausnahme	istisna
Dauer	süre
Masse	kütle
Besuche	ziyaret
Fähigkeiten	yetenekleri
Empfehlung	tavsiye
Sünde	günah
organisiert	örgütlü
ba	ba
para	paragraf
Annahme	Benimseme
Verbesserung	geliştirme
teuer	pahalı
Büffel	bizon
Organisationen	organizasyonlar
Ebene	uçak
Programme	programlar
Mechanismus	mekanizma
ee	ee
markiert	işaretlenmiş
Gefahren	tahrik
Flasche	şişe
innovativ	yenilikçi
Massage	masaj
Fazit	Sonuç
Schließen	kapanış
tausend	bin
Legende	efsane
Villa	villa
Knochen	kemik
Säulen	sütunlar
Störungen	bozukluklar
Zusammenarbeit	işbirliği
Entdeckung	bulma
innere	iç
Formation	formasyon
med	med
Ingenieure	mühendisler
Entität	varlık
Kreuzfahrten	yolculukları
Tor	kapı
römisch	Roma
Aufgaben	görevleri
erotisch	erotik
Ton	ton
Ethik	ahlâk
Drachen	Ejderha
beschäftigt	meşgul
Kapitän	Kaptan
bringt	getiriyor
Heizung	ısıtma
Bein	bacak
Hals	boyun
Flügel	kanat
Skripte	senaryo
ABC	ABC
ernannt	döşenmiş
Behandlung	muamele
verpflichten	işlemek
Schiene	Demiryolu
Reisen	gezileri
Spalt	boşluk
Seiten	taraf
Tube	tüp
dazugehörigen	uyan
Beschreibungen	açıklamaları
Gürtel	kemer
Jacke	ceket
Animation	animasyon
Orakel	torpil
er	er
Produktionen	yapımları
Luftfahrt	havacılık
stolz	gururlu
Katastrophe	afet
Konsole	konsol
Befehle	komutlar
jr	jr
Telekommunikation	telekomünikasyon
Lehrer	eğitmen
Riese	dev
erreicht	elde
Verletzungen	yaralanmalar
Ansätze	yaklaşımlar
gewöhnlich	olağan
Briefmarken	pullar
Winkel	açı
rauben	soymak
Designer	tasarımcılar
Freiheit	özgürlük
Epoche	çağ
Konvertieren	dönüştürmek
Möglichkeit	olasılık
Analytiker	analist
gefährlich	tehlikeli
Zuverlässigkeit	güvenilirlik
beziehungsweise	sırasıyla
Freiwillige	gönüllüler
abgeleiteten	türetilmiş
Vergnügen	Zevk
Ehre	Onur
orientiert	yönlü
Adler	kartal
Gebet	namaz
Workshops	atölyeler
Hurrikan	kasırga
ruhig	sessiz
Hersteller	yapımcı
repräsentiert	temsil
Verantwortlichkeiten	sorumluluklar
Käse	peynir
vorsichtig	dikkatlice
Produktivität	verimlilik
Krone	taç
Par	eşitlik
Diagnose	Teşhis
Hersteller	yapıcı
Riss	çatlak
Prinzip	prensip
Picks	seçtikleri
Gang	çete
Fetisch	fetiş
Aussehen	görünüm
Rauch	duman
Filter	filtreler
inkorporiert	Anonim
Kunst	zanaat
Gefährte	adam
blind	kör
Salon	salon
wütend	deli
Algorithmus	algoritma
stark	şiddetle
Cafe	kafe
ken	ken
Proteine	proteinler
su	su
familiär	tanıdık
fähig	yetenekli
Eintritt	kabul
Schuh	ayakkabı
gewählt	seçildi
Tragen	taşıma
Terrorismus	terörizm
Freude	sevinç
Ausgaben	sürümleri
ethnisch	etnik
Parlament	parlamento
Darsteller	aktör
Funde	buluntular
Dichtung	mühür
Situationen	durumlar
fünfte	beşinci
Bürger	vatandaş
vertikal	dikey
Korrekturen	düzeltmeler
beschreibt	açıklar
Behinderungen	engelli
Substanz	madde
verboten	yasak
Rohr	boru
Soldaten	askerler
Wächter	Gardiyan
Vorlesung	ders
Simulation	simülasyon
Layout	düzen
Initiativen	girişimler
krank	hasta
Konzentration	konsantrasyon
legen	yatırmak
Deutung	yorumlama
dreckig	kirli
unterrichtet	öğretilen
Arbeitnehmer	işçi
Optimierung	optimizasyon
Tempel	tapınak
Substanzen	maddeler
beweisen	kanıtlamak
entdeckt	keşfedilen
Flügel	kanatlar
genetisch	genetik
Beschränkungen	kısıtlamalar
dünn	ince
Ausstellung	sergi
Grat	sırt
Modem	modem
bringen	getiren
krank	hasta
bewerten	değerlendirmek
tropisch	tropikal
sammeln	toplamak
Vektor	vektör
bestimmt	kesinlikle
Drehung	döndürme
Existenz	varoluş
Kommentar	yorum
Entwicklungen	gelişmeler
Einwanderung	göç
Reiseziele	yerler
gegenseitig	karşılıklı
Syntax	sözdizimi
li	li
Attribut	nitelik
Gefängnis	hapis
Fertigkeit	beceri
Stühle	sandalye
Umgebung	çevreleyen
Berge	dağlar
Popularität	popülerlik
Anfrage	soruşturma
geprüft	kontrol
Ausstellungsstück	sergi
werfen	atmak
Trend	akım
Katzen	kediler
Wüste	çöl
ya	ya
Koordinator	koordinatör
Quecksilber	Merkür
Verbrennung	yanan
Flucht	kaçış
Empfänger	alıcı
progressiv	ilerici
Boote	tekneler
Meisterschaft	şampiyonluk
Arkade	çarşı
unmöglich	imkansız
erzählt	anlatır
offensichtlich	açık
Depression	depresyon
Graph	grafik
Abdeckung	kaplama
Platin	platin
Beurteilung	yargı
Gespräche	görüşmeler
Einreichung	dosyalama
fördern	beslemek
ausgezeichnet	layık
Versuche	denemeler
Meister	ustaları
Patrone	kartuş
Erläuterung	açıklama
org	org
Betrug	dolandırıcılık
Elektrizität	elektrik
Spektrum	spektrum
Ankunft	varış
Keramik	çömlekçilik
Betonung	vurgu
genial	müthiş
Bestätigt	onaylı
zählt	sayımları
Absturz	kaza
Aufzug	asansör
inter	arası
Höhen	yükseklikleri
Schatten	gölge
Ausgabe	gider
wagen	girişim
Klinik	klinik
Heilung	şifa
Prinzessin	prenses
Eingeben	girme
Paket	paket
Studios	stüdyoları
Beteiligung	ilgi
Papa	baba
Tasten	düğmeleri
Platzierung	yerleştirme
Beobachtungen	gözlemler
Gewinner	kazananlar
Straßen	yollar
anschließend	sonraki
Garten	avlu
Bekanntgabe	ifşa
Einrichtung	kuruluş
Erinnerungen	hatıralar
te	te
schafft	yaratır
Gesichter	yüzleri
Tourist	turist
Mord	cinayet
angemessene	yeterli
Senator	senatör
Präsentationen	sunumlar
verdauen	özet
Staub	toz
Wiki	wiki
ersetzt	değiştirilir
Radar	radar
Verluste	kayıplar
Kampf	savaş
Reduzierung	indirgen
gestoppt	durduruldu
Besetzung	Meslek
eng	yakından
Strahlung	radyasyon
Könige	krallar
Schießen	çekim
Ohr	kulak
Flaggen	bayraklar
Bäcker	fırıncı
konservativ	muhafazakâr
Schock	şok
Wirksamkeit	etki
Krawatte	kravat
Dach	çatı
zeigen	göstermek
Atmosphäre	atmosfer
Kuss	öpücük
Tier	canavar
ra	ra
betrieben	ameliyat
Experiment	deney
Ziele	hedefler
Einkäufe	alımları
Föderation	federasyon
Pizza	Pizza
eingeladen	davet
Zuordnung	atama
modern	şık
Abfragen	sorguları
Abwesenheit	yokluk
Anbieter	satıcıları
Yoga	yoga
dient	vermektedir
Überraschung	sürpriz
Lampe	Lamba
Witze	espriler
Beratung	danışmanlık
Palast	Saray
zufrieden	memnun
Gewinnt	kazanç
Warenhaus	depo
soll	sözde
gewöhnliche	sıradan
Geist	hayalet
Verstoß	ihlal
Boss	patron
Stolz	gurur
Erwartungen	beklentiler
Unabhängigkeit	bağımsızlık
wissend	bilme
Reporter	muhabir
Stoffwechsel	metabolizma
Champion	şampiyon
persönlich	Şahsen
reichlich	bol
Solo	solo
Kehle	boğaz
Reichtum	servet
Vakuum	vakum
Tanzen	dans
erkenne	tanımak
schreibt	yazıyor
Piazza	plaza
Suche	araştırma
veröffentlichen	Yayınla
Abschirmung	tarama
trans	trans
Pionier	öncü
Vergessene	unutulmuş
Akrobat	akrobat
Platten	plakalar
Aufsätze	denemeler
Verhalten	davranış
erzählen	söylüyorum
ziemlich	oldukça
intelligent	akıllı
Modi	modları
Verpflichtung	yükümlülük
Hafen	liman
Reisende	gezgin
Segment	bölüm
Feind	düşman
Puzzle	bulmaca
Brunnen	kuyular
beschränkt	kısıtlı
Republikaner	cumhuriyetçi
Geheimnisse	sırlar
Syndrom	sendrom
Teilnahme	katılım
Elfmeter	ceza
Trommel	davul
ermöglicht	sağlayan
Baumeister	kurucu
Aussicht	manzara
Flut	sel
Leichtigkeit	kolaylaştırmak
Argumente	argümanlar
Arena	arena
Abenteuer	maceralar
Schüler	öğrenciler
Ankündigung	duyuru
Ergebnis	sonuç
schätzen	anlamak
ergänzt	genişletilmiş
gewachsen	yetişkin
schön	güzel
Zentren	merkezleri
Klausel	fıkra
Lächeln	gülümseme
Länder	topraklar
Truppen	asker
bewaffnet	silâhlı
Kiefer	çam
Kühlung	soğutma
Golf	körfez
LKW	kamyonlar
Mechanismen	mekanizmalar
Scheidung	boşanma
Tradition	gelenek
Pillen	haplar
Tiger	kaplan
Leute	arkadaşlar
Sensor	algılayıcı
ausgesetzt	maruz
Jagd	av
Engel	melekler
Stellvertreter	milletvekili
thailändisch	Tayland
Emissionen	emisyonları
Ärzte	hekimler
Beschwerde	şikâyet
Szenen	sahneler
Experimente	deneyler
Auftrieb	artırmak
Führung	Yönetim
Mühle	değirmen
Gegründet	kurulmuş
chronisch	kronik
Höhle	den
Finger	parmak
hält	tutar
Pfund	pound
Lokalisieren	yerleştirmek
pl	pl
trainiert	eğitilmiş
Umsetzung	uygulanması
Brot	ekmek
Motoren	motorlar
zäh	sert
Vorfall	olay
Dynamik	dinamik
Lüge	Yalan
Konversation	konuşma
verringern	azaltmak
Anbetung	ibadet
Fähigkeit	kabiliyet
ak	ak
Präzision	hassas
Schadenersatz	tazminat
Reserve	rezervler
lösen	çözmek
Minderheit	azınlık
vielfältig	çeşitli
Zutaten	malzemeler
Ah	Ah
Töne	sesleri
Rehabilitation	rehabilitasyon
Sicht	görme
Lehm	kil
schwach	zayıf
geteilt	bölünmüş
Rezeption	resepsiyon
weise	bilge
Chancen	olasılık
Seminare	seminer
Folgen	sonuçları
Entscheidungsträger	vericiler
Erdkunde	coğrafya
Integrität	bütünlük
Erbe	miras
zufrieden	memnun
Achtung	Tehlike
Vitamin	vitamin
verarbeitet	işlenmiş
Phrase	ifade
erziehen	yükselen
Auswirkungen	etkileri
Funktionalität	işlevselliği
Paradies	cennet
hybrid	melez
liest	okur
emotional	duygusal
Ruhm	şan
ja	ja
geographisch	coğrafi
überschreiten	aşmak
Stange	çubuk
Seide	ipek
Babys	bebekler
Bi	bi
romantisch	romantik
aufgedeckt	ortaya
Spezialisten	uzmanlar
Generator	jeneratör
Suspension	süspansiyon
traurig	üzgün
Korrektur	düzeltme
Wolf	Kurt
langsam	yavaşça
Ergänzung	ek
Teile	bölümleri
Säugling	bebek
Branchen	sektörler
Flüssigkeit	akışkan
Begründung	zeminler
Mahlzeit	yemek
ta	ta
Maschinen	makinalar
Gleichung	denklem
Körbe	sepetler
Wahrscheinlichkeit	olasılık
Abmessungen	boyut
studierte	okudu
Gewinne	kar
Teufel	şeytan
Gras	çimen
illustriert	resimli
Kirsche	Kiraz
kontinental	kıta
Leistung	başarı
Einschränkungen	sınırlamaları
Beerdigung	cenaze
Kapitel	bölümler
Passagier	yolcu
praktisch	uygun
Mars	Mars
Größe	boy
Ei	Yumurta
Signale	sinyalleri
Orientierung	oryantasyon
Diebstahl	Çalınması
Kindheit	çocukluk
Symbole	semboller
lat	lat
Meta	meta
Analog	analog
Talent	yetenek
datiert	tarihli
Weisheit	bilgelik
Grenze	sınır
Elite	seçkinler
gi	gi
glaubt	inanır
Gedichte	şiirler
Zuständigkeit	yargı
Roboter	robot
Anzeige	sergileyen
Zeuge	tanık
ausgestattet	donanımlı
Stufen	aşamaları
sur	sur
erworben	Edinilen
beurteilen	belirlemek
waschen	yıkama
Eingang	Giriş
Erklärung	deklarasyon
verlieren	kaybetme
Versuche	denemeler
edel	asil
Automatisierung	otomasyon
Auswirkungen	etkiler
Umdrehung	devir
Vorteile	avantajları
Ritter	şövalye
Ziele	Amaçları
Erweiterungen	uzantılar
Einsprüche	itirazlar
Krankheit	hastalık
ho	ho
Alternativen	alternatifleri
Sch	sh
Seife	sabun
Marmelade	reçel
ungewöhnlich	olağandışı
antwortete	cevap
Zerstörung	imha
Migration	göç
Störung	düzensizlik
konventionell	Konvansiyonel
tragen	giyme
Achse	eksen
gesucht	aranan
Gene	genler
Median	medyan
Scanner	tarayıcı
hierin	burada
lebhaft	canlandırılmış
Einstellung	ayarlama
Held	kahraman
Behandlungen	tedaviler
Haltung	tutum
Teppich	halı
Linsen	lensler
besucht	katıldı
Schwierigkeit	zorluk
Punk	punk
Koalition	koalisyon
Einschreibung	kayıt
Herzog	dük
Tempo	hız
Produzenten	üreticileri
Bogen	yay
Schnittstellen	arayüzleri
Atlas	Atlas
Überwachung	gözlem
Folter	işkence
gelöscht	silindi
Mantel	ceket
Wiederherstellung	restorasyon
Bequemlichkeit	Kolaylık
Rückkehr	dönen
Opposition	muhalefet
Container	konteyner
Beklagte	sanık
Supervisor	gözetmen
Korps	kolordu
Schauspieler	aktörler
Leber	karaciğer
haftbar	sorumlu
Petition	dilekçe
Antenne	anten
gepflückt	seçilmiş
Glauben	inanç
Tötung	öldürme
Schulter	omuz
Dekor	dekor
Ion	iyon
Durchmesser	çap
Podcast	podcast
Wechselwirkungen	etkileşimler
Sänger	şarkıcı
Herold	haberci
Altern	yaşlanma
Intervention	müdahale
Plugin	Eklenti
Attraktion	cazibe
Tauchen	dalış
Änderung	değişiklik
annehmen	varsaymak
Schilf	kamış
betreffen	dahil
mäßig	ılımlı
Mäuse	fareler
verstanden	anladım
schnell	hızla
Verbot	yasak
Sicherheit	güvence
Ereignis	olay
weit	Muazzam
Mühlen	üreticiler
Gliederung	taslak
erhält	aldığı
Jeans	kot
Zusammenstellung	derleme
ungerade	garip
sigma	sigma
GR	gr
attraktiv	çekici
Gelegenheit	fırsat
Aufnahmen	kayıtları
Opfer	kurban
Forderungen	talepler
Vorsichtig	dikkatli
Strahl	kiriş
Gartenarbeit	Bahçıvanlık
Verbindlichkeiten	yükümlülükleri
ankommen	varmak
Orchester	orkestra
Lizenz	lisans
einstellbar	ayarlanabilir
Zuweisung	tahsis
Aufsatz	deneme
gezeigt	gösterdi
Dialog	diyalog
Lager	kampları
erklärt	beyan
Spur	iz
geschlossen	kapamak
Packungen	paketleri
