из	de
в	à
в	dans
для	pour
является	est
на	sur
что	cette
от	par
это	ce
с	avec
я	je
вы	toi
Это	il
или	ou
быть	être
находятся	sont
в	à
все	tout
иметь	avoir
новый	Nouveau
мы	nous
будем	volonté
Главная	maison
нас	nous
около	sur
если	si
страница	page
мой	mon
имеет	a
поиск	chercher
свободно	gratuit
но	mais
наш	notre
один	un
Другие	autre
делать	faire
Информация	information
время	temps
он	il
который	lequel
их	leur
Новости	nouvelles
использование	utilisation
там	Là
видеть	voir
так	alors
кто	qui
Web	toile
также	aussi
получить	obtenir
вечера	pm
Посмотреть	vue
с	c
е	e
первый	premier
было	été
бы	aurait
мы	étaient
s	s
как	comme
Икс	X
чем	que
найти	trouver
цена	prix
назад	arrière
Вверх	Haut
люди	gens
имел	avait
список	liste
имя	prénom
просто	juste
год	an
день	journée
в	dans
два	deux
здоровье	santé
N	n
ре	ré
используемый	utilisé
идти	aller
б	b
последний	dernier
делать	faire
их	leur
должен	devrait
продукт	produit
система	système
после	poster
ее	sa
город	ville
T	t
политика	politique
номер	nombre
поддержка	soutien
сообщение	message
после	après
тогда	puis
январь	jan
хорошо	bien
d	ré
где	où
Информация	Info
права	droits
книги	livres
высокая	haute
школа	école
м	m
каждый	chaque
связи	liens
она	elle
лет	années
заказ	commande
очень	très
книга	livre
Предметы	articles
Компания	compagnie
р	r
читать	lis
группа	groupe
секс	sexe
многие	beaucoup
пользователь	utilisateur
де	de
задавать	ensemble
Генеральная	général
исследование	recherche
Университет	Université
январь	janvier
почта	courrier
полный	plein
отзывы	avis
программа	programme
знать	connaître
игры	Jeux
путь	façon
дней	journées
п	p
часть	partie
мог	pourrait
Великий	génial
единый	uni
реальный	réal
е	F
Международный	international
центр	centre
путешествовать	Voyage
Комментарии	commentaires
сделал	fabriqué
развитие	développement
доклад	rapport
член	membre
Детали	détails
линия	ligne
сроки	termes
до	avant
отели	hôtels
сделал	fait
Отправить	envoyer
правильно	droite
тип	type
местный	local
те	ceux
Результаты	résultats
офис	Bureau
национальный	nationale
автомобиль	voiture
дизайн	conception
принимать	prendre
отправил	posté
адрес	adresse
сообщество	communauté
в	dans
состояния	États
хотеть	vouloir
Телефон	téléphone
DVD	DVD
предмет	assujettir
между	entre
Форум	forum
семья	famille
L	l
длинный	longue
вес	w
показать	montrer
о	o
даже	même
черный	noir
особый	spécial
индекс	indice
являющийся	étant
женщины	femmes
много	beaucoup
знак	signe
файл	fichier
ссылка	lien
открытый	ouvrir
юг	Sud
дело	Cas
проект	projet
страницы	pages
версия	version
раздел	section
своя	posséder
дом	maison
безопасность	Sécurité
г	g
округ	comté
американский	américain
Фото	photo
игра	Jeu
члены	membres
мощность	Puissance
сеть	réseau
компьютер	ordinateur
системы	systèmes
три	Trois
место	endroit
конец	fin
час	h
его	lui
в	par
доступ	accès
думать	pense
север	Nord
Ресурсы	Ressources
текущий	actuel
большой	gros
СМИ	médias
закон	loi
контроль	contrôle
воды	eau
история	histoire
размер	Taille
личный	personnel
руководство	guider
магазин	boutique
каталог	annuaire
изменение	changement
белый	blanc
текст	texte
маленький	petit
рейтинг	évaluation
ставка	taux
правительство	gouvernement
дети	enfants
вернуть	revenir
студенты	élèves
v	v
Счет	Compte
раз	fois
уровень	niveau
цифровой	numérique
профиль	profil
предыдущий	précédent
форма	forme
Мероприятия	événements
люблю	amour
старый	vieux
Джон	John
главный	principale
вызов	appel
образ	image
отдел	département
заглавие	Titre
не	non
К	k
Y	y
страхование	Assurance
должен	doit
имущество	propriété
класс	classe
CD	CD
качественный	qualité
каждый	chaque
список	inscription
содержание	contenu
страна	pays
немного	peu
инструменты	outils
низкий	faible
Ответить	répondre
клиент	client
Декабрь	décembre
сравнить	comparer
кино	films
колледж	Université
стоимость	valeur
статья	article
человек	homme
работы	emplois
J	j
питание	aliments
автор	auteur
другой	différent
U	u
учить	apprendre
продажа	vente
Распечатать	impression
курс	cours
работа	emploi
комната	chambre
акции	Stock
обучение	entraînement
слишком	aussi
кредит	crédit
точка	point
наука	science
люди	Hommes
категории	catégories
запад	Ouest
смотреть	Regardez
английский	Anglais
команда	équipe
имущество	biens
коробка	boîte
условия	conditions
фото	Photos
гей	gai
нить	fil
категория	Catégorie
заметка	Remarque
жить	vivre
большой	grand
галерея	Galerie
Таблица	table
Однако	toutefois
июнь	juin
октябрь	octobre
ноябрь	novembre
рынок	marché
библиотека	bibliothèque
действие	action
Начало	début
серии	séries
функции	fonctionnalités
воздух	air
промышленность	industrie
план	plan
человек	Humain
да	Oui
второй	seconde
горячий	chaud
Стоимость	Coût
кино	film
форумы	forums
Март	Mars
ля	la
сентябрь	septembre
сказать	dire
собирается	Aller
медицинская	médical
друг	ami
декабрь	déc
сервер	serveur
заявление	application
сотрудники	Personnel
играть	jouer
вопросы	problèmes
апрель	avril
пользователи	utilisateurs
улица	rue
тема	sujet
против	contre
получил	eu
блог	Blog
вечеринка	fête
оплата	Paiement
оборудование	équipement
позволять	laisser
программы	programmes
правовой	légal
недавний	récent
парк	parc
акт	acte
проблема	problème
красный	rouge
дайте	donner
Память	Mémoire
представление	performance
Социальное	social
Q	q
история	récit
продавать	vendre
опции	Options
опыт	expérience
ключ	clé
тело	corps
молодой	Jeune
важный	important
поле	champ
мало	peu
восток	est
Один	unique
б	ii
возраст	âge
клуб	club
пример	Exemple
девочки	filles
Z	z
Дорога	route
подарок	cadeau
вопрос	question
Калифорния	Californie
жесткий	difficile
платить	Payer
четыре	quatre
покер	poker
вопрос	problème
ассортимент	gamme
здание	bâtiment
продавец	vendeur
суд	tribunal
февраль	février
результат	résultat
легкий	lumière
записывать	écrire
война	guerre
предлагает	offre
синий	bleu
группы	groupes
аль	Al
легко	facile
данный	donné
запрос	demande
факс	fax
Китай	Chine
изготовление	fabrication
картина	image
потребности	Besoins
возможное	possible
месяц	mois
главный	Majeur
звезда	étoile
будущее	avenir
пространство	espace
комитет	Comité
рука	main
солнце	Soleil
карты	cartes
Лондон	Londres
встреча	réunion
стали	devenir
ребенок	enfant
держать	garder
порно	porno
доля	partager
аналогичный	similaire
сад	jardin
школы	écoles
миллиона	million
добавленной	ajoutée
Справка	référence
компании	entreprises
детка	bébé
обучение	apprentissage
энергия	énergie
бег	courir
Доставка	livraison
популярный	populaire
срок	terme
фильм	film
истории	histoires
положил	mettre
журнал	journal
отчеты	rapports
Колорадо	co
пытаться	essayer
изображений	images
уведомление	remarquer
Бог	Dieu
оригинал	original
глава	tête
радио	radio
клетка	cellule
совет	conseil
включает	comprend
трек	Piste
обсуждение	discussion
архив	archiver
другие	autres
соглашение	accord
формат	format
общество	société
месяцы	mois
безопасность	sécurité
друзья	copains
конечно	sûr
издание	édition
Сообщения	messages
маркетинг	commercialisation
рассказать	dire
ассоциация	association
обеспечивает	fournit
весело	amusement
уже	déjà
зеленый	vert
исследования	études
Закрыть	Fermer
общий	commun
конкретный	spécifique
