из	de
в	à
в	dans
для	pour
является	est
на	sur
что	cette
от	par
это	ce
с	avec
я	je
вы	toi
Это	il
или	ou
быть	être
находятся	sont
в	à
все	tout
иметь	avoir
новый	Nouveau
мы	nous
будем	volonté
Главная	maison
нас	nous
около	sur
если	si
страница	page
мой	mon
имеет	a
поиск	chercher
свободно	gratuit
но	mais
наш	notre
один	un
Другие	autre
делать	faire
Информация	information
время	temps
он	il
который	lequel
их	leur
Новости	nouvelles
использование	utilisation
там	Là
видеть	voir
так	alors
кто	qui
Web	toile
также	aussi
получить	obtenir
вечера	pm
Посмотреть	vue
с	c
е	e
первый	premier
было	été
бы	aurait
мы	étaient
s	s
как	comme
Икс	X
чем	que
найти	trouver
цена	prix
назад	arrière
Вверх	Haut
люди	gens
имел	avait
список	liste
имя	prénom
просто	juste
год	an
день	journée
в	dans
два	deux
здоровье	santé
N	n
ре	ré
используемый	utilisé
идти	aller
б	b
последний	dernier
делать	faire
их	leur
должен	devrait
продукт	produit
система	système
после	poster
ее	sa
город	ville
T	t
политика	politique
номер	nombre
поддержка	soutien
сообщение	message
после	après
тогда	puis
январь	jan
хорошо	bien
d	ré
где	où
Информация	Info
права	droits
книги	livres
высокая	haute
школа	école
м	m
каждый	chaque
связи	liens
она	elle
лет	années
заказ	commande
очень	très
книга	livre
Предметы	articles
Компания	compagnie
р	r
читать	lis
группа	groupe
секс	sexe
многие	beaucoup
пользователь	utilisateur
де	de
задавать	ensemble
Генеральная	général
исследование	recherche
Университет	Université
январь	janvier
почта	courrier
полный	plein
отзывы	avis
программа	programme
знать	connaître
игры	Jeux
путь	façon
дней	journées
п	p
часть	partie
мог	pourrait
Великий	génial
единый	uni
реальный	réal
е	F
Международный	international
центр	centre
путешествовать	Voyage
Комментарии	commentaires
сделал	fabriqué
развитие	développement
доклад	rapport
член	membre
Детали	détails
линия	ligne
сроки	termes
до	avant
отели	hôtels
сделал	fait
Отправить	envoyer
правильно	droite
тип	type
местный	local
те	ceux
Результаты	résultats
офис	Bureau
национальный	nationale
автомобиль	voiture
дизайн	conception
принимать	prendre
отправил	posté
адрес	adresse
сообщество	communauté
в	dans
состояния	États
хотеть	vouloir
Телефон	téléphone
DVD	DVD
предмет	assujettir
между	entre
Форум	forum
семья	famille
L	l
длинный	longue
вес	w
показать	montrer
о	o
даже	même
черный	noir
особый	spécial
индекс	indice
являющийся	étant
женщины	femmes
много	beaucoup
знак	signe
файл	fichier
ссылка	lien
открытый	ouvrir
юг	Sud
дело	Cas
проект	projet
страницы	pages
версия	version
раздел	section
своя	posséder
дом	maison
безопасность	Sécurité
г	g
округ	comté
американский	américain
Фото	photo
игра	Jeu
члены	membres
мощность	Puissance
сеть	réseau
компьютер	ordinateur
системы	systèmes
три	Trois
место	endroit
конец	fin
час	h
его	lui
в	par
доступ	accès
думать	pense
север	Nord
Ресурсы	Ressources
текущий	actuel
большой	gros
СМИ	médias
закон	loi
контроль	contrôle
воды	eau
история	histoire
размер	Taille
личный	personnel
руководство	guider
магазин	boutique
каталог	annuaire
изменение	changement
белый	blanc
текст	texte
маленький	petit
рейтинг	évaluation
ставка	taux
правительство	gouvernement
дети	enfants
вернуть	revenir
студенты	élèves
v	v
Счет	Compte
раз	fois
уровень	niveau
цифровой	numérique
профиль	profil
предыдущий	précédent
форма	forme
Мероприятия	événements
люблю	amour
старый	vieux
Джон	John
главный	principale
вызов	appel
образ	image
отдел	département
заглавие	Titre
не	non
К	k
Y	y
страхование	Assurance
должен	doit
имущество	propriété
класс	classe
CD	CD
качественный	qualité
каждый	chaque
список	inscription
содержание	contenu
страна	pays
немного	peu
инструменты	outils
низкий	faible
Ответить	répondre
клиент	client
Декабрь	décembre
сравнить	comparer
кино	films
колледж	Université
стоимость	valeur
статья	article
человек	homme
работы	emplois
J	j
питание	aliments
автор	auteur
другой	différent
U	u
учить	apprendre
продажа	vente
Распечатать	impression
курс	cours
работа	emploi
комната	chambre
акции	Stock
обучение	entraînement
слишком	aussi
кредит	crédit
точка	point
наука	science
люди	Hommes
категории	catégories
запад	Ouest
смотреть	Regardez
английский	Anglais
команда	équipe
имущество	biens
коробка	boîte
условия	conditions
фото	Photos
гей	gai
нить	fil
категория	Catégorie
заметка	Remarque
жить	vivre
большой	grand
галерея	Galerie
Таблица	table
Однако	toutefois
июнь	juin
октябрь	octobre
ноябрь	novembre
рынок	marché
библиотека	bibliothèque
действие	action
Начало	début
серии	séries
функции	fonctionnalités
воздух	air
промышленность	industrie
план	plan
человек	Humain
да	Oui
второй	seconde
горячий	chaud
Стоимость	Coût
кино	film
форумы	forums
Март	Mars
ля	la
сентябрь	septembre
сказать	dire
собирается	Aller
медицинская	médical
друг	ami
декабрь	déc
сервер	serveur
заявление	application
сотрудники	Personnel
играть	jouer
вопросы	problèmes
апрель	avril
пользователи	utilisateurs
улица	rue
тема	sujet
против	contre
получил	eu
блог	Blog
вечеринка	fête
оплата	Paiement
оборудование	équipement
позволять	laisser
программы	programmes
правовой	légal
недавний	récent
парк	parc
акт	acte
проблема	problème
красный	rouge
дайте	donner
Память	Mémoire
представление	performance
Социальное	social
Q	q
история	récit
продавать	vendre
опции	Options
опыт	expérience
ключ	clé
тело	corps
молодой	Jeune
важный	important
поле	champ
мало	peu
восток	est
Один	unique
б	ii
возраст	âge
клуб	club
пример	Exemple
девочки	filles
Z	z
Дорога	route
подарок	cadeau
вопрос	question
Калифорния	Californie
жесткий	difficile
платить	Payer
четыре	quatre
покер	poker
вопрос	problème
ассортимент	gamme
здание	bâtiment
продавец	vendeur
суд	tribunal
февраль	février
результат	résultat
легкий	lumière
записывать	écrire
война	guerre
предлагает	offre
синий	bleu
группы	groupes
аль	Al
легко	facile
данный	donné
запрос	demande
факс	fax
Китай	Chine
изготовление	fabrication
картина	image
потребности	Besoins
возможное	possible
месяц	mois
главный	Majeur
звезда	étoile
будущее	avenir
пространство	espace
комитет	Comité
рука	main
солнце	Soleil
карты	cartes
Лондон	Londres
встреча	réunion
стали	devenir
ребенок	enfant
держать	garder
порно	porno
доля	partager
аналогичный	similaire
сад	jardin
школы	écoles
миллиона	million
добавленной	ajoutée
Справка	référence
компании	entreprises
детка	bébé
обучение	apprentissage
энергия	énergie
бег	courir
Доставка	livraison
популярный	populaire
срок	terme
фильм	film
истории	histoires
положил	mettre
журнал	journal
отчеты	rapports
Колорадо	co
пытаться	essayer
изображений	images
уведомление	remarquer
Бог	Dieu
оригинал	original
глава	tête
радио	radio
клетка	cellule
совет	conseil
включает	comprend
трек	Piste
обсуждение	discussion
архив	archiver
другие	autres
соглашение	accord
формат	format
общество	société
месяцы	mois
безопасность	sécurité
друзья	copains
конечно	sûr
издание	édition
Сообщения	messages
маркетинг	commercialisation
рассказать	dire
ассоциация	association
обеспечивает	fournit
весело	amusement
уже	déjà
зеленый	vert
исследования	études
Закрыть	Fermer
общий	commun
конкретный	spécifique
несколько	nombreuses
живой	vivant
коллекция	collection
называется	appelé
короткая	court
искусства	lettres
много	lot
просить	demander
ограниченное	limité
решения	solutions
директор	réalisateur
пляж	plage
мимо	passé
натуральный	Naturel
электроника	électronique
на	sur
период	période
планирование	Planification
говорит	dit
официальный	officiel
март	mar
сделанный	terminé
технический	technique
окно	fenêtre
профессионал	pro
область	Région
остров	île
запись	record
непосредственный	direct
конференция	conférence
учет	archives
улица	st
район	district
календарь	calendrier
расходы	frais
стиль	style
заявление	déclaration
миль	miles
ресурс	Ressource
Приложения	applications
документ	document
слово	mot
работает	travaux
материал	Matériel
законопроект	facture
написано	écrit
правила	règles
окончательный	final
вещь	chose
центр	centre
требования	exigences
ПРАВДА	VRAI
минут	minutes
еще	autre
отметка	marque
камень	Roche
Плохо	mal
индивидуальный	individuel
плюс	plus
авто	auto
обложка	couverture
редактировать	modifier
вместе	ensemble
видео	vidéos
быстро	vite
функция	fonction
факт	fait
получение	obtention
Глобальный	global
тек	technologie
встретить	rencontrer
далеко	loin
экономической	économique
ан	en
игрок	joueur
проектов	projets
количество	montant
смотреть	regarder
включены	inclus
Чувствовать	ressentir
банка	banque
риск	risque
предложения	offres
различный	divers
слова	mots
производство	production
коммерческая	commercial
вес	poids
сердце	cœur
лечение	traitement
точки	points
знание	connaissance
журнал	magazine
ошибка	Erreur
камера	caméra
девушка	fille
строительство	construction
игрушки	jouets
зарегистрированный	inscrit
домен	domaine
методы	méthodes
глава	chapitre
защита	protection
полисы	politiques
широкий	large
красота	beauté
менеджер	directeur
Индия	Inde
должность	position
взятый	pris
Сортировать	Trier
объявления	annonces
известен	connu
половина	moitié
случаи	cas
шаг	étape
инжиниринг	ingénierie
просто	simple
быстро	rapide
лицензия	Licence
озеро	Lac
все	entier
годовой	annuel
опубликованный	publié
церковь	église
метод	méthode
активный	actif
ответ	réponse
фигура	figure
материалы	matériaux
достаточно	assez
предназначенный	conçu
среди	parmi
смерть	décès
потеря	perte
лицо	visage
марка	marque
скидка	remise
последствия	effets
созданный	créé
стандарты	normes
немного	bit
политическая	politique
Королевство	Royaume
база	base
дела	Faire
кредитование	prêts
обувь	chaussures
запись	entrée
оставаться	rester
заказы	ordres
доступность	disponibilité
резюме	résumé
очередь	tour
рост	croissance
агентство	agence
король	Roi
Европейская	européen
Мероприятия	activité
копия	copie
вестерн	occidental
сила	Obliger
занятость	emploi
залив	baie
река	rivière
комиссия	commission
пакет	paquet
видели	vu
игроки	joueurs
двигатель	moteur
порт	Port
альбом	album
региональный	régional
стоп	Arrêtez
начал	commencé
администрация	administration
бар	bar
институт	institut
Просмотры	vues
двойной	double
собака	chien
скоро	bientôt
линии	lignes
электронный	électronique
выгоды	avantages
необходимый	nécessaire
принтер	imprimante
состояние	condition
эффективный	efficace
верить	croyez
организация	organisation
эффект	effet
разум	esprit
выбор	sélection
казино	casino
PDF	pdf
тур	tour
пересекать	traverser
надежда	espérer
корпорация	société
желание	souhait
решение	Solution
зрелый	mature
роль	rôle
недель	semaines
определенный	certain
ниже	inférieur
необходимо	nécessaire
союз	syndicat
понедельник	lun
ком	com
конкретный	particulier
отлично	bien
час	heure
газ	gaz
навыки	compétences
шесть	six
куст	buisson
острова	îles
совет	Conseil
карьера	carrière
решение	décision
оставлять	laisser
до	pré
огромный	énorme
женщина	femme
оборудование	installations
предложение	offre
средний	milieu
кабель	câble
возможности	Opportunités
принятие	prise
значения	valeurs
деление	division
приход	arrivant
объект	objet
лесбиянка	lesbienne
подходящее	approprié
машина	machine
логотип	logo
длина	longueur
хороший	agréable
Гол	But
статистика	statistiques
клиент	client
образец	échantillon
инвестиции	investissement
послал	envoyé
показанный	montré
рождество	Noël
культура	Culture
вспышка	flash
Миз	Mme
выбор	choix
курсы	cours
потребитель	consommateur
Здравствуй	salut
иностранные	étranger
художник	artiste
мебель	meubles
канал	canal
письмо	lettre
Режим	mode
телефоны	Téléphones
идеи	idées
состав	structure
степень	degré
контракт	Contrat
супер	super
мужской	mâle
дело	matière
почти	presque
располагается	situé
множественный	plusieurs
распределение	Distribution
редактор	éditeur
гостиница	auberge
промышленные	industriel
потенциал	potentiel
песня	chanson
лос	los
падать	tomber
идея	idée
номера	pièces
связь	communications
выиграть	gagner
первичный	primaire
рак	cancer
чисел	Nombres
причина	raison
инструмент	outil
весна	printemps
Фонд	fondation
ответ	répondre
голос	voix
график	programme
документы	documents
цель	objectif
особенность	fonctionnalité
постель	lit
выходит	vient
полиция	police
независимый	indépendant
подход	approche
коричневый	marron
физическое	physique
холм	colline
карты	Plans
держать	tenir
рейтинги	évaluations
счастливый	content
кузнец	forgeron
развитая	développé
спасибо	remercier
безопасно	sûr
уникальный	unique
опрос	enquête
предшествующий	avant
телефон	Téléphone
спорт	sport
готов	prêt
животное	animal
источники	sources
Население	population
папа	Pennsylvanie
регулярный	ordinaire
безопасный	garantir
операции	opérations
просто	simplement
доказательства	preuve
станция	gare
Понимаю	comprendre
вариант	option
долина	vallée
вероятно	Probablement
море	mer
публикации	publications
улучшать	améliorer
соединение	connexion
издатель	éditeur
зал	salle
анти	anti
сети	réseaux
Земля	Terre
родители	Parents
влияние	impact
перевод	transfert
введение	introduction
кухня	cuisine
сильный	fort
свадьба	mariage
свойства	Propriétés
больница	hôpital
земля	sol
корабль	navire
жилье	hébergement
болезнь	maladie
отлично	excellent
идеально	parfait
волосы	cheveux
возможность	opportunité
Комплект	trousse
классический	classique
основа	base
команда	commander
города	villes
экспресс	Express
награда	prix
расстояние	distance
дерево	arbre
оценка	évaluation
стена	mur
участвует	impliqué
эль	el
дополнительный	supplémentaire
особенно	notamment
бюджет	budget
направляющие	guides
успех	Succès
максимальная	maximum
мама	mère
операция	opération
существующий	existant
довольно	assez
выбранный	choisi
мальчик	garçon
ресторан	Restaurants
красивая	beau
предупреждение	Attention
места	Emplacements
лошадь	cheval
голос	vote
цветы	fleurs
звезды	étoiles
списки	listes
владелец	propriétaire
животные	animaux
пути	façons
сын	fils
обеспечение	fournir
правило	règle
Корпус	logement
принимает	prend
приносить	apporter
каталог	catalogue
Максимум	max
мама	mère
власть	autorité
сказал	Raconté
программа	programme
присоединился	relié
вход	contribution
стратегия	stratégie
ноги	pieds
агент	agent
действительный	valide
современное	moderne
старшая	Sénior
сексуальный	sexy
обучение	enseignement
дверь	porte
большой	grandiose
испытание	procès
единицы	unités
круто	cool
нормальный	Ordinaire
предприятие	entreprise
судов	navires
все	tout
положительный	positif
фитнес	aptitude
Китайский	chinois
мнение	opinion
футбол	Football
Абстрактные	abstrait
вывод	sortie
фонды	fonds
Мистер	M
вероятно	probable
развивать	développer
художники	artistes
альтернатива	alternative
обязанность	responsabilité
Ява	Java
гость	client
публикация	publication
проходить	passer
связи	rapports
доверять	confiance
фургон	van
содержит	contient
много	multi
республика	république
сборы	honoraires
компоненты	Composants
отпуск	vacances
века	siècle
академический	académique
помощь	assistance
завершено	terminé
кожа	peau
графика	graphique
индийский	Indien
кольцо	bague
класс	qualité
гора	Montagne
организации	organisations
фильтр	filtre
панель	panneau
пол	sol
покупка	achat
совпадение	rencontre
предложенный	proposé
требовать	exiger
мальчиков	garçons
утро	Matin
позволяет	permet
белок	protéine
растение	plante
сообщается	signalé
удар	frappé
мм	mm
бассейн	bassin
мини	mini
политика	politique
партнер	partenaire
авторы	auteurs
доски	planches
рыба	poisson
членство	adhésion
миссия	mission
глаз	œil
строка	chaîne
смысл	sens
модифицированный	modifié
выпущенный	libéré
сцена	étape
внутренний	interne
Родился	née
подробный	détaillé
Японский	Japonais
раса	course
утвержденный	approuvé
цель	cible
Кроме	sauf
персонаж	personnage
поддержание	entretien
способность	aptitude
издание	ed
изнасилование	râpé
аккумулятор	batterie
молодежь	jeunesse
давление	pression
Отправлено	soumis
долг	dette
средний	moyen
телевидение	télévision
заинтересованный	intéressé
ядро	coeur
ломать	Pause
цели	fins
наборы	ensembles
танец	Danse
дерево	bois
определенный	défini
документы	papiers
награды	prix
плата	frais
студия	studio
читатель	lecteur
устройство	dispositif
установленный	établi
ответы	réponses
аренда	location
лас	Las
темно	foncé
внешний	externe
яблоко	Pomme
ле	le
инструкции	instructions
мин	min
предложенный	offert
теория	théorie
Удалить	retirer
помощь	aide
визуальный	visuel
хозяин	hôte
разнообразие	variété
учителей	enseignants
руководство	Manuel
блок	bloc
предметы	sujets
агенты	agents
ремонт	réparation
Справедливая	juste
стали	acier
понимание	compréhension
песни	Chansons
исправлено	fixé
неправильно	faux
начало	début
Руки	mains
Аризона	az
Париж	Paris
получает	obtient
сектор	secteur
вместимость	capacité
ООН	ONU
жир	graisse
отец	père
электрический	électrique
увидел	vu
инструменты	instruments
сотрудник	officier
Водитель	chauffeur
бизнес	entreprises
мертвый	mort
неизвестный	inconnu
ресторан	restaurant
Майк	Mike
поездка	voyage
ми	mi
бедные	pauvre
отношения	relation
рабочие	ouvriers
мир	paix
традиционный	traditionnel
показ	projection
творческий	Créatif
берег	côte
выгода	avantage
финансирование	financement
приборы	dispositifs
господин	Seigneur
даровать	subvention
суб	sous
фантастика	fiction
часы	montres
карьера	carrières
идет	va
светодиод	LED
музей	musée
поклонник	ventilateur
транспорт	transport
интересно	intéressant
блоги	blogs
оценка	évaluation
бывший	ancien
зона	zone
сложный	complexe
го	e
Кот	chat
умереть	mourir
представленный	présenté
квартира	appartement
течь	couler
агентства	agences
литература	Littérature
родитель	parent
установка	réglage
доктор	dr
масштаб	échelle
экономика	économie
полезный	utile
ежемесячно	mensuel
критический	critique
Рамка	Cadre
музыкальный	musical
определение	définition
секретарь	secrétaire
дорожка	chemin
главный	chef
дает	donne
пакеты	paquets
подробно	détail
законы	lois
изменено	modifié
начать	commencer
королевский	Royal
чистый	nettoyer
парень	gars
названия	titres
Соответствующий	pertinent
справедливость	Justice
соединять	relier
кружка	Coupe
корзина	panier
прикладная	appliqué
еженедельно	hebdomadaire
об	vol
монтаж	installation
стр	pp
внимание	attention
продвижение	avance
пропускать	sauter
диета	régime
армия	armée
шестерня	équipement
разница	différence
позволил	permis
верный	correct
нация	nation
продажа	vente
много	beaucoup
кусок	pièce
лист	drap
фирма	raffermir
Семь	Sept
элементы	éléments
вид	espèce
Прыгать	saut
ячейки	cellules
модуль	module
курорт	recours
сертификат	certificat
министр	ministre
движение	mouvement
мода	mode
направления	directions
посетители	visiteurs
документация	Documentation
торговый	commerce
лес	forêt
звонки	appels
покрытие	couverture
пара	couple
дающий	donnant
шанс	chance
видение	vision
мяч	ballon
окончание	fin
клиенты	clients
действия	actes
обсуждать	discuter
Цель	objectif
успешный	réussi
продан	vendu
ветер	vent
сообщества	communautés
клиническая	clinique
ситуация	situation
рынки	marchés
издательский	édition
появиться	apparaître
развивающийся	développement
жизни	vies
определить	déterminer
температура	Température
объявления	annonces
пациент	patient
фактический	réel
исторический	historique
камень	pierre
боб	bob
коммерция	Commerce
лиц	personnes
сложно	difficile
научный	scientifique
спутник	Satellite
тесты	essais
деревня	village
Счета	comptes
любитель	amateur
бывший	ex
встретил	rencontré
боль	douleur
факторы	facteurs
кофе	café
покупатель	acheteur
плакат	affiche
край	bord
функциональная	fonctionnel
корень	racine
фи	Fi
закрыто	fermé
каникулы	vacances
розовый	rose
баланс	équilibre
мониторинг	surveillance
ответы	réponses
выстрел	coup
начальная	initiale
метка	étiquette
сек	seconde
канон	canon
лига	ligue
отходы	déchets
минут	minute
автобус	autobus
поставщик	fournisseur
Словарь	dictionnaire
учет	comptabilité
производство	fabrication
разделы	sections
стул	chaise
усилие	effort
фаза	phase
фантазия	fantaisie
ро	po
в	Virginie
профессор	professeur
устанавливать	installer
Рубашка	chemise
одежда	vêtements
фут	pied
грудь	Sein
методы	techniques
долларов	dollars
религия	religion
разрешение	autorisation
дикий	sauvage
поколение	génération
Мисс	manquer
химическая	chimique
врач	docteur
задача	tâche
уменьшить	réduire
привел	apporté
упражнение	exercice
ошибка	punaise
гарантия	garantie
лидер	chef
се	se
процессы	processus
мягкий	doux
встречи	réunions
секунд	secondes
рейс	vol
конгресс	congrès
топливо	carburant
ходить	marche
произведенный	produit
святой	Saint
аргумент	argument
соревнование	compétition
наркотики	drogues
совместный	mixte
премия	prime
свежий	Frais
персонажи	personnages
адвокат	avocat
ди	di
фактор	facteur
тысячи	milliers
км	km
поток	courant
апартаменты	appartements
выбирать	choisir
слух	audition
восточный	est
терапия	thérapie
записи	entrées
подписанный	signé
административный	administratif
серьезный	sérieux
предел	limite
меры	pas
магазины	magasins
зависимость	esclavage
дель	del
усилия	efforts
проинформировал	informé
Джорджия	Géorgie
мысли	pensées
ручей	ruisseau
фут	ft
количество	quantité
существенный	essentiel
туры	Tours
нагрузка	charge
немедленно	immédiatement
машины	Machines
назначенный	désigné
тяжелый	lourd
покрытый	couvert
восстановление	récupération
интегрированный	intégré
конфигурация	configuration
петух	coq
торговец	marchande
комплексный	complet
эксперт	expert
защищать	protéger
твердый	solide
презентация	présentation
стал	devenu
оранжевый	Orange
соблюдение	conformité
тема	thème
богатые	riches
кампания	campagne
против	contre
гитара	guitare
обнаружение	découverte
Примеры	exemples
дух	esprit
Арканзас	ar
требования	réclamations
принятие	acceptation
стратегии	stratégies
мо	mo
дела	affaires
предназначена	prévu
са	sa
цели	buts
Наем	louer
выборы	élection
предлагать	suggérer
филиал	branche
обслуживать	servir
филиалы	affiliés
крепление	monter
латинский	Latin
мультимедиа	multimédia
управлять	gérer
угол	coin
ранг	rang
элемент	élément
рождение	naissance
вирус	virus
интерактивный	interactif
Запросы	demandes
отдельный	séparé
четверть	trimestre
процедура	procédure
руководство	direction
определять	définir
религиозная	religieux
факты	faits
завтрак	déjeuner
колонка	colonne
вера	Foi
цепь	chaîne
идентифицировать	identifier
проспект	rue
отсутствует	disparu
рекомендации	recommandations
переехал	déplacé
достичь	atteindre
сравнение	Comparaison
момент	moment
расширенный	élargi
последовательность	séquence
дюймовый	pouce
атака	attaque
центры	centres
открытие	ouverture
лаборатория	laboratoire
резерв	réserve
гамма	gamma
производить	produire
правда	vérité
счетчик	compteur
отказ	échec
следует	suit
доллар	dollar
лагерь	camp
дез	des
фильмы	films
мост	pont
заполнить	remplir
движение	mouvement
печать	impression
проект	Brouillon
диаграмма	graphique
играл	joué
контакты	Contacts
читатели	lecteurs
клубы	clubs
Вашингтон	Washington
приключение	aventure
предложение	offre
прибыль	profit
лидеры	dirigeants
плакаты	affiches
учреждения	institutions
помощник	assistant
переменная	variable
диджей	dj
стоянка	parking
вчера	hier
определенный	déterminé
мастерская	atelier
прошло	disparu
коды	codes
виды	types
расширение	extension
заявления	déclarations
полностью	complètement
команды	équipes
форт	fort
см	cm
сенат	sénat
веселая	drôle
ген	gène
оказалось	tourné
диск	disque
шаблон	modèle
лодка	bateau
театр	théâtre
производители	fabricants
спонсор	parrainer
классический	classique
значок	icône
гарантия	garantie
преданный	dévoué
направление	direction
баскетбол	basketball
объекты	objets
Удалить	effacer
вечер	soir
сборка	Assemblée
ядерной	nucléaire
мышь	Souris
сигнал	signal
преступник	criminel
выпущен	Publié
мощный	puissant
мечта	rêver
ЛОЖНЫЙ	FAUX
да	da
бросать	jeter
цветок	fleur
персонал	personnel
прошло	passé
поставляется	fourni
падения	chutes
душа	âme
содействовать	promouvoir
заявил	déclaré
статистика	Statistiques
профессионалов	professionnels
появляется	apparaît
нести	porter
флаг	drapeau
крышки	couvertures
Эм	em
преимущество	avantage
Здравствуйте	Bonjour
конструкции	dessins
поддерживать	maintenir
туризм	tourisme
приоритет	priorité
Взрослые	adultes
графический	graphique
атом	atome
платежи	Paiements
переплет	contraignant
краткое	bref
закончился	terminé
выигрыш	gagnant
анонимный	anonyme
скрипт	scénario
служил	servi
хочет	veut
подготовленный	préparé
недействительным	vide
тег	marque
интервью	entretien
смешивание	mélanger
фреймворк	cadre
диск	disque
установлен	installée
Королева	reine
кредиты	crédits
явно	clairement
фиксировать	réparer
ручка	manipuler
милая	doux
критерии	Critères
ассоциировать	associer
Небраска	ne
поведение	comportement
увеличить	agrandir
луч	rayon
доход	revenu
измерение	mesure
голосов	votes
дю	du
обязанность	devoir
обсуждение	discussions
медведь	ours
усиление	Gain
фестиваль	Festival
лаборатория	laboratoire
океан	océan
рейсы	vols
эксперты	experts
знаки	signes
глубина	profondeur
поезд	train
сухой	sec
исследовать	explorer
спа	spa
концепция	concept
около	presque
обращение	manipulation
происхождения	origine
миллиард	milliard
интеллект	intelligence
купил	acheté
против	escroquerie
нации	nations
маршрут	route
сломанный	cassé
боевой	bataille
говорить	parler
протокол	protocole
запрос	question
партнерство	Partenariat
выражение	expression
эс	es
речь	discours
провод	câble
предложения	suggestions
замена	remplacement
лента	ruban
стратегическое	stratégique
судья	juge
кислота	acide
байтов	octets
цент	cent
принудительный	forcé
совместимый	compatible
квартира	appartement
ноль	nul
нуль	zéro
оратор	orateur
консалтинг	consultant
дизайнер	designer
пр	pr
брак	mariage
рулон	rouleau
банки	banques
фр	fr
участники	participants
секрет	secret
отрицательный	négatif
избранное	favoris
театр	théâtre
пружины	ressorts
вар	var
выполнять	effectuer
перевод	Traduction
оценки	estimations
травма	blessure
министерство	ministère
водители	conducteurs
адвокат	avocat
цифры	chiffres
защищенный	protégé
предложение	proposition
разделение	partage
портал	portail
бета	bêta
бесплатно	gratuitement
к	vers
немного	légèrement
помощь	aider
поведение	conduite
содержащиеся	contenu
законодательство	législation
призвание	appel
параметры	paramètres
профили	profils
вопросы	questions
дома	Maisons
управления	contrôles
комбинированный	combiné
окончательный	ultime
представитель	représentant
незначительный	mineur
ведомства	départements
жители	résidents
отображается	affiché
Мама	maman
уменьшенный	réduit
редкий	rare
выполнено	réalisée
экстремальный	extrême
образцы	échantillons
брусья	barres
прогноз	prévoir
удален	supprimé
цикл	cycle
содержать	contenir
точность	précision
спать	dormir
мг	mg
птица	oiseau
аптека	pharmacie
создание	création
статический	statique
охотник	chasseur
адреса	adresses
леди	Dame
кристалл	cristal
известный	célèbre
писатель	écrivain
председатель	président
напиток	boisson
академия	académie
динамический	dynamique
есть	manger
постоянный	permanent
уборка	nettoyage
составляет	constitue
портфолио	portefeuille
практическое	pratique
доставлен	livré
инфраструктура	Infrastructure
цвет	Couleur
продавец	vendeur
философия	philosophie
регулирование	règlement
офицеры	officiers
цель	objectif
предложения	offres
питание	nutrition
запись	enregistrement
младший	junior
ле	les
мыс	cap
кольца	anneaux
наконечник	pointe
замечательно	formidable
билет	billet
объявленный	annoncé
Угадай	deviner
кого	qui
футбольный	football
математический	math
Импортировать	importer
проводка	affectation
присутствие	présence
автоматический	automatique
просмотр	visualisation
поддерживается	entretenu
ч	ch
Дан	dan
собаки	chiens
директора	directeurs
аспекты	aspects
впереди	devant
Луна	lune
участие	participation
схема	schème
летать	mouche
манера	manière
матрица	matrice
сочетание	combinaison
поправка	amendement
прочность	force
Турция	dinde
библиотеки	bibliothèques
правильный	correct
степени	degrés
предприятия	entreprises
дельта	delta
страх	peur
Ищу	recherche
дюймов	pouces
условность	convention
акции	actions
главный	principal
комфорт	confort
цвета	couleurs
войны	guerres
заказ	commande
хранится	conservé
альфа	alpha
обращение	charme
круиз	croisière
бонус	prime
Привет	Hey
здания	bâtiments
скидки	promos
бить	battre
батареи	batteries
становится	devient
диски	disques
оружие	bras
чай	thé
улучшен	amélioré
достигать	atteindre
позиции	positions
платье	robe
подписка	abonnement
дилер	Marchand
современный	contemporain
небо	ciel
ПЗУ	ROM
осуществляется	porté
воздействие	exposition
скрывать	cacher
подпись	Signature
мельник	meunier
обеспечение	disposition
одежда	vêtements
кадры	cadres
безусловно	certainement
газета	journal
игрушка	jouet
слой	couche
печатные	imprimé
медленный	lent
удаление	suppression
ответственность	responsabilité
принтеры	imprimantes
добавление	ajouter
место	place
проводить	dépenser
завод	usine
интерьер	intérieur
расти	croître
оптический	optique
продвижение	promotion
относительный	relatif
удивительно	incroyable
точка	point
идентичность	identité
преобразование	conversion
чувство	sentiment
скрытый	caché
разумный	raisonnable
пересмотр	révision
влияние	influence
соотношение	rapport
важность	importance
дождь	pluie
планета	planète
копии	copies
разрешать	permis
видя	voyant
доказательство	preuve
бас	basse
рецепт	ordonnance
пустой	vide
пример	exemple
дыра	trou
поездка	balade
бюро	bureau
сохранение	préservation
пара	paire
идеальный	idéal
функции	spécification
записанный	enregistré
дон	Don
куски	pièces
законченный	fini
парки	parcs
адвокаты	avocats
стресс	stress
крем	crème
сс	ss
работает	fonctionne
обнаружить	découvrir
ар	ap
узоры	modèles
холмы	collines
нм	nm
консультант	conseiller
знать	conscient
форма	forme
эволюция	évolution
сертификаты	certificats
цели	objectifs
станций	stations
предложенный	suggéré
оп	op
остатки	restes
фирмы	entreprises
евро	euro
оператор	opérateur
сооружения	structures
общий	générique
энциклопедия	encyclopédie
Применение	usage
чернила	encre
смешанный	mixte
перепись	recensement
колесо	roue
поставщики	Fournisseurs
компактный	compact
поэзия	poésie
огни	lumières
отслеживание	suivi
ангел	ange
подготовка	préparation
попытка	tentative
получение	recevoir
Матчи	allumettes
соответствие	conformité
ширина	largeur
двигатели	moteurs
забывать	oublier
массив	tableau
обсуждается	discuté
точный	précis
климат	climat
греческий	grec
инструкция	instruction
управление	gérant
сырье	brut
различия	différences
объяснять	Explique
установить	établir
выраженный	exprimé
степень	ampleur
острый	tranchant
Бен	ben
параграф	paragraphe
убийство	tuer
математика	mathématiques
компенсация	compensation
экспорт	exportation
менеджеры	gestionnaires
модули	modules
проведены	menée
версии	versions
знает	sait
описывать	décrire
граждане	citoyens
наследие	patrimoine
беда	difficulté
тренер	entraîneur
сельскохозяйственное	agricole
расширять	développer
аудитория	public
назначенный	attribué
коллекции	collections
возраст	âge
специалист	spécialiste
готовить	cuisinier
аффект	affecter
девственница	vierge
опытный	expérimenté
расследование	enquête
поднятый	relevé
шапка	chapeau
учреждение	institution
направленный	dirigée
пострадавших	affecté
велосипед	bicyclette
полностью	totalement
пластина	assiette
затраты	frais
указывать	indiquer
блондинка	blond
производство	procédure
любимый	préféré
характеристики	caractéristiques
дер	der
потерять	perdre
органический	biologique
искать	chercher
опыт	expériences
альбомы	albums
контракты	contrats
гости	invités
состоялся	hébergé
болезни	maladies
относительно	concernant
эквивалент	équivalent
химия	chimie
комплекты	kits
логика	logique
принц	prince
круг	cercle
почва	sol
психология	psychologie
влажный	humide
обстоятельства	conditions
инвестор	investisseur
элементарный	élémentaire
спонсоры	sponsors
лиса	Renard
неограниченный	illimité
отвечать	répondre
размеры	tailles
гладкий	plaine
Выход	Sortie
рука	bras
ключи	clés
волна	vague
святой	saint
акты	actes
руководство	orientation
след	Piste
символ	symbole
шоссе	Autoroute
наблюдаемый	observé
декан	doyen
настроить	installer
голосование	sondage
стили	modes
заполненный	rempli
связь	liaison
каналы	filières
приложение	annexe
шоколад	Chocolat
часть	portion
объем	portée
поставщик	fournisseur
кабели	câbles
хлопок	coton
требование	exigence
убитый	tué
граница	frontière
древний	ancien
обсуждение	débat
представители	représentants
начинается	départs
беременность	grossesse
достопримечательности	attractions
научился	appris
операции	transactions
исследователь	explorateur
исторический	historique
муж	mari
уполномоченный	autorisé
псих	fou
предстоящий	prochain
концерт	concert
множество	scores
эффективность	Efficacité
комедия	comédie
принят	adopté
эффективное	efficace
линейный	linéaire
обязательство	engagement
специальность	spécialité
медведи	ours
хмель	saut
перевозчик	transporteur
постоянная	constant
виза	visa
рот	bouche
метр	mètre
связанный	lié
интервью	interviews
концепции	concepts
пистолет	pistolet
отражать	réfléchir
чистый	pur
ад	enfer
фрукты	fruit
начинается	commence
квалифицированный	qualifié
реформа	réforme
объектив	lentille
обрабатывали	traités
открытие	Découverte
привлечь	dessiner
объявление	classifié
предполагать	assumer
союз	Alliance
подтвердить	confirmer
инженер	ingénieur
последовательный	cohérent
замещать	remplacer
зазор	dégagement
конвертер	convertisseur
организация	organisation
младенец	bébé
проверки	chèques
достиг	atteint
становление	devenir
задача	objectif
указанный	indiqué
сахар	sucre
экипаж	équipage
ноги	jambes
придерживаться	bâton
связь	relation
включен	activée
жанр	genre
доброволец	bénévole
задний	arrière
демократической	démocratique
усилить	améliorer
точный	exact
связанный	lié
параметр	paramètre
процессор	processeur
узел	nœud
формальный	formel
буря	orage
микро	micro
колледжи	collèges
мили	mile
проблемы	défis
редакторы	éditeurs
высший	suprême
братья	frères
признание	reconnaissance
ссылка	ref
оценить	estimation
дитя	enfant
осмотр	inspection
потребители	consommateurs
пределы	limites
территория	territoire
оружие	armes
задержка	retard
пилот	pilote
взносы	contributions
непрерывный	continu
инициатива	initiative
роман	roman
выполнение	exécution
инвалидность	invalidité
ультра	ultra
победитель	gagnant
эпизод	épisode
гончар	potier
блюдо	plat
игры	pièces
бюллетень	bulletin
Айова	ia
модифицировать	modifier
действительно	vraiment
вселенная	univers
кандидат	candidat
слот	fente
выдающийся	exceptionnel
ха	Ha
планируемый	prévu
домик	loge
зеркало	miroir
турнир	tournoi
рассмотрение	considération
сессий	sessions
ядро	noyau
покупатели	acheteurs
журналы	revues
серый	gris
каталог	catalogue
заряженный	accusé
широкий	vaste
унд	und
выбранный	choisi
демонстрация	demo
ненавидеть	haine
Терминал	Terminal
издатели	éditeurs
ночью	nuits
жидкость	liquide
рис	riz
бронирование	réservation
продукты	nourriture
охрана	garde
экономия	économie
империя	Empire
вновь	nouvellement
повышение	élever
нелегальный	illégal
расширение	expansion
премьер	premier
завтра	demain
молоко	Lait
драма	drame
посещение	visite
конкурс	concours
собранный	collectées
группы	bandes
подходящее	adapté
абсолютно	absolument
аудит	vérification
камера	chambre
Гвинея	Guinée
Выводы	résultats
ISO	iso
типичный	typique
сумма	somme
курица	poulet
временный	temporaire
посещать	assister
душ	douche
отправка	envoi
достаточно	suffisant
оболочка	coquille
провинция	Province
католик	catholique
губернатор	gouverneur
пиво	Bière
вклад	contribution
формула	formule
конституции	Constitution
упаковка	emballage
надежный	fiable
сомнение	doute
зарабатывать	gagner
периодов	périodes
нападки	attaques
товар	marchandise
симптомы	symptômes
мемориал	Mémorial
близнец	double
вставить	insérer
шлюз	passerelle
Рисование	dessin
кандидаты	candidats
приказал	commandé
биологический	biologique
борьба	combat
переход	transition
предпочтения	préférences
шпион	espion
романс	romance
инструмент	instrument
Трещина	Divisé
темы	thèmes
полномочия	pouvoirs
небо	paradis
биты	morceaux
беременная	Enceinte
классификация	classification
сосредоточены	concentré
врач	médecin
просить	demander
блоки	blocs
вот	lo
духовный	spirituel
диабет	Diabète
мл	ml
сдвиг	décalage
сидеть	asseoir
тела	corps
фотографии	photographies
резка	Coupe
писатели	écrivains
гибкий	flexible
любимый	aimé
избранное	favoris
отображение	cartographie
многочисленные	nombreux
относительно	relativement
представляет	représente
превосходящий	supérieur
предпочтительным	préféré
сохранены	enregistré
интеллектуальной	intellectuel
предоставляется	accordé
углерод	carbone
удобный	confortable
магнитные	magnétique
взаимодействие	interaction
прослушивание	écoute
кризис	crise
прогноз	perspective
массивный	massif
яркий	brillant
сформированный	formé
пианино	piano
эхо	écho
революция	révolution
дисплеи	affiche
плазма	plasma
прибыль	gains
тайна	mystère
пейзаж	paysage
механический	mécanique
поездка	périple
баннер	bannière
инжир	figue
графств	comtés
получение	acquisition
признанное	reconnu
мечты	rêves
уведомление	notification
кг	kg
учат	apprendre
быстрый	rapide
вытащить	tirer
Юта	Utah
семинар	séminaire
вложения	investissements
колеса	roues
указывать	spécifier
чувствительный	sensible
шаблоны	modèles
форматы	formats
держит	détient
маршрутизатор	routeur
бетон	béton
си	si
папка	dossier
завершение	achèvement
пульс	impulsion
техника	technique
голосование	vote
суды	tribunaux
переоборудованный	converti
метро	métro
Годовщина	anniversaire
улучшения	améliorations
полоса	bande
Спецификация	spécification
авария	accident
Ник	entaille
доступной	accessible
резидент	résident
сюжет	terrain
типично	typiquement
представление	représentation
насос	pompe
существует	existe
договоренности	arrangements
конференций	conférences
потребление	consommation
узкий	étroit
угроза	menace
опросы	enquêtes
сидящий	séance
консультант	consultant
контроллер	manette
комитеты	comités
пенис	pénis
замок	Château
сады	jardins
этикетки	Étiquettes
готовы	prêt
био	bio
действующий	agissant
руководители	têtes
экзамен	examen
резиденция	résidence
плотность	densité
сто	cent
странный	étrange
устойчивый	durable
статистический	statistique
упомянуть	mention
инновация	innovation
серый	gris
параллельно	parallèle
работать	fonctionner
банкноты	factures
стабильный	stable
определения	définitions
фон	von
врачи	médecins
урок	leçon
кино	cinéma
выборы	élections
реакция	réaction
пустой	blanc
повышенная	renforcée
озаглавленный	intitulé
серьезный	sévère
генерировать	produire
газеты	journaux
больницы	hôpitaux
VI	vi
юмор	humour
престарелый	vieilli
мониторы	moniteurs
исключение	exception
продолжительность	durée
насыпной	masse
посещения	visites
возможности	capacités
рекомендация	recommandation
грех	péché
организованная	organisé
ба	ba
пункт	para
принятие	adoption
улучшение	améliorer
дорогая	coûteux
буйвол	buffle
организации	organisations
самолет	avion
программы	programmes
механизм	mécanisme
й	ee
отмеченный	marqué
управляемый	poussé
бутылка	bouteille
инновационный	innovant
массаж	massage
вывод	conclusion
закрытие	fermeture
тысяча	mille
легенда	Légende
вилла	villa
кость	OS
столбцы	colonnes
расстройства	troubles
сотрудничество	collaboration
обнаружение	détection
внутренний	interne
образование	formation
мед	med
инженеры	ingénieurs
организация	entité
круизы	Croisières
Ворота	porte
Римский	romain
обязанности	fonctions
эротический	érotique
тон	Ton
этика	éthique
Дракон	dragon
занятый	occupé
капитан	capitaine
приносит	apporte
обогрев	chauffage
ножка	jambe
шея	cou
крыло	aile
скрипты	scripts
азбука	abc
назначенный	nommé
дело	transaction
совершить	commettre
рельс	rail
поездки	voyages
разрыв	écart
стороны	côtés
трубка	tube
соответствующий	correspondant
описания	descriptions
ремень	ceinture
куртка	veste
анимация	animation
оракул	oracle
эр	er
производства	productions
авиация	aviation
гордый	fier
катастрофа	catastrophe
консоль	console
команды	commandes
младший	jr
связь	télécommunications
инструктор	instructeur
гигант	géant
достигнутый	réalisé
травмы	blessures
подходы	approches
обычный	habituel
Марки	timbres
угол	angle
грабить	Rob
дизайнеры	concepteurs
свобода	liberté
эпоха	ère
конвертировать	convertir
возможность	possibilité
аналитик	analyste
опасно	dangereux
надежность	fiabilité
соответственно	respectivement
добровольцы	bénévoles
полученный	dérivé
удовольствие	plaisir
честь	honneur
ориентированного	orienté
орел	Aigle
молитва	prière
мастерские	ateliers
ураган	ouragan
тихо	silencieux
режиссер	producteur
представленный	représentée
обязанности	responsabilités
сыр	fromage
внимательно	soigneusement
производительность	productivité
корона	couronne
паритет	par
диагностика	diagnostic
производитель	fabricant
трещина	fissure
принцип	principe
кирки	choix
банда	gang
фетиш	fétiche
появление	apparence
дым	fumée
фильтры	filtres
включенный	incorporé
ремесло	artisanat
человек	compagnon
слепой	aveugle
гостиная	salon
Сумасшедший	furieux
алгоритм	algorithme
сильно	fortement
кафе	café
кругозор	ken
белки	protéines
су	su
знакомые	familier
способный	capable
вход	admission
башмак	chaussure
избран	élu
проведение	portant
терроризм	terrorisme
радость	joie
издания	éditions
этнической	ethnique
парламент	parlement
актер	acteur
находки	découvertes
печать	joint
ситуации	situations
пятый	cinquième
гражданин	citoyen
вертикальный	verticale
поправки	corrections
описывает	décrit
инвалидов	handicapées
вещество	substance
запрещено	interdit
труба	tuyau
солдаты	soldats
опекун	Gardien
лекция	conférence
моделирование	simulation
расположение	disposition
инициативы	initiatives
больной	mauvais
концентрация	concentration
прокладывать	allonger
интерпретация	interprétation
грязный	sale
учил	enseigné
работник	ouvrier
оптимизация	optimisation
храм	temple
вещества	substances
доказывать	prouver
обнаруженный	découvert
крылья	ailes
генетический	génétique
ограничения	restrictions
тонкий	mince
выставка	exposition
хребет	crête
модем	modem
приведение	apportant
больной	malade
оценивать	évaluer
тропический	tropical
собирать	collecte
вектор	vecteur
определенно	absolument
превращение	tournant
существование	existence
комментарий	commentaire
события	développements
иммиграция	immigration
направления	destinations
взаимное	mutuel
синтаксис	syntaxe
литий	li
атрибут	attribut
тюрьма	prison
умение	compétence
стулья	chaises
окружающих	alentours
горы	montagnes
популярность	popularité
запрос	enquête
проверено	vérifié
экспонат	exposition
бросать	jeter
тенденция	tendance
коты	chats
пустыня	désert
я	ya
координатор	coordinateur
Меркурий	Mercure
сжигание	brûlant
побег	échapper
получатель	destinataire
прогрессирующий	progressive
лодки	bateaux
чемпионат	championnat
аркада	arcade
невозможно	impossible
говорит	dit
очевидный	évident
депрессия	dépression
график	graphique
покрытие	couvrant
платина	platine
суждение	jugement
переговоры	pourparlers
подача	dépôt
способствовать	favoriser
награжден	décerné
испытания	essais
мастера	maîtrise
картридж	cartouche
объяснение	explication
организация	org
мошенничество	fraude
электричество	électricité
спектр	spectre
прибытие	arrivée
керамика	poterie
акцент	accentuation
здорово	impressionnant
подтвердил	confirmé
счетчики	compte
авария	crash
лифт	ascenseur
между	entre
высоты	hauteurs
тень	ombre
расходы	frais
предприятие	entreprise
клиника	clinique
исцеление	guérison
принцесса	Princesse
входящий	entrer
пакет	paquet
студии	studios
участие	participation
папа	papa
кнопки	boutons
размещение	placement
наблюдения	observations
победители	gagnants
дороги	routes
последующий	subséquent
двор	Cour
раскрытие	divulgation
создание	établissement
воспоминания	souvenirs
тэ	te
создает	crée
лица	visages
турист	touristique
убийство	meurtre
адекватный	adéquat
сенатор	sénateur
презентации	présentations
дайджест	digérer
пыли	poussière
вики	wiki
заменены	remplacé
радиолокационный	radar
потери	pertes
бой	combat
сокращение	réduire
остановился	arrêté
занятие	Occupation
тесно	étroitement
излучение	radiation
короли	rois
стрельба	tournage
ухо	oreille
флаги	drapeaux
пекарь	boulanger
консервативный	conservateur
шок	choc
эффективность	efficacité
галстук	attacher
крыша	toit
демонстрировать	démontrer
атмосфера	atmosphère
поцелуй	baiser
зверь	bête
ра	ra
управляемый	exploité
эксперимент	expérience
цели	cibles
покупки	achats
федерация	fédération
пицца	Pizza
приглашенный	invité
назначение	affectation
модификация	mod
запросы	requêtes
отсутствие	absence
поставщики	vendeurs
йога	yoga
служит	sert
сюрприз	surprise
лампа	lampe
шутки	blagues
консультирование	conseils
дворец	palais
доволен	satisfait
победы	victoires
склад	entrepôt
предполагаемый	supposé
обычный	ordinaire
призрак	fantôme
нарушение	violation
босс	patron
гордость	fierté
ожидания	attentes
независимость	indépendance
знание	connaissance
репортер	journaliste
метаболизм	métabolisme
чемпион	champion
лично	personnellement
много	beaucoup
соло	solo
горло	gorge
богатство	richesse
вакуум	vide
танцы	dansant
признать	reconnaître
пишет	écrit
площадь	place
поиск	quête
публиковать	publier
скрининг	dépistage
транс	trans
пионер	pionnier
забытый	oublié
акробат	acrobate
тарелки	plaques
эссе	essais
поведение	comportement
говоря	récit
довольно	équitablement
умный	intelligent
режимы	modes
обязательство	obligation
гавань	port
путешественник	voyageur
сегмент	segment
враг	ennemi
головоломка	puzzle
углубления	puits
ограниченный	limité
республиканец	républicain
секреты	secrets
синдром	syndrome
посещаемость	présence
штраф	peine
барабан	tambour
позволяет	permet
строитель	constructeur
перспектива	vue
наводнение	inonder
легкость	facilité
аргументы	arguments
арена	arène
приключения	aventures
зрачки	élèves
объявление	annonce
исход	résultat
ценить	apprécier
расширенный	étendu
взрослый	mûr
прекрасный	charmant
центры	centres
пункт	clause
улыбка	sourire
земли	terres
войска	troupes
вооруженный	armé
сосна	pin
охлаждение	refroidissement
залив	golfe
грузовики	camions
механизмы	mécanismes
развод	divorce
традиция	tradition
таблетки	pilules
тигр	tigre
люди	gens
датчик	capteur
подвергаются	exposé
охота	chasse
ангелы	anges
заместитель	adjoint
тайский	thaïlandais
выбросы	émissions
врачи	médecins
жалоба	plainte
сцены	scènes
эксперименты	expériences
увеличение	renforcer
управление	gouvernance
мельница	moulin
основанный	fondé
хронический	chronique
логово	tanière
Палец	doigt
держит	garde
фунт	livre
разместить	Localiser
пл	PL
обученный	qualifié
реализации	exécution
хлеб	pain
моторы	moteurs
жесткий	dure
инцидент	incident
динамика	dynamique
ложь	mensonge
разговор	conversation
снижение	diminution
поклонение	culte
возможность	aptitude
Аляска	Alaska
точность	précision
убытки	dégâts
резервы	réserves
решать	résoudre
меньшинство	minorité
разнообразный	diverse
ингредиенты	Ingrédients
ах	ah
тоны	tons
реабилитация	réhabilitation
взгляд	vue
глина	argile
слабый	faible
разделенный	divisé
прием	accueil
мудрый	sage
шансы	chances
семинары	séminaires
последствия	conséquences
производители	décideurs
география	géographie
целостность	intégrité
наследие	héritage
довольный	heureux
Опасность	danger
витамин	vitamine
обработанный	traité
фраза	phrase
привлечение	élevage
последствия	implications
функциональность	fonctionnalité
рай	paradis
гибридный	hybride
читает	lit
эмоциональный	émotif
слава	gloire
JA	ja
географический	géographique
превышать	dépasser
стержень	barre
шелк	soie
дети	bébés
би	bi
романтик	romantique
показал	révélé
специалисты	spécialistes
генератор	Générateur
подвеска	suspension
грустный	triste
коррекция	correction
волк	Loup
медленно	lentement
дополнение	supplément
участки	portions
младенец	bébé
секторов	secteurs
жидкость	fluide
основания	terrains
еда	repas
та	ta
машины	machinerie
уравнение	équation
корзины	paniers
вероятность	probabilité
измерение	dimension
изучал	étudié
доходы	bénéfices
дьявол	diable
трава	herbe
иллюстрированный	illustré
вишня	Cerise
континентальный	continental
достижение	réussite
ограничения	limites
похороны	funérailles
главы	chapitres
пассажир	passager
удобный	pratique
Марс	Mars
размера	taille
яйцо	Oeuf
сигналы	signaux
ориентация	orientation
кража	vol
детство	enfance
символы	symboles
Lat	lat
мета	méta
аналоговый	analogique
талант	Talent
датированный	daté
мудрость	sagesse
граница	frontière
элита	élite
солдат	gi
считает	croit
стихи	poèmes
юрисдикция	juridiction
робот	robot
отображение	visualisation
свидетель	témoin
оборудованный	équipé
этапы	étapes
сюр	sur
приобретенный	acquis
оценить	évaluer
мыть	lavage
вход	entrée
декларация	déclaration
проигрыш	perdant
попытки	tentatives
благородный	noble
автоматизация	automatisation
воздействие	impacts
оборот	tour
преимущества	avantages
рыцарь	Chevalier
цели	objectifs
расширения	extensions
апелляции	appels
болезнь	maladie
эй	ho
альтернативы	alternatives
ш	sh
мыло	savon
варенье	confiture
необычный	inhabituel
ответил	répondu
разрушение	destruction
миграция	migration
расстройство	désordre
обычный	conventionnel
носить	portant
ось	axe
искать	recherché
гены	gènes
медиана	médian
сканер	scanner
здесь	ici
мультипликационный	Animé
регулировка	ajustement
герой	héros
лечение	traitements
отношение	attitude
ковер	tapis
линзы	lentilles
участие	assisté
трудность	difficulté
панк	punk
коалиция	coalition
регистрация	inscription
герцог	Duc
темп	rythme
производители	producteurs
дуга	arc
интерфейсы	interfaces
атлас	atlas
наблюдение	observation
пытки	torture
удаленный	supprimé
Пальто	manteau
восстановление	restauration
удобство	commodité
возврате	retour
оппозиция	opposition
контейнер	récipient
ответчик	défendeur
руководитель	superviseur
корпус	corps
актеры	acteurs
печень	foie
подлежащий	assujetti
петиция	pétition
антенна	antenne
выбрал	choisi
вера	croyance
убийство	meurtre
плечо	épaule
оформление	décor
ион	ion
диаметр	diamètre
подкаст	Podcast
взаимодействия	interactions
певец	chanteur
вестник	héraut
старение	vieillissement
вмешательство	intervention
плагин	brancher
Привлечение	attraction
дайвинг	plongée
модификация	modification
предполагать	supposer
тростник	roseau
включать	impliquer
умеренный	modérer
мышей	souris
понимать	compris
быстро	rapidement
запрет	interdire
гарантия	assurance
происходит	événement
огромный	vaste
мельницы	moulins
контур	contour
получает	reçoit
джинсы	jeans
сборник	compilation
странный	impair
сигма	Sigma
гр	gr
привлекательный	attrayant
повод	occasion
записи	enregistrements
жертва	victime
требования	demandes
осторожный	prudent
луч	faisceau
садоводство	jardinage
обязательства	obligations
прибыть	arrivée
оркестр	orchestre
лицензия	Licence
регулируемый	Ajustable
распределение	allocation
сочинение	essai
продемонстрировал	démontré
диалог	dialogue
лагеря	camps
объявленный	déclaré
след	trace
закрыть	fermer
пакеты	paquets
