di	de
a	à
in	dans
per	pour
è	est
sopra	sur
quella	cette
di	par
Questo	ce
con	avec
io	je
tu	toi
esso	il
o	ou
essere	être
siamo	sont
a	à
tutti	tout
avere	avoir
nuovo	Nouveau
noi	nous
volere	volonté
casa	maison
noi	nous
di	sur
Se	si
pagina	page
mio	mon
ha	a
ricerca	chercher
gratuito	gratuit
ma	mais
nostro	notre
uno	un
altro	autre
fare	faire
informazione	information
tempo	temps
lui	il
quale	lequel
loro	leur
notizia	nouvelles
uso	utilisation
Là	Là
vedere	voir
così	alors
chi	qui
web	toile
anche	aussi
ottenere	obtenir
pm	pm
vista	vue
c	c
e	e
primo	premier
stato	été
voluto	aurait
erano	étaient
S	s
piace	comme
X	X
di	que
trova	trouver
prezzo	prix
indietro	arrière
superiore	Haut
persone	gens
aveva	avait
elenco	liste
nome	prénom
appena	juste
anno	an
giorno	journée
in	dans
Due	deux
Salute	santé
n	n
ri	ré
Usato	utilisé
partire	aller
B	b
ultimo	dernier
rendere	faire
loro	leur
dovrebbero	devrait
Prodotto	produit
sistema	système
inviare	poster
sua	sa
città	ville
t	t
politica	politique
numero	nombre
supporto	soutien
Messaggio	message
dopo	après
poi	puis
gennaio	jan
bene	bien
d	ré
dove	où
Informazioni	Info
diritti	droits
libri	livres
alto	haute
scuola	école
m	m
ogni	chaque
link	liens
lei	elle
anni	années
ordine	commande
molto	très
libro	livre
elementi	articles
azienda	compagnie
r	r
leggere	lis
gruppo	groupe
sesso	sexe
molti	beaucoup
utente	utilisateur
de	de
impostato	ensemble
generale	général
ricerca	recherche
Università	Université
gennaio	janvier
posta	courrier
pieno	plein
recensioni	avis
programma	programme
conoscere	connaître
Giochi	Jeux
modo	façon
giorni	journées
p	p
parte	partie
poteva	pourrait
grande	génial
unito	uni
vero	réal
f	F
internazionale	international
centro	centre
viaggio	Voyage
Commenti	commentaires
fatto	fabriqué
sviluppo	développement
rapporto	rapport
membro	membre
dettagli	détails
linea	ligne
condizioni	termes
prima	avant
alberghi	hôtels
fatto	fait
inviare	envoyer
destra	droite
genere	type
Locale	local
quelli	ceux
risultati	résultats
ufficio	Bureau
nazionale	nationale
auto	voiture
design	conception
prendere	prendre
postato	posté
indirizzo	adresse
Comunità	communauté
entro	dans
stati	États
volere	vouloir
Telefono	téléphone
DVD	DVD
soggetto	assujettir
fra	entre
Forum	forum
famiglia	famille
l	l
lungo	longue
w	w
mostrare	montrer
o	o
anche	même
nero	noir
speciale	spécial
indice	indice
essere	étant
donne	femmes
tanto	beaucoup
cartello	signe
file	fichier
collegamento	lien
Aperto	ouvrir
Sud	Sud
Astuccio	Cas
progetto	projet
pagine	pages
versione	version
sezione	section
proprio	posséder
Casa	maison
sicurezza	Sécurité
g	g
contea	comté
americano	américain
foto	photo
gioco	Jeu
membri	membres
energia	Puissance
Rete	réseau
computer	ordinateur
sistemi	systèmes
tre	Trois
posto	endroit
fine	fin
h	h
lui	lui
per	par
accesso	accès
pensare	pense
nord	Nord
risorse	Ressources
attuale	actuel
grande	gros
media	médias
legge	loi
controllo	contrôle
acqua	eau
storia	histoire
dimensione	Taille
personale	personnel
guida	guider
negozio	boutique
elenco	annuaire
modificare	changement
bianca	blanc
testo	texte
piccolo	petit
valutazione	évaluation
Vota	taux
governo	gouvernement
bambini	enfants
ritorno	revenir
studenti	élèves
v	v
account	Compte
volte	fois
livello	niveau
digitale	numérique
profilo	profil
precedente	précédent
modulo	forme
eventi	événements
amore	amour
vecchio	vieux
John	John
principale	principale
chiamata	appel
Immagine	image
Dipartimento	département
titolo	Titre
non	non
K	k
y	y
assicurazione	Assurance
deve	doit
proprietà	propriété
classe	classe
CD	CD
qualità	qualité
ogni	chaque
listato	inscription
soddisfare	contenu
nazione	pays
piccolo	peu
utensili	outils
Basso	faible
rispondere	répondre
cliente	client
dicembre	décembre
confrontare	comparer
film	films
Università	Université
valore	valeur
articolo	article
uomo	homme
lavori	emplois
j	j
cibo	aliments
autore	auteur
diverso	différent
u	u
imparare	apprendre
saldi	vente
stampare	impression
corso	cours
lavoro	emploi
camera	chambre
azione	Stock
formazione	entraînement
pure	aussi
credito	crédit
punto	point
scienza	science
uomini	Hommes
categorie	catégories
ovest	Ouest
Guarda	Regardez
Inglese	Anglais
squadra	équipe
tenuta	biens
scatola	boîte
condizioni	conditions
fotografie	Photos
gay	gai
filo	fil
categoria	Catégorie
Nota	Remarque
vivere	vivre
grande	grand
galleria	Galerie
tavolo	table
però	toutefois
giugno	juin
ottobre	octobre
novembre	novembre
mercato	marché
biblioteca	bibliothèque
azione	action
inizio	début
serie	séries
Caratteristiche	fonctionnalités
aria	air
industria	industrie
Piano	plan
umano	Humain
sì	Oui
secondo	seconde
caldo	chaud
costo	Coût
film	film
forum	forums
marzo	Mars
la	la
settembre	septembre
dire	dire
andando	Aller
medico	médical
amico	ami
dicembre	déc
server	serveur
applicazione	application
personale	Personnel
giocare	jouer
problemi	problèmes
aprile	avril
utenti	utilisateurs
strada	rue
argomento	sujet
contro	contre
avuto	eu
blog	Blog
festa	fête
pagamento	Paiement
attrezzatura	équipement
permettere	laisser
programmi	programmes
legale	légal
recente	récent
parco	parc
atto	acte
problema	problème
rosso	rouge
dare	donner
memoria	Mémoire
prestazione	performance
sociale	social
q	q
storia	récit
vendere	vendre
opzioni	Options
Esperienza	expérience
chiave	clé
corpo	corps
giovane	Jeune
importante	important
campo	champ
pochi	peu
est	est
singolo	unique
ii	ii
età	âge
club	club
esempio	Exemple
ragazze	filles
z	z
strada	route
regalo	cadeau
domanda	question
circa	Californie
difficile	difficile
pagare	Payer
quattro	quatre
poker	poker
problema	problème
gamma	gamme
costruzione	bâtiment
venditore	vendeur
Tribunale	tribunal
febbraio	février
risultato	résultat
leggero	lumière
Scrivi	écrire
guerra	guerre
offrire	offre
blu	bleu
gruppi	groupes
al	Al
facile	facile
dato	donné
richiesta	demande
fax	fax
Cina	Chine
fabbricazione	fabrication
immagine	image
esigenze	Besoins
possibile	possible
mese	mois
maggiore	Majeur
stella	étoile
futuro	avenir
spazio	espace
Comitato	Comité
mano	main
sole	Soleil
carte	cartes
Londra	Londres
incontro	réunion
diventare	devenir
bambino	enfant
conservare	garder
porno	porno
Condividere	partager
simile	similaire
giardino	jardin
scuole	écoles
milione	million
aggiunto	ajoutée
riferimento	référence
aziende	entreprises
bambino	bébé
apprendimento	apprentissage
energia	énergie
correre	courir
consegna	livraison
popolare	populaire
termine	terme
film	film
storie	histoires
mettere	mettre
rivista	journal
rapporti	rapports
co	co
provare	essayer
immagini	images
Avviso	remarquer
Dio	Dieu
originale	original
capo	tête
Radio	radio
cellula	cellule
consiglio	conseil
include	comprend
traccia	Piste
discussione	discussion
archivio	archiver
altri	autres
accordo	accord
formato	format
società	société
mesi	mois
sicurezza	sécurité
amici	copains
sicuro	sûr
edizione	édition
messaggi	messages
marketing	commercialisation
raccontare	dire
associazione	association
fornisce	fournit
divertimento	amusement
già	déjà
verde	vert
studi	études
vicino	Fermer
Comune	commun
specifica	spécifique
parecchi	nombreuses
vita	vivant
collezione	collection
chiamato	appelé
corto	court
arti	lettres
lotto	lot
Chiedere	demander
limitato	limité
soluzioni	solutions
direttore	réalisateur
spiaggia	plage
passato	passé
naturale	Naturel
elettronica	électronique
su	sur
periodo	période
pianificazione	Planification
dice	dit
ufficiale	officiel
mar	mar
fatto	terminé
tecnico	technique
finestra	fenêtre
professionista	pro
regione	Région
isola	île
disco	record
diretto	direct
conferenza	conférence
record	archives
st	st
quartiere	district
calendario	calendrier
costi	frais
stile	style
dichiarazione	déclaration
miglia	miles
risorsa	Ressource
applicazioni	applications
documento	document
parola	mot
lavori	travaux
Materiale	Matériel
conto	facture
scritto	écrit
regole	règles
finale	final
cosa	chose
centro	centre
requisiti	exigences
VERO	VRAI
minuti	minutes
altro	autre
marchio	marque
roccia	Roche
cattivo	mal
individuale	individuel
più	plus
auto	auto
copertina	couverture
modificare	modifier
insieme	ensemble
video	vidéos
veloce	vite
funzione	fonction
fatto	fait
ottenere	obtention
globale	global
Tech	technologie
incontrare	rencontrer
lontano	loin
economico	économique
it	en
giocatore	joueur
progetti	projets
quantità	montant
orologio	regarder
incluso	inclus
sentire	ressentir
banca	banque
rischio	risque
offerte	offres
vario	divers
parole	mots
produzione	production
commerciale	commercial
peso	poids
cuore	cœur
trattamento	traitement
punti	points
conoscenza	connaissance
rivista	magazine
errore	Erreur
telecamera	caméra
ragazza	fille
costruzione	construction
giocattoli	jouets
registrato	inscrit
dominio	domaine
metodi	méthodes
capitolo	chapitre
protezione	protection
politiche	politiques
largo	large
bellezza	beauté
manager	directeur
India	Inde
posizione	position
prese	pris
ordinare	Trier
annunci	annonces
conosciuto	connu
metà	moitié
casi	cas
passo	étape
ingegneria	ingénierie
semplice	simple
Presto	rapide
licenza	Licence
lago	Lac
totale	entier
annuale	annuel
pubblicato	publié
Chiesa	église
metodo	méthode
attivo	actif
risposta	réponse
figura	figure
materiale	matériaux
abbastanza	assez
progettato	conçu
tra	parmi
Morte	décès
perdita	perte
viso	visage
marca	marque
sconto	remise
effetti	effets
creato	créé
norme	normes
po	bit
politico	politique
regno	Royaume
base	base
fare	Faire
prestiti	prêts
scarpe	chaussures
iscrizione	entrée
restare	rester
ordini	ordres
disponibilità	disponibilité
sommario	résumé
turno	tour
crescita	croissance
agenzia	agence
re	Roi
europeo	européen
attività	activité
copia	copie
occidentale	occidental
vigore	Obliger
occupazione	emploi
baia	baie
fiume	rivière
commissione	commission
pacchetto	paquet
visto	vu
Giocatori	joueurs
motore	moteur
porta	Port
album	album
regionale	régional
Stop	Arrêtez
iniziato	commencé
amministrazione	administration
bar	bar
istituto	institut
visualizzazioni	vues
Doppio	double
cane	chien
presto	bientôt
Linee	lignes
elettronico	électronique
benefici	avantages
necessaria	nécessaire
stampante	imprimante
condizione	condition
efficace	efficace
credere	croyez
organizzazione	organisation
effetto	effet
mente	esprit
selezione	sélection
casinò	casino
PDF	pdf
giro	tour
attraversare	traverser
speranza	espérer
società	société
desiderio	souhait
soluzione	Solution
maturo	mature
ruolo	rôle
settimane	semaines
certo	certain
inferiore	inférieur
necessario	nécessaire
unione	syndicat
mon	lun
com	com
particolare	particulier
bene	bien
ora	heure
gas	gaz
abilità	compétences
sei	six
cespuglio	buisson
isole	îles
consigli	Conseil
carriera	carrière
decisione	décision
partire	laisser
pre	pré
enorme	énorme
donna	femme
strutture	installations
offerta	offre
mezzo	milieu
cavo	câble
opportunità	Opportunités
presa	prise
valori	valeurs
divisione	division
venuta	arrivant
oggetto	objet
lesbica	lesbienne
adeguata	approprié
macchina	machine
logo	logo
lunghezza	longueur
simpatico	agréable
Punto	But
statistica	statistiques
cliente	client
campione	échantillon
investimento	investissement
inviato	envoyé
mostrato	montré
Natale	Noël
cultura	Culture
veloce	flash
Signorina	Mme
scelta	choix
corsi	cours
consumatore	consommateur
Ciao	salut
straniero	étranger
artista	artiste
mobilia	meubles
canale	canal
lettera	lettre
modalità	mode
telefoni	Téléphones
idee	idées
struttura	structure
grado	degré
contrarre	Contrat
super	super
maschio	mâle
importa	matière
quasi	presque
collocato	situé
multiplo	plusieurs
distribuzione	Distribution
editore	éditeur
Locanda	auberge
industriale	industriel
potenziale	potentiel
canzone	chanson
los	los
autunno	tomber
idea	idée
camere	pièces
comunicazioni	communications
vincere	gagner
primario	primaire
cancro	cancer
numeri	Nombres
ragionare	raison
strumento	outil
primavera	printemps
fondazione	fondation
risposta	répondre
voce	voix
programma	programme
documenti	documents
scopo	objectif
caratteristica	fonctionnalité
letto	lit
viene	vient
polizia	police
indipendente	indépendant
approccio	approche
Marrone	marron
fisico	physique
collina	colline
mappe	Plans
tenere	tenir
giudizi	évaluations
contento	content
fabbro	forgeron
sviluppato	développé
grazie	remercier
sicuro	sûr
unico	unique
sondaggio	enquête
precedente	avant
telefono	Téléphone
sport	sport
pronto	prêt
animale	animal
fonti	sources
popolazione	population
papà	Pennsylvanie
regolare	ordinaire
sicuro	garantir
operazioni	opérations
semplicemente	simplement
prova	preuve
stazione	gare
capire	comprendre
opzione	option
valle	vallée
probabilmente	Probablement
mare	mer
pubblicazioni	publications
Migliorare	améliorer
connessione	connexion
editore	éditeur
sala	salle
anti	anti
reti	réseaux
terra	Terre
genitori	Parents
urto	impact
trasferimento	transfert
introduzione	introduction
cucina	cuisine
forte	fort
nozze	mariage
proprietà	Propriétés
ospedale	hôpital
terra	sol
nave	navire
alloggio	hébergement
malattia	maladie
eccellente	excellent
perfezionare	parfait
capelli	cheveux
opportunità	opportunité
kit	trousse
classico	classique
base	base
comando	commander
città	villes
esprimere	Express
premio	prix
distanza	distance
albero	arbre
valutazione	évaluation
parete	mur
coinvolti	impliqué
EL	el
extra	supplémentaire
particolarmente	notamment
bilancio	budget
guide	guides
successo	Succès
massimo	maximum
mamma	mère
operazione	opération
esistente	existant
abbastanza	assez
selezionato	choisi
ragazzo	garçon
ristoranti	Restaurants
bellissimo	beau
avvertimento	Attention
posizioni	Emplacements
cavallo	cheval
votazione	vote
fiori	fleurs
stelle	étoiles
liste	listes
proprietario	propriétaire
animali	animaux
modi	façons
figlio	fils
fornitura	fournir
regola	règle
alloggiamento	logement
prende	prend
portare	apporter
Catalogare	catalogue
max	max
madre	mère
autorità	autorité
detto	Raconté
programma	programme
Iscritto	relié
ingresso	contribution
strategia	stratégie
piedi	pieds
agente	agent
valido	valide
moderno	moderne
anziano	Sénior
sexy	sexy
insegnamento	enseignement
porta	porte
grande	grandiose
prova	procès
unità	unités
freddo	cool
normale	Ordinaire
impresa	entreprise
navi	navires
intero	tout
positivo	positif
fitness	aptitude
Cinese	chinois
opinione	opinion
calcio	Football
astratto	abstrait
produzione	sortie
fondi	fonds
Sig	M
probabile	probable
sviluppare	développer
artisti	artistes
alternativa	alternative
responsabilità	responsabilité
Giava	Java
ospite	client
pubblicazione	publication
passaggio	passer
relazioni	rapports
fiducia	confiance
furgone	van
contiene	contient
Multi	multi
repubblica	république
tasse	honoraires
componenti	Composants
vacanza	vacances
secolo	siècle
accademico	académique
assistenza	assistance
completato	terminé
pelle	peau
grafica	graphique
indiano	Indien
squillare	bague
grado	qualité
montagna	Montagne
organizzazioni	organisations
filtro	filtre
pannello	panneau
pavimento	sol
acquisto	achat
incontro	rencontre
proposto	proposé
richiedere	exiger
ragazzi	garçons
mattina	Matin
consente	permet
proteina	protéine
pianta	plante
segnalati	signalé
colpire	frappé
mm	mm
piscina	bassin
mini	mini
politica	politique
compagno	partenaire
autori	auteurs
tavole	planches
pesce	poisson
membri	adhésion
missione	mission
occhio	œil
stringa	chaîne
senso	sens
modificata	modifié
rilasciato	libéré
palcoscenico	étape
interno	interne
Nato	née
dettagliato	détaillé
giapponese	Japonais
gara	course
approvato	approuvé
bersaglio	cible
tranne	sauf
carattere	personnage
Manutenzione	entretien
capacità	aptitude
Ed	ed
stupro	râpé
batteria	batterie
gioventù	jeunesse
pressione	pression
presentata	soumis
debito	dette
medio	moyen
televisione	télévision
interessato	intéressé
nucleo	coeur
rompere	Pause
scopi	fins
imposta	ensembles
danza	Danse
legna	bois
definito	défini
documenti	papiers
premi	prix
tassa	frais
studio	studio
lettore	lecteur
dispositivo	dispositif
stabilito	établi
risposte	réponses
affitto	location
las	Las
buio	foncé
esterno	externe
Mela	Pomme
Le	le
Istruzioni	instructions
min	min
offerta	offert
teoria	théorie
rimuovere	retirer
aiuto	aide
visivo	visuel
ospite	hôte
varietà	variété
insegnanti	enseignants
Manuale	Manuel
bloccare	bloc
soggetti	sujets
agenti	agents
riparazione	réparation
giusto	juste
acciaio	acier
comprensione	compréhension
canzoni	Chansons
fisso	fixé
sbagliato	faux
inizio	début
mani	mains
az	az
Parigi	Paris
prende	obtient
settore	secteur
capacità	capacité
un	ONU
Grasso	graisse
padre	père
elettrico	électrique
sega	vu
strumenti	instruments
ufficiale	officier
autista	chauffeur
aziende	entreprises
morto	mort
sconosciuto	inconnu
ristorante	restaurant
Mike	Mike
viaggio	voyage
mi	mi
povero	pauvre
relazione	relation
lavoratori	ouvriers
pace	paix
tradizionale	traditionnel
mostrando	projection
creativo	Créatif
costa	côte
vantaggio	avantage
finanziamento	financement
dispositivi	dispositifs
signore	Seigneur
concedere	subvention
sub	sous
finzione	fiction
orologi	montres
carriere	carrières
va	va
guidato	LED
Museo	musée
fan	ventilateur
trasporto	transport
interessante	intéressant
blog	blogs
valutazione	évaluation
ex	ancien
zona	zone
complesso	complexe
esimo	e
gatto	chat
morire	mourir
presentata	présenté
piatto	appartement
flusso	couler
agenzie	agences
letteratura	Littérature
genitore	parent
ambientazione	réglage
dr	dr
scala	échelle
economia	économie
utile	utile
mensile	mensuel
critico	critique
telaio	Cadre
musicale	musical
definizione	définition
segretario	secrétaire
sentiero	chemin
capo	chef
dà	donne
Pacchetti	paquets
dettaglio	détail
legislazione	lois
cambiato	modifié
inizio	commencer
reale	Royal
pulito	nettoyer
tipo	gars
titoli	titres
pertinente	pertinent
giustizia	Justice
Collegare	relier
tazza	Coupe
cestino	panier
applicato	appliqué
settimanalmente	hebdomadaire
vol	vol
installazione	installation
pp	pp
Attenzione	attention
avanzare	avance
Salta	sauter
dieta	régime
esercito	armée
Ingranaggio	équipement
differenza	différence
permesso	permis
corretta	correct
nazione	nation
vendita	vente
molte	beaucoup
pezzo	pièce
foglio	drap
azienda	raffermir
Sette	Sept
elementi	éléments
specie	espèce
saltare	saut
cellule	cellules
modulo	module
ricorrere	recours
certificato	certificat
ministro	ministre
movimento	mouvement
moda	mode
indicazioni	directions
visitatori	visiteurs
documentazione	Documentation
commercio	commerce
foresta	forêt
chiamate	appels
copertura	couverture
coppia	couple
dando	donnant
opportunità	chance
visione	vision
palla	ballon
fine	fin
clienti	clients
Azioni	actes
discutere	discuter
obbiettivo	objectif
riuscito	réussi
venduto	vendu
vento	vent
comunità	communautés
clinico	clinique
situazione	situation
mercati	marchés
editoriale	édition
apparire	apparaître
sviluppando	développement
vite	vies
determinare	déterminer
temperatura	Température
annunci	annonces
paziente	patient
effettivo	réel
storico	historique
pietra	pierre
peso	bob
commercio	Commerce
persone	personnes
difficile	difficile
scientifico	scientifique
satellitare	Satellite
test	essais
villaggio	village
conti	comptes
dilettante	amateur
ex	ex
incontrato	rencontré
dolore	douleur
fattori	facteurs
caffè	café
acquirente	acheteur
manifesto	affiche
bordo	bord
funzionale	fonctionnel
radice	racine
fi	Fi
chiuso	fermé
vacanze	vacances
rosa	rose
equilibrio	équilibre
monitoraggio	surveillance
risposte	réponses
tiro	coup
iniziale	initiale
etichetta	étiquette
secondo	seconde
canone	canon
lega	ligue
rifiuto	déchets
minuto	minute
autobus	autobus
fornitore	fournisseur
dizionario	dictionnaire
contabilità	comptabilité
produzione	fabrication
sezioni	sections
sedia	chaise
sforzo	effort
fase	phase
fantasia	fantaisie
Po	po
va	Virginie
Professore	professeur
installare	installer
camicia	chemise
abbigliamento	vêtements
piede	pied
Seno	Sein
tecniche	techniques
dollari	dollars
religione	religion
autorizzazione	autorisation
selvaggio	sauvage
generazione	génération
Perdere	manquer
chimico	chimique
medico	docteur
compito	tâche
ridurre	réduire
portato	apporté
esercizio	exercice
insetto	punaise
garanzia	garantie
capo	chef
SE	se
processi	processus
morbido	doux
incontri	réunions
secondi	secondes
volo	vol
congresso	congrès
carburante	carburant
camminare	marche
prodotta	produit
santo	Saint
discussione	argument
concorrenza	compétition
farmaci	drogues
comune	mixte
premio	prime
fresco	Frais
personaggi	personnages
procuratore	avocat
di	di
fattore	facteur
migliaia	milliers
km	km
ruscello	courant
appartamenti	appartements
raccogliere	choisir
udito	audition
orientale	est
terapia	thérapie
inserimenti	entrées
firmato	signé
amministrativo	administratif
grave	sérieux
limite	limite
passaggi	pas
negozi	magasins
servitù	esclavage
del	del
sforzi	efforts
informato	informé
ga	Géorgie
pensieri	pensées
torrente	ruisseau
ft	ft
quantità	quantité
essenziale	essentiel
tour	Tours
caricare	charge
subito	immédiatement
macchine	Machines
designato	désigné
pesante	lourd
coperto	couvert
recupero	récupération
integrato	intégré
configurazione	configuration
cazzo	coq
mercante	marchande
globale	complet
esperto	expert
proteggere	protéger
solido	solide
presentazione	présentation
divenne	devenu
arancia	Orange
conformità	conformité
tema	thème
ricco	riches
campagna	campagne
vs	contre
chitarra	guitare
scoperta	découverte
esempi	exemples
spirito	esprit
ar	ar
reclami	réclamations
accettazione	acceptation
strategie	stratégies
momento	mo
affari	affaires
destinato	prévu
sa	sa
obiettivi	buts
assumere	louer
elezione	élection
suggerire	suggérer
ramo	branche
servire	servir
affiliati	affiliés
montare	monter
latino	Latin
multimedia	multimédia
gestire	gérer
angolo	coin
rango	rang
elemento	élément
nascita	naissance
virus	virus
interattivo	interactif
richieste	demandes
separato	séparé
trimestre	trimestre
procedura	procédure
comando	direction
definire	définir
religioso	religieux
fatti	faits
colazione	déjeuner
colonna	colonne
fede	Foi
catena	chaîne
identificare	identifier
viale	rue
mancante	disparu
raccomandazioni	recommandations
mosso	déplacé
raggiungere	atteindre
confronto	Comparaison
momento	moment
esteso	élargi
sequenza	séquence
pollice	pouce
attacco	attaque
centri	centres
apertura	ouverture
laboratorio	laboratoire
Riserva	réserve
gamma	gamma
produrre	produire
verità	vérité
contatore	compteur
fallimento	échec
segue	suit
dollaro	dollar
campo	camp
des	des
cinema	films
ponte	pont
riempire	remplir
movimento	mouvement
stampa	impression
bozza	Brouillon
grafico	graphique
giocato	joué
contatti	Contacts
lettori	lecteurs
club	clubs
wa	Washington
avventura	aventure
offerta	offre
profitto	profit
capi	dirigeants
manifesti	affiches
istituzioni	institutions
assistente	assistant
variabile	variable
dj	dj
parcheggio	parking
ieri	hier
determinato	déterminé
laboratorio	atelier
andato	disparu
codici	codes
tipi	types
estensione	extension
dichiarazioni	déclarations
completamente	complètement
squadre	équipes
forte	fort
centimetro	cm
senato	sénat
divertente	drôle
gene	gène
trasformato	tourné
disco	disque
modello	modèle
barca	bateau
Teatro	théâtre
produttori	fabricants
sponsor	parrainer
classico	classique
icona	icône
garanzia	garantie
dedito	dévoué
direzione	direction
pallacanestro	basketball
oggetti	objets
Elimina	effacer
sera	soir
montaggio	Assemblée
nucleare	nucléaire
topo	Souris
segnale	signal
penale	criminel
rilasciato	Publié
potente	puissant
sognare	rêver
FALSE	FAUX
da	da
lanciare	jeter
fiore	fleur
personale	personnel
passato	passé
fornito	fourni
cascate	chutes
anima	âme
promuovere	promouvoir
dichiarato	déclaré
statistiche	Statistiques
professionisti	professionnels
appare	apparaît
trasportare	porter
bandiera	drapeau
coperture	couvertures
em	em
vantaggio	avantage
Ciao	Bonjour
disegni	dessins
mantenere	maintenir
turismo	tourisme
priorità	priorité
adulti	adultes
grafico	graphique
atomo	atome
pagamenti	Paiements
rilegatura	contraignant
breve	bref
conclusa	terminé
vincente	gagnant
anonimo	anonyme
copione	scénario
servito	servi
vuole	veut
preparato	préparé
vuoto	vide
etichetta	marque
colloquio	entretien
mescolare	mélanger
struttura	cadre
disco	disque
installato	installée
Regina	reine
crediti	crédits
chiaramente	clairement
fissare	réparer
maniglia	manipuler
dolce	doux
criteri	Critères
socio	associer
NE	ne
comportamento	comportement
Ingrandire	agrandir
raggio	rayon
reddito	revenu
misurare	mesure
voti	votes
du	du
dovere	devoir
discussioni	discussions
orso	ours
guadagno	Gain
Festival	Festival
laboratorio	laboratoire
oceano	océan
voli	vols
esperti	experts
segni	signes
profondità	profondeur
treno	train
asciutto	sec
Esplorare	explorer
terme	spa
concetto	concept
quasi	presque
maneggio	manipulation
origine	origine
miliardo	milliard
intelligenza	intelligence
comprato	acheté
contro	escroquerie
nazioni	nations
itinerario	route
rotto	cassé
battaglia	bataille
parlare	parler
protocollo	protocole
domanda	question
associazione	Partenariat
espressione	expression
es	es
discorso	discours
filo	câble
suggerimenti	suggestions
sostituzione	remplacement
nastro	ruban
strategico	stratégique
giudice	juge
acido	acide
byte	octets
centesimo	cent
costretto	forcé
compatibile	compatible
appartamento	appartement
nullo	nul
zero	zéro
altoparlante	orateur
consulenza	consultant
progettista	designer
pr	pr
matrimonio	mariage
rotolo	rouleau
banche	banques
fr	fr
partecipanti	participants
segreto	secret
negativo	négatif
preferiti	favoris
Teatro	théâtre
molle	ressorts
var	var
eseguire	effectuer
traduzione	Traduction
stime	estimations
ferita	blessure
ministero	ministère
driver	conducteurs
avvocato	avocat
figure	chiffres
protetta	protégé
proposta	proposition
compartecipazione	partage
portale	portail
beta	bêta
gratis	gratuitement
verso	vers
leggermente	légèrement
assistere	aider
condotta	conduite
contenuta	contenu
legislazione	législation
chiamata	appel
parametri	paramètres
profili	profils
questioni	questions
case	Maisons
controlli	contrôles
combinato	combiné
finale	ultime
rappresentante	représentant
minore	mineur
dipartimenti	départements
residenti	résidents
visualizzati	affiché
mamma	maman
ridotto	réduit
raro	rare
eseguita	réalisée
estremo	extrême
campioni	échantillons
barre	barres
previsione	prévoir
rimosso	supprimé
ciclo	cycle
contenere	contenir
precisione	précision
dormire	dormir
mg	mg
uccello	oiseau
farmacia	pharmacie
creazione	création
statico	statique
cacciatore	chasseur
indirizzi	adresses
signora	Dame
cristallo	cristal
famoso	célèbre
scrittore	écrivain
presidente	président
bere	boisson
accademia	académie
dinamico	dynamique
mangiare	manger
permanente	permanent
pulizia	nettoyage
costituisce	constitue
portafoglio	portefeuille
pratico	pratique
consegnato	livré
infrastruttura	Infrastructure
colore	Couleur
venditore	vendeur
filosofia	philosophie
regolamento	règlement
ufficiali	officiers
scopo	objectif
offerte	offres
nutrizione	nutrition
registrazione	enregistrement
junior	junior
les	les
mantellina	cap
anelli	anneaux
mancia	pointe
meraviglioso	formidable
biglietto	billet
annunciato	annoncé
indovina	deviner
chi	qui
calcio	football
matematica	math
importare	importer
spedizione	affectation
presenza	présence
automatico	automatique
visualizzazione	visualisation
mantenuto	entretenu
ch	ch
dan	dan
cani	chiens
registi	directeurs
aspetti	aspects
avanti	devant
Luna	lune
partecipazione	participation
schema	schème
volare	mouche
maniera	manière
matrice	matrice
combinazione	combinaison
emendamento	amendement
forza	force
tacchino	dinde
librerie	bibliothèques
corretto	correct
gradi	degrés
aziende	entreprises
delta	delta
paura	peur
cerca	recherche
pollici	pouces
convenzione	convention
azioni	actions
principale	principal
comfort	confort
colori	couleurs
guerre	guerres
ordinazione	commande
tenuto	conservé
alfa	alpha
appello	charme
crociera	croisière
indennità	prime
Hey	Hey
edifici	bâtiments
Speciali	promos
battere	battre
batterie	batteries
diventa	devient
unità	disques
braccia	bras
tè	thé
migliorata	amélioré
raggiungere	atteindre
posizioni	positions
vestito	robe
sottoscrizione	abonnement
commerciante	Marchand
contemporaneo	contemporain
cielo	ciel
rom	ROM
trasportato	porté
esposizione	exposition
nascondere	cacher
firma	Signature
mugnaio	meunier
fornitura	disposition
Abiti	vêtements
montatura	cadres
certamente	certainement
giornale	journal
giocattolo	jouet
strato	couche
stampato	imprimé
lento	lent
rimozione	suppression
responsabilità	responsabilité
stampanti	imprimantes
aggiungendo	ajouter
individuare	place
trascorrere	dépenser
fabbrica	usine
interno	intérieur
crescere	croître
ottico	optique
promozione	promotion
parente	relatif
Stupefacente	incroyable
punto	point
identità	identité
conversione	conversion
sensazione	sentiment
nascosto	caché
ragionevole	raisonnable
revisione	révision
influenza	influence
rapporto	rapport
importanza	importance
pioggia	pluie
pianeta	planète
copie	copies
permesso	permis
vedendo	voyant
prova	preuve
basso	basse
prescrizione	ordonnance
vuoto	vide
esempio	exemple
buco	trou
cavalcata	balade
ufficio	bureau
conservazione	préservation
paio	paire
ideale	idéal
Specifiche	spécification
registrato	enregistré
don	Don
pezzi	pièces
finito	fini
parchi	parcs
avvocati	avocats
stress	stress
crema	crème
ss	ss
piste	fonctionne
scoprire	découvrir
ap	ap
modelli	modèles
colline	collines
nm	nm
consulente	conseiller
consapevole	conscient
forma	forme
Evoluzione	évolution
certificati	certificats
obiettivi	objectifs
stazioni	stations
suggerito	suggéré
operazione	op
resti	restes
aziende	entreprises
Euro	euro
operatore	opérateur
strutture	structures
generico	générique
enciclopedia	encyclopédie
uso	usage
inchiostro	encre
misto	mixte
censimento	recensement
ruota	roue
fornitori	Fournisseurs
compatto	compact
poesia	poésie
luci	lumières
puntamento	suivi
angelo	ange
preparazione	préparation
tentativo	tentative
ricevente	recevoir
fiammiferi	allumettes
conformità	conformité
larghezza	largeur
motori	moteurs
dimenticare	oublier
schieramento	tableau
discusso	discuté
preciso	précis
clima	climat
greco	grec
istruzione	instruction
gestione	gérant
crudo	brut
differenze	différences
spiegare	Explique
stabilire	établir
espresso	exprimé
estensione	ampleur
acuto	tranchant
Ben	ben
paragrafo	paragraphe
uccidere	tuer
matematica	mathématiques
compensazione	compensation
esportare	exportation
manager	gestionnaires
moduli	modules
condotto	menée
versioni	versions
conosce	sait
descrivere	décrire
cittadini	citoyens
eredità	patrimoine
guaio	difficulté
allenatore	entraîneur
agricolo	agricole
espandere	développer
pubblico	public
assegnato	attribué
collezioni	collections
evo	âge
specialista	spécialiste
cucinare	cuisinier
influenzare	affecter
vergine	vierge
esperto	expérimenté
indagine	enquête
sollevato	relevé
cappello	chapeau
istituzione	institution
dirette	dirigée
influenzato	affecté
bicicletta	bicyclette
totalmente	totalement
piatto	assiette
spese	frais
indicare	indiquer
bionda	blond
procedimento	procédure
preferito	préféré
caratteristiche	caractéristiques
der	der
perdere	perdre
biologico	biologique
ricercare	chercher
esperienze	expériences
album	albums
contratti	contrats
ospiti	invités
ospitato	hébergé
malattie	maladies
circa	concernant
equivalente	équivalent
chimica	chimie
kit	kits
logica	logique
Principe	prince
cerchio	cercle
suolo	sol
psicologia	psychologie
bagnato	humide
condizioni	conditions
investitore	investisseur
elementare	élémentaire
sponsor	sponsors
Volpe	Renard
illimitato	illimité
rispondere	répondre
dimensioni	tailles
pianura	plaine
Uscita	Sortie
braccio	bras
chiavi	clés
onda	vague
santo	saint
atti	actes
guida	orientation
pista	Piste
simbolo	symbole
autostrada	Autoroute
osservata	observé
decano	doyen
impostare	installer
sondaggio	sondage
stili	modes
pieno	rempli
legame	liaison
canali	filières
appendice	annexe
cioccolato	Chocolat
porzione	portion
scopo	portée
fornitore	fournisseur
cavi	câbles
cotone	coton
Requisiti	exigence
ucciso	tué
confine	frontière
antico	ancien
discussione	débat
rappresentanti	représentants
inizia	départs
gravidanza	grossesse
attrazioni	attractions
imparato	appris
transazioni	transactions
esploratore	explorateur
storico	historique
marito	mari
autorizzato	autorisé
pazzo	fou
imminente	prochain
concerto	concert
punteggi	scores
efficienza	Efficacité
commedia	comédie
adottato	adopté
efficiente	efficace
lineare	linéaire
impegno	engagement
specialità	spécialité
orsi	ours
luppolo	saut
vettore	transporteur
costante	constant
Visa	visa
bocca	bouche
metro	mètre
connesso	lié
interviste	interviews
concetti	concepts
pistola	pistolet
riflettere	réfléchir
puro	pur
inferno	enfer
frutta	fruit
inizia	commence
qualificato	qualifié
riforma	réforme
lente	lentille
trattati	traités
scoperta	Découverte
disegnare	dessiner
classificato	classifié
assumere	assumer
alleanza	Alliance
Confermare	confirmer
ingegnere	ingénieur
coerente	cohérent
sostituire	remplacer
autorizzazione	dégagement
convertitore	convertisseur
organizzazione	organisation
bambino	bébé
controlli	chèques
raggiunto	atteint
diventando	devenir
obbiettivo	objectif
indicato	indiqué
zucchero	sucre
equipaggio	équipage
gambe	jambes
bastone	bâton
relazione	relation
abilitato	activée
genere	genre
volontario	bénévole
posteriore	arrière
democratico	démocratique
accrescere	améliorer
esatto	exact
limite	lié
parametro	paramètre
processore	processeur
nodo	nœud
formale	formel
tempesta	orage
micro	micro
collegi	collèges
miglio	mile
sfide	défis
redattori	éditeurs
supremo	suprême
fratelli	frères
riconoscimento	reconnaissance
arbitro	ref
stima	estimation
ragazzo	enfant
ispezione	inspection
consumatori	consommateurs
limiti	limites
territorio	territoire
Armi	armes
ritardo	retard
pilota	pilote
contributi	contributions
continuo	continu
iniziativa	initiative
romanzo	roman
esecuzione	exécution
invalidità	invalidité
ultra	ultra
vincitore	gagnant
episodio	épisode
vasaio	potier
piatto	plat
giochi	pièces
bollettino	bulletin
ia	ia
modificare	modifier
veramente	vraiment
universo	univers
candidato	candidat
fessura	fente
eccezionale	exceptionnel
ah	Ha
pianificato	prévu
casetta	loge
specchio	miroir
torneo	tournoi
considerazione	considération
sessioni	sessions
nocciolo	noyau
acquirenti	acheteurs
riviste	revues
grigio	gris
Catalogare	catalogue
carico	accusé
ampio	vaste
und	und
scelto	choisi
dimostrazione	demo
odiare	haine
terminale	Terminal
editori	éditeurs
notti	nuits
liquido	liquide
riso	riz
prenotazione	réservation
Alimenti	nourriture
guardia	garde
Salvataggio	économie
impero	Empire
recentemente	nouvellement
aumentare	élever
illegale	illégal
espansione	expansion
premier	premier
Domani	demain
latte	Lait
Dramma	drame
visitare	visite
concorso	concours
raccolto	collectées
bande	bandes
adatto	adapté
assolutamente	absolument
revisione	vérification
Camera	chambre
Guinea	Guinée
risultati	résultats
iso	iso
tipico	typique
somma	somme
pollo	poulet
temporaneo	temporaire
assistere	assister
doccia	douche
invio	envoi
sufficiente	suffisant
conchiglia	coquille
Provincia	Province
cattolico	catholique
governatore	gouverneur
birra	Bière
contributo	contribution
formula	formule
costituzione	Constitution
confezione	emballage
affidabile	fiable
dubbio	doute
guadagnare	gagner
periodi	périodes
attacchi	attaques
merce	marchandise
sintomi	symptômes
memoriale	Mémorial
gemello	double
inserire	insérer
porta	passerelle
disegno	dessin
candidati	candidats
ordinato	commandé
biologico	biologique
combattente	combat
transizione	transition
preferenze	préférences
spiare	espion
romanza	romance
strumento	instrument
Diviso	Divisé
temi	thèmes
potenze	pouvoirs
Paradiso	paradis
bit	morceaux
incinta	Enceinte
classificazione	classification
focalizzata	concentré
medico	médecin
chiede	demander
blocchi	blocs
Lo	lo
spirituale	spirituel
diabete	Diabète
ml	ml
cambio	décalage
sedersi	asseoir
corpi	corps
fotografie	photographies
taglio	Coupe
scrittori	écrivains
flessibile	flexible
amato	aimé
preferiti	favoris
Mappatura	cartographie
numerose	nombreux
relativamente	relativement
rappresenta	représente
superiore	supérieur
preferito	préféré
salvato	enregistré
intellettuale	intellectuel
concesso	accordé
carbonio	carbone
confortevole	confortable
magnetico	magnétique
interazione	interaction
ascoltando	écoute
crisi	crise
prospettiva	perspective
massiccio	massif
luminosa	brillant
formato	formé
pianoforte	piano
eco	écho
rivoluzione	révolution
visualizza	affiche
plasma	plasma
guadagni	gains
mistero	mystère
paesaggio	paysage
meccanico	mécanique
viaggio	périple
bandiera	bannière
Figura	figue
contee	comtés
acquisizione	acquisition
riconosciuto	reconnu
sogni	rêves
notifica	notification
kg	kg
insegnare	apprendre
rapido	rapide
Tirare	tirer
ut	Utah
seminario	séminaire
investimenti	investissements
ruote	roues
specificare	spécifier
sensibile	sensible
modelli	modèles
formati	formats
detiene	détient
router	routeur
calcestruzzo	béton
SI	si
cartella	dossier
completamento	achèvement
impulso	impulsion
tecnica	technique
voto	vote
tribunali	tribunaux
convertito	converti
Metro	métro
anniversario	anniversaire
miglioramenti	améliorations
striscia	bande
specificazione	spécification
incidente	accident
tacca	entaille
accessibile	accessible
residente	résident
tracciare	terrain
tipicamente	typiquement
rappresentazione	représentation
pompa	pompe
esiste	existe
accordi	arrangements
conferenze	conférences
consumo	consommation
stretto	étroit
minaccia	menace
sondaggi	enquêtes
seduta	séance
consulente	consultant
controllore	manette
comitati	comités
pene	pénis
castello	Château
giardini	jardins
etichette	Étiquettes
disposto	prêt
bio	bio
recitazione	agissant
teste	têtes
esame	examen
residenza	résidence
densità	densité
centinaio	cent
strano	étrange
sostenibile	durable
statistico	statistique
citare	mention
innovazione	innovation
grigio	gris
parallelo	parallèle
operare	fonctionner
fatture	factures
stabile	stable
definizioni	définitions
von	von
medici	médecins
lezione	leçon
cinema	cinéma
elezioni	élections
reazione	réaction
vuoto	blanc
migliorata	renforcée
intitolato	intitulé
grave	sévère
creare	produire
giornali	journaux
ospedali	hôpitaux
VI	vi
umorismo	humour
anziano	vieilli
monitor	moniteurs
eccezione	exception
durata	durée
massa	masse
visite	visites
capacità	capacités
raccomandazione	recommandation
peccato	péché
organizzato	organisé
ba	ba
parà	para
adozione	adoption
miglioramento	améliorer
costoso	coûteux
bufalo	buffle
organizzazioni	organisations
aereo	avion
programmi	programmes
meccanismo	mécanisme
EE	ee
segnato	marqué
guidato	poussé
bottiglia	bouteille
innovativo	innovant
massaggio	massage
conclusione	conclusion
chiusura	fermeture
mille	mille
leggenda	Légende
villa	villa
osso	OS
colonne	colonnes
disturbi	troubles
collaborazione	collaboration
rivelazione	détection
interno	interne
formazione	formation
med	med
ingegneri	ingénieurs
entità	entité
crociere	Croisières
cancello	porte
romano	romain
doveri	fonctions
erotico	érotique
tono	Ton
etica	éthique
Drago	dragon
occupato	occupé
Capitano	capitaine
porta	apporte
riscaldamento	chauffage
gamba	jambe
collo	cou
ala	aile
script	scripts
abc	abc
designato	nommé
rapporti	transaction
commettere	commettre
rotaia	rail
viaggi	voyages
divario	écart
lati	côtés
tubo	tube
corrispondente	correspondant
descrizioni	descriptions
cintura	ceinture
giacca	veste
animazione	animation
oracolo	oracle
er	er
produzioni	productions
aviazione	aviation
orgoglioso	fier
disastro	catastrophe
consolle	console
comandi	commandes
jr	jr
telecomunicazioni	télécommunications
istruttore	instructeur
gigante	géant
raggiunto	réalisé
lesioni	blessures
approcci	approches
solito	habituel
francobolli	timbres
angolo	angle
rapinare	Rob
progettisti	concepteurs
libertà	liberté
era	ère
convertire	convertir
possibilità	possibilité
analista	analyste
pericoloso	dangereux
affidabilità	fiabilité
rispettivamente	respectivement
volontari	bénévoles
derivato	dérivé
piacere	plaisir
onore	honneur
orientata	orienté
aquila	Aigle
preghiera	prière
workshop	ateliers
uragano	ouragan
silenzioso	silencieux
produttore	producteur
rappresentato	représentée
responsabilità	responsabilités
formaggio	fromage
accuratamente	soigneusement
produttività	productivité
corona	couronne
par	par
diagnosi	diagnostic
creatore	fabricant
crepa	fissure
principio	principe
picconi	choix
banda	gang
feticcio	fétiche
aspetto	apparence
Fumo	fumée
filtri	filtres
incorporato	incorporé
mestiere	artisanat
compagno	compagnon
cieco	aveugle
sala	salon
pazzo	furieux
algoritmo	algorithme
fortemente	fortement
bar	café
comprensione	ken
proteine	protéines
su	su
familiare	familier
capace	capable
ammissione	admission
scarpa	chaussure
eletto	élu
portando	portant
terrorismo	terrorisme
gioia	joie
edizioni	éditions
etnico	ethnique
parlamento	parlement
attore	acteur
reperti	découvertes
foca	joint
situazioni	situations
quinto	cinquième
cittadino	citoyen
verticale	verticale
correzioni	corrections
descrive	décrit
disabilità	handicapées
sostanza	substance
proibito	interdit
tubo	tuyau
soldati	soldats
custode	Gardien
conferenza	conférence
simulazione	simulation
disposizione	disposition
iniziative	initiatives
malato	mauvais
concentrazione	concentration
posare	allonger
interpretazione	interprétation
sporco	sale
insegnato	enseigné
lavoratore	ouvrier
ottimizzazione	optimisation
tempio	temple
sostanze	substances
dimostrare	prouver
scoperto	découvert
Ali	ailes
genetico	génétique
restrizioni	restrictions
magro	mince
esposizione	exposition
cresta	crête
modem	modem
portando	apportant
malato	malade
valutare	évaluer
tropicale	tropical
raccogliere	collecte
vettore	vecteur
decisamente	absolument
svolta	tournant
esistenza	existence
commento	commentaire
sviluppi	développements
immigrazione	immigration
destinazioni	destinations
reciproco	mutuel
sintassi	syntaxe
Li	li
attributo	attribut
prigione	prison
abilità	compétence
sedie	chaises
circostante	alentours
montagne	montagnes
popolarità	popularité
inchiesta	enquête
verificato	vérifié
mostra	exposition
gettare	jeter
tendenza	tendance
gatti	chats
deserto	désert
ya	ya
coordinatore	coordinateur
mercurio	Mercure
ardente	brûlant
fuga	échapper
ricevitore	destinataire
progressivo	progressive
Barche	bateaux
campionato	championnat
portico	arcade
impossibile	impossible
dice	dit
evidente	évident
depressione	dépression
grafico	graphique
copertura	couvrant
platino	platine
giudizio	jugement
trattativa	pourparlers
limatura	dépôt
adottivo	favoriser
premiato	décerné
prove	essais
maestri	maîtrise
cartuccia	cartouche
spiegazione	explication
org	org
frode	fraude
elettricità	électricité
spettro	spectre
arrivo	arrivée
ceramica	poterie
enfasi	accentuation
eccezionale	impressionnant
confermato	confirmé
conta	compte
schianto	crash
sollevamento	ascenseur
Inter	entre
altezza	hauteurs
ombra	ombre
spese	frais
avventurarsi	entreprise
clinica	clinique
guarigione	guérison
Principessa	Princesse
entrare	entrer
pacchetto	paquet
studios	studios
coinvolgimento	participation
papà	papa
pulsanti	boutons
posizionamento	placement
osservazioni	observations
vincitori	gagnants
strade	routes
successivo	subséquent
cortile	Cour
rivelazione	divulgation
istituzione	établissement
ricordi	souvenirs
TE	te
crea	crée
facce	visages
turista	touristique
omicidio	meurtre
adeguato	adéquat
senatore	sénateur
presentazioni	présentations
digerire	digérer
polvere	poussière
wiki	wiki
sostituito	remplacé
radar	radar
perdite	pertes
combattere	combat
riducendo	réduire
fermato	arrêté
occupazione	Occupation
strettamente	étroitement
radiazione	radiation
re	rois
tiro	tournage
orecchio	oreille
bandiere	drapeaux
panettiere	boulanger
prudente	conservateur
shock	choc
efficacia	efficacité
cravatta	attacher
tetto	toit
dimostrare	démontrer
atmosfera	atmosphère
bacio	baiser
bestia	bête
RA	ra
operato	exploité
sperimentare	expérience
obiettivi	cibles
acquisti	achats
federazione	fédération
Pizza	Pizza
invitato	invité
assegnazione	affectation
mod	mod
interrogazioni	requêtes
assenza	absence
fornitori	vendeurs
yoga	yoga
servi	sert
sorpresa	surprise
lampada	lampe
scherzi	blagues
consulenza	conseils
palazzo	palais
soddisfatto	satisfait
vittorie	victoires
magazzino	entrepôt
ipotetico	supposé
ordinario	ordinaire
fantasma	fantôme
violazione	violation
capo	patron
orgoglio	fierté
aspettative	attentes
indipendenza	indépendance
sapendo	connaissance
reporter	journaliste
metabolismo	métabolisme
campione	champion
personalmente	personnellement
abbondanza	beaucoup
assolo	solo
gola	gorge
ricchezza	richesse
vuoto	vide
danza	dansant
riconoscere	reconnaître
scrive	écrit
plaza	place
ricerca	quête
pubblicare	publier
selezione	dépistage
trans	trans
pioniere	pionnier
dimenticato	oublié
acrobata	acrobate
piatti	plaques
saggi	essais
comportamento	comportement
raccontare	récit
abbastanza	équitablement
intelligente	intelligent
modalità	modes
obbligo	obligation
porto	port
viaggiatore	voyageur
segmento	segment
nemico	ennemi
puzzle	puzzle
pozzi	puits
limitato	limité
repubblicano	républicain
segreti	secrets
sindrome	syndrome
partecipazione	présence
pena	peine
tamburo	tambour
Abilita	permet
costruttore	constructeur
vista	vue
alluvione	inonder
alleviare	facilité
argomenti	arguments
arena	arène
avventure	aventures
allievi	élèves
annuncio	annonce
risultato	résultat
apprezzare	apprécier
allargato	étendu
cresciuto	mûr
bello	charmant
centri	centres
clausola	clause
Sorriso	sourire
terre	terres
truppe	troupes
armato	armé
pino	pin
raffreddamento	refroidissement
golfo	golfe
camion	camions
meccanismi	mécanismes
divorzio	divorce
tradizione	tradition
pillole	pilules
tigre	tigre
gente	gens
sensore	capteur
esposto	exposé
caccia	chasse
angeli	anges
vice	adjoint
tailandese	thaïlandais
emissioni	émissions
medici	médecins
denuncia	plainte
scene	scènes
esperimenti	expériences
Incremento	renforcer
governo	gouvernance
mulino	moulin
fondato	fondé
cronico	chronique
tana	tanière
dito	doigt
mantiene	garde
libbra	livre
individuare	Localiser
pl	PL
allenato	qualifié
attuazione	exécution
pane	pain
motori	moteurs
difficile	dure
incidente	incident
dinamica	dynamique
menzogna	mensonge
conversazione	conversation
diminuire	diminution
culto	culte
capacità	aptitude
ak	Alaska
precisione	précision
danni	dégâts
riserve	réserves
risolvere	résoudre
minoranza	minorité
diverso	diverse
ingredienti	Ingrédients
ah	ah
toni	tons
reinserimento	réhabilitation
vista	vue
argilla	argile
debole	faible
diviso	divisé
ricezione	accueil
saggio	sage
probabilità	chances
seminari	séminaires
conseguenze	conséquences
maker	décideurs
geografia	géographie
integrità	intégrité
eredità	héritage
contento	heureux
Pericolo	danger
vitamina	vitamine
trasformati	traité
frase	phrase
raccolta	élevage
implicazioni	implications
funzionalità	fonctionnalité
Paradiso	paradis
ibrido	hybride
legge	lit
emotivo	émotif
gloria	gloire
ja	ja
geografico	géographique
superare	dépasser
asta	barre
seta	soie
bambini	bébés
bi	bi
romantico	romantique
rivelato	révélé
specialisti	spécialistes
Generatore	Générateur
sospensione	suspension
triste	triste
correzione	correction
lupo	Loup
lentamente	lentement
supplemento	supplément
porzioni	portions
infantile	bébé
settori	secteurs
fluido	fluide
motivo	terrains
pasto	repas
ta	ta
macchinario	machinerie
equazione	équation
cesti	paniers
probabilità	probabilité
dimensione	dimension
studiato	étudié
profitti	bénéfices
diavolo	diable
erba	herbe
illustrato	illustré
ciliegia	Cerise
continentale	continental
realizzazione	réussite
limitazioni	limites
funerale	funérailles
capitoli	chapitres
passeggeri	passager
conveniente	pratique
Marte	Mars
dimensioni	taille
uovo	Oeuf
segnali	signaux
orientamento	orientation
furto	vol
infanzia	enfance
simboli	symboles
lat	lat
meta	méta
analogico	analogique
talento	Talent
datato	daté
saggezza	sagesse
confine	frontière
elite	élite
gi	gi
crede	croit
poesie	poèmes
Giurisdizione	juridiction
robot	robot
visualizzazione	visualisation
testimone	témoin
fornito	équipé
stadi	étapes
sur	sur
acquisita	acquis
valutare	évaluer
lavaggio	lavage
Ingresso	entrée
dichiarazione	déclaration
perdere	perdant
tentativi	tentatives
nobile	noble
automazione	automatisation
impatti	impacts
rev	tour
vantaggi	avantages
cavaliere	Chevalier
obiettivi	objectifs
estensioni	extensions
appelli	appels
malattia	maladie
Ho	ho
alternative	alternatives
sh	sh
sapone	savon
marmellata	confiture
insolito	inhabituel
risponde	répondu
distruzione	destruction
migrazione	migration
disturbo	désordre
convenzionale	conventionnel
indossare	portant
asse	axe
ricercato	recherché
geni	gènes
mediano	médian
scanner	scanner
qui	ici
animato	Animé
registrazione	ajustement
eroe	héros
trattamenti	traitements
atteggiamento	attitude
tappeto	tapis
lenti	lentilles
frequentato	assisté
difficoltà	difficulté
punk	punk
coalizione	coalition
iscrizione	inscription
duca	Duc
ritmo	rythme
produttori	producteurs
arco	arc
interfacce	interfaces
atlante	atlas
osservazione	observation
tortura	torture
cancellato	supprimé
cappotto	manteau
restauro	restauration
convenienza	commodité
ritorno	retour
opposizione	opposition
contenitore	récipient
imputato	défendeur
supervisore	superviseur
corpo	corps
attori	acteurs
fegato	foie
responsabile	assujetti
petizione	pétition
antenna	antenne
raccolto	choisi
credenza	croyance
uccisione	meurtre
spalla	épaule
arredamento	décor
ione	ion
diametro	diamètre
Podcast	Podcast
interazioni	interactions
cantante	chanteur
araldo	héraut
invecchiamento	vieillissement
intervento	intervention
collegare	brancher
attrazione	attraction
immersione	plongée
modifica	modification
supporre	supposer
canna	roseau
coinvolgere	impliquer
moderare	modérer
topi	souris
inteso	compris
rapidamente	rapidement
bandire	interdire
garanzia	assurance
avvenimento	événement
vasto	vaste
mulini	moulins
contorno	contour
riceve	reçoit
jeans	jeans
compilazione	compilation
dispari	impair
sigma	Sigma
gr	gr
attraente	attrayant
occasione	occasion
registrazioni	enregistrements
vittima	victime
richieste	demandes
attento	prudent
fascio	faisceau
giardinaggio	jardinage
obblighi	obligations
arrivo	arrivée
orchestra	orchestre
licenza	Licence
regolabile	Ajustable
assegnazione	allocation
tema	essai
dimostrato	démontré
dialogo	dialogue
campi	camps
dichiarato	déclaré
traccia	trace
chiuso	fermer
confezioni	paquets
ge	ge
installazione	pose
interruttori	interrupteurs
volontario	volontaire
tu	tu
molto	très
ng	ng
comunemente	communément
pe	pe
fotografo	photographe
piangere	cri
quantistico	quantum
costruito	construit
aggiunte	additions
richiedendo	exigeant
freccia	flèche
Fidanzamento	engagement
ruvido	rugueux
strano	bizarre
Leone	Lion
matrimoni	mariages
ossigeno	oxygène
canyon	canyon
metri	mètres
semplicemente	seulement
calendari	calendriers
preparativi	arrangement
conclusioni	conclusions
bibliografia	bibliographie
pointer	aiguille
Compatibilità	compatibilité
allungare	étendue
permessi	permis
cooperativa	coopérative
alimentazione	alimentation
municipalità	canton
classifiche	classements
misurazione	mesure
cinghia	sangle
folla	foule
trasferimenti	transferts
olimpico	olympique
trasformazione	transformation
dir	dir
dogana	douane
amministratori	administrateurs
personalità	personnalité
gancio	crochet
roulette	roulette
declino	déclin
cordone	corde
nube	nuage
facilitare	faciliter
val	val
spiega	explique
procedere	procéder
sentimenti	sentiments
coltello	couteau
adottare	adopter
negato	dénié
donazione	don
esterno	extérieur
raccolto	surgir
fiumi	rivières
nodi	nœuds
citato	cité
mozzo	centre
mirata	ciblée
realizzato	réalisé
fondatore	fondateur
decennio	décennie
controversia	contestation
stanco	fatigué
avverso	négatif
estratto	extrait
scarico	décharge
bevande	boissons
asso	as
voci	voix
arrampicata	escalade
tonnellate	tonnes
profumo	parfum
pericoloso	dangereux
ristabilire	restaurer
pila	empiler
metodologia	méthodologie
reputazione	réputation
democratici	démocrates
appendere	pendre
curva	courbe
Creatore	créateur
ambra	ambre
musei	musées
codifica	codage
inseguitore	traqueur
variazione	variation
passaggio	passage
trasferito	transféré
tronco	tronc
fotografia	photographier
onde	vagues
cammello	chameau
distributore	distributeur
chi	chi
raduno	rassemblement
proiezione	projection
matematico	mathématique
logico	logique
salsa	sauce
fama	célébrité
specializzato	spécialisé
aziende	sociétés
critica	critique
automobile	voiture
giudici	juges
osservazioni	remarques
rilevato	détecté
dipinti	peintures
camminava	marché
derivante	découlant
popolazioni	populations
impaurito	peur
acustico	acoustique
cassetta	cassette
indicatore	indicateur
jpg	jpg
sbaglio	erreur
eliminare	éliminer
minerale	minéral
rubino	rubis
perline	perles
fortuna	fortune
tela	Toile
soglia	seuil
parrocchia	paroisse
schermi	écrans
cimitero	cimetière
stadio	stade
esplorazione	exploration
min	minutes
stelo	tige
astronomia	astronomie
concorsi	concours
influenza	grippe
costume	costume
Bici	vélos
vescovo	évêque
tirato	tiré
Mais	blé
compressione	compression
stabilire	établissement
contadino	agriculteur
lattina	étain
schiavo	esclave
immediatamente	immédiatement
istruire	encadrement
esaminato	examiné
codifica	codage
osservazioni	soumissions
eroi	héros
dipinto	peint
ritratto	portrait
terrorista	terroriste
etico	éthique
vettori	transporteurs
mobilità	mobilité
lotta	lutte
schemi	régimes
sofferenza	Souffrance
neutro	neutre
pescatore	pêcheur
ratto	rat
lance	lances
accoppiamento	joindre
intestazione	titre
artificiale	artificiel
cuscinetto	palier
spettacolare	spectaculaire
mondi	mondes
colpevole	coupable
Attivazione	Activation
porto	havre
tavoletta	tablette
giuria	jury
dos	dos
coda	queue
fascino	charme
violento	violent
potenzialmente	potentiellement
ranch	ranch
vincoli	contraintes
attraversamento	traversée
inclusivo	compris
Cottage	chalet
ubriaco	ivre
considerevole	considérable
crimini	crimes
risoluto	résolu
byte	octet
naso	nez
rami	branches
alieno	extraterrestre
processori	processeurs
rotto	cassé
complessità	complexité
costantemente	constamment
risolvere	résoudre
territori	territoires
tesi	thèse
dischi	disques
frequente	fréquent
soffitto	plafond
pixel	pixels
gen	gen
quadri	diamants
flotta	flotte
mazzo	bouquet
teorico	théorique
rinvio	référence
smettere	quitter
protocolli	protocoles
polmone	poumon
sostituire	remplacer
brillante	brillant
ti	ti
gel	gel
verbale	parlé
omega	oméga
valutato	évalué
rimasto	séjourné
vede	voit
fine	Résiliation
guardato	regardé
famiglie	ménages
riscattare	racheter
grano	grain
regime	régime
Toro	taureau
architettonico	architectural
differire	différer
movimenti	mouvements
riparazione	réparations
respiro	souffle
servizi	équipements
potenzialmente	virtuellement
mercato	marché
candela	bougie
sospeso	pendaison
colorato	coloré
racconto	conte
precedentemente	anciennement
proiettore	projecteur
situato	situé
cerca	cherche
rigorosamente	strictement
psicologico	psychologique
vitamine	vitamines
elegante	élégant
utile	gains
rinnovo	renouvellement
genealogia	généalogie
ritenuto	réputée
punteggio	points
spesa	dépense
critica	critiques
algoritmi	algorithmes
pirata	pirate
salone	salon
turbo	turbo
cura	guérir
ni	ni
pensa	pense
suggerimento	suggestion
soldato	soldat
bomba	bombe
danno	nuire
intervallo	intervalle
specchi	miroirs
indagare	enquêter
tuo	tes
pannelli	panneaux
ripetuto	répété
assalto	agression
cervo	cerf
lingua	langue
bowling	bowling
tri	tri
scimmia	singe
proporzione	proportion
gonna	jupe
analisi	analyses
disegni	dessins
significato	importance
scenario	scénario
voi	vous
Arabo	arabe
valutare	jauge
proteggere	protéger
affrontato	face
soluzione	résolution
produce	produit
intensivo	intensif
Catene	Chaînes
sesto	sixième
impegnare	engager
commutazione	commutation
corrispondenza	correspondance
importazioni	importations
supervisione	surveillance
spese	dépenses
separazione	séparation
testimonianza	témoignage
sospettare	suspect
obbligatorio	obligatoire
confini	limites
celebrazione	fête
filtraggio	filtration
Sposa	époux
esotico	exotique
spettatore	téléspectateur
raggiungendo	atteindre
ridere	rire
chirurgico	chirurgical
distruggere	détruire
citazione	citation
yo	yo
premesse	locaux
dimostrato	prouvé
offensivo	offensive
imperiale	impérial
dozzina	douzaine
distribuzione	déploiement
stoffa	tissu
loto	lotus
salmone	Saumon
carico	cargaison
direttiva	directif
compagno	camarade
burro	beurre
Pepe	poivre
arma	arme
fardello	charge
nastri	bandes
zone	zones
isola	île
sottile	svelte
acero	érable
drogheria	épicerie
governo	gouvernant
deposito	dépôt
alt	alt
torta	tarte
miscela	mélange
emissione	émission
apparente	apparent
didattico	éducatif
permessi	autorisations
gabinetto	toilette
classificato	classé
itinerari	routes
montaggio	montage
legato	lié
equilibrato	équilibré
ritardato	différé
vallata	vallée
calcolo	calcul
ville	villas
occasioni	occasions
equazioni	équations
oli	huiles
settembre	septembre
eccezionale	exceptionnel
ansia	anxiété
spaziale	spatial
intervistati	répondants
considerazioni	considérations
paga	paie
soleggiato	ensoleillé
fornisce	livre
je	je
collana	Collier
composito	composite
Lang	lang
teatri	théâtres
progettazione	conception
speranze	espoirs
valutazioni	évaluations
diagramma	diagramme
calzature	chaussure
sg	sg
popoli	peuples
vincitore	Victor
licenze	licences
intervalli	gammes
coppie	paires
sensibilità	sensibilité
conservazione	préservation
isolato	isolé
provvisorio	intérimaire
assistito	assisté
divine	Divin
approvare	approuver
composto	composé
intensità	intensité
tecnologico	technologique
aborto	Avortement
dialogo	dialogue
sedi	lieux
esplosione	explosion
indirizzamento	adressage
polo	pôle
scudo	bouclier
membrana	membrane
disperato	désespéré
madri	mères
dimostrazione	manifestation
governo	gouvernemental
manufatto	fabriqué
candele	bougies
variazioni	variations
mamme	mamans
sacro	sacré
dipendenza	dépendance
cromo	chrome
rifiutato	refusé
freno	frein
esterno	extérieur
saluto	salutation
ecologia	écologie
valletta	glen
disoccupazione	chômage
segnato	marqué
aumento	renforcement
clone	cloner
velocità	rapidité
lambda	lambda
composto	composé
lacrime	larmes
oasi	oasis
taxi	taxi
fa	FA
società	sociétés
silicio	silicium
identico	identique
petrolio	pétrole
competere	rivaliser
ist	ist
amante	amoureux
appartenere	appartenir
labbra	lèvres
scorta	escorte
stagno	étang
traghetto	traversier
coniglio	lapin
professione	métier
diga	barrage
fisiologia	physiologie
esportazioni	exportations
pneumatico	pneu
partecipante	participant
elettrone	électron
carichi	charges
erica	bruyère
motel	motel
sindacati	syndicats
tesoreria	Trésorerie
occupato	occupé
bilancia	Balance
sforzo	souche
arrestato	arrêté
indagini	enquêtes
guadagnato	gagné
lavanderia	blanchisserie
collocazione	placement
regolare	régler
valutato	évalués
crittografia	chiffrement
Riempimento	remplissage
imposto	imposé
silenzio	silence
sovietico	soviétique
possesso	possession
trattato	traité
allenatore	entraîneur
organo	organe
Limone	citron
buio	obscurité
campata	envergure
scherzo	blague
Imballaggio	emballage
statuto	loi
respinto	rejeté
riparo	abri
cappella	chapelle
produzione	fabrication
strati	couches
celebrare	célébrer
apparecchio	appareil
miscela	mélange
ciclista	cavalier
raggio	rayon
impressionante	impressionnant
pecora	mouton
architetto	architecte
lezioni	conférences
vini	vins
tazze	tasses
cenere	cendre
contributori	contributeurs
insalata	salade
violazioni	violations
temperature	températures
concorsi	compétitions
conserva	préserver
poesia	poème
stare	rester
Pasqua	Pâques
teorie	théories
deposito	dépôt
flussi	ruisseaux
atterraggio	atterrissage
eseguito	réalisé
negoziati	négociations
realistico	réaliste
chiede	demande
sinossi	synopsis
compositore	compositeur
fagiolo	haricot
spada	épée
modifiche	modifications
corallo	corail
pixel	pixel
percorsi	chemins
bolla	bulle
por	por
acquisire	acquérir
contrario	contraire
tribuna	tribune
nave	navire
acidi	acides
virus	virus
adesivi	autocollants
reazioni	réactions
credenze	croyances
squadra	équipe
analizzare	analyser
divisioni	divisions
nuotare	nager
nano	nano
concerti	concerts
maschi	mâles
conservare	conserver
colori	couleurs
eseguire	exécuter
tunnel	tunnel
generi	genres
brevetti	brevets
Grano	blé
Cronache	chroniques
ottenendo	obtention
castoro	castor
letture	lectures
allargamento	élargissement
Aquile	aigles
basi	bases
accusato	accusé
campagne	campagnes
unità	unité
definisce	définit
casi	instances
indigeno	indigène
iniziato	commencé
pacchetti	paquets
ancora	ancre
calzini	chaussettes
grilletto	déclencheur
colesterolo	cholestérol
differenziale	différentiel
superfici	surfaces
terribile	terrible
router	routeurs
orologi	horloges
artrite	arthrite
bios	bios
femmine	femelles
riflette	reflète
tassazione	Imposition
febbre	fièvre
cucina	cuisine
certamente	sûrement
professionisti	praticiens
teorema	théorème
inflazione	inflation
ti	te
composti	composés
batteria	tambours
ragionevolmente	raisonnablement
spoglio	nu
radicale	radical
raccomanda	recommande
controllo	commander
Tesoro	Trésor
fiamma	flamme
fossa	fosse
mono	mono
particelle	particules
galleggiante	flottant
coordinata	coordonner
esclusivamente	exclusivement
limitazione	limitation
colpito	frappé
illustrazione	illustration
avvertenze	avertissements
costruire	construction
applicazioni	applications
indagini	enquêtes
annesso	annexe
ispirazione	inspiration
nolo	fret
eclisse	éclipse
colpisce	affecte
previsioni	prévisions
individuare	détecter
attivamente	activement
complicato	compliqué
ferito	blessé
espressioni	expressions
tonnellata	tonne
Corriere	courrier
suggerimenti	astuces
gif	gif
conflitti	conflits
bevanda	boisson
omaggio	hommage
immune	immunitaire
silvicoltura	sylviculture
barriere	barrières
gergo	pente
raramente	rarement
offerte	offres
barriera	barrière
bicicletta	vélo
arredamento	mobilier
sorgere	survenir
celtico	celtique
particella	particule
umidità	humidité
bottiglie	bouteilles
dm	dm
Rinascimento	Renaissance
decreto	ordonnance
fotografi	photographes
infezioni	infections
scacchi	échecs
opera	fonctionne
festival	festivals
possibilità	possibilités
anatra	canard
canale	canal
contribuendo	contribuant
mucca	vache
analitico	analytique
costumi	costumes
rigoroso	strict
circolazione	circulation
offesa	infraction
assunzione	supposition
passatempo	loisir
cerca	essais
invenzione	invention
tecnico	technicien
dirigenti	cadres
indagini	enquêtes
conoscitivo	cognitif
esplorando	explorant
trucco	tour
inchiesta	enquête
chiusura	fermeture
legname	bois
volt	volt
intenso	intense
sostenitori	partisans
statuti	statuts
iscritto	inscrits
sensori	capteurs
vite	vis
ministri	ministres
pubblicamente	publiquement
subito	souffert
presa	admission
farfalla	papillon
meccanica	mécanique
intestazioni	têtes
errori	erreurs
numerico	numérique
definizione	définissant
conteggio	compte
riflessione	réflexion
invito	invitation
sodio	sodium
ormone	hormone
bambini	enfants
mattone	brique
presa	poignée
medievale	médiéval
porcellana	porcelaine
catturato	capturé
decente	décent
getto	fonderie
tradotto	traduit
donna	dona
guerriero	guerrier
cabina	cabine
lettura	balayage
polo	polo
copiatura	copier
corno	klaxon
giornalismo	journalisme
rana	grenouille
grammatica	grammaire
Intenzione	intention
pneumatici	pneus
intrapreso	entreprise
rischio	danger
Episodi	épisodes
circolare	circulaire
rabbia	colère
illustrazioni	illustrations
possibilità	chances
felicità	bonheur
bizzarro	bizarre
ur	ur
frutta	fruits
identificatore	identificateur
nastro	ruban
calcoli	calculs
jpeg	jpeg
avviare	Commencez
maneggevole	pratique
scambiare	échanger
esonerare	exempter
colture	cultures
riduce	réduit
compiuto	accompli
geometria	géométrie
impressione	impression
gilda	guilde
correlazione	corrélation
sim	sim
nervoso	nerveux
fragranza	fragrance
replica	réplique
tribù	tribu
compravendite	métiers
superbo	superbe
liberare	débarrasser
Trinità	trinité
maneggiato	manipulés
leggende	légendes
boom	boom
calma	calme
campioni	champions
piani	étages
Selezioni	sélections
confrontando	comparant
parla	parle
professionale	professionnel
farmacie	pharmacies
ln	Dans
rullo	rouleau
partita	lot
organizzare	organiser
gradito	apprécié
alterare	modifier
bordi	bords
miscelazione	mélange
maniglie	poignées
armonia	harmonie
distinto	distingué
asma	asthme
assunzioni	hypothèses
regolata	réglementé
triangolo	Triangle
emendare	modifier
anticipato	anticipé
orientale	Oriental
ricompensa	récompense
idrogeno	hydrogène
comparabile	comparable
avvocato	avocat
confusione	confusion
ingressi	contributions
garanzie	garanties
genoma	génome
medaglia	médaille
allenatori	entraîneurs
vasi	navires
porto	port
eco	eco
vulnerabile	vulnérable
organizzare	organiser
artistico	artistique
onori	honneurs
riflessa	reflété
unificato	unifié
razza	race
rivelatore	détecteur
ignorato	ignoré
preciso	précis
valutare	évaluer
labbro	lèvre
raccogliere	recueillir
formatura	formant
giornalisti	journalistes
leggero	mince
indiretto	indirect
tra	parmi
fondazioni	fondations
orizzonte	horizon
nu	nu
profondamente	profondément
passivo	passif
premi	prix
diminuita	diminué
descrivendo	décrivant
ottica	optique
perseguire	poursuivre
fulmine	foudre
ou	OU
citazioni	citations
ispettore	inspecteur
serpente	serpent
promemoria	rappel
cercato	cherché
pianure	plaines
approfondimenti	idées
abilità	capacités
avviato	initié
karaoke	karaoké
trappola	piège
solitario	solitaire
ve	ve
osservare	observer
contenitori	conteneurs
atteggiamenti	attitudes
bacca	baie
collare	collier
integrare	intégrer
sociologia	sociologie
mostre	expositions
muore	meurt
terrazza	terrasse
batteri	bactéries
dovere	devrait
delizioso	délicieux
tradizioni	traditions
finito	fini
invia	envoie
durevole	durable
alleato	allié
umidità	humidité
trasformare	transformer
Timer	minuteur
compresse	comprimés
ottenuto	obtenu
educatori	éducateurs
verdura	légume
versetto	verset
indipendentemente	indépendamment
concorrenti	concurrents
razzo	fusée
sì	toujours
proiettile	balle
torri	tours
visibilità	visibilité
latitudine	latitude
coscienza	conscience
tumore	tumeur
brutta	laid
depositi	dépôts
padrona	maîtresse
incontrare	rencontre
watt	watts
quaranta	quarante
tubi	tubes
tentata	tentative
sacerdote	prêtre
analisti	analystes
martello	marteau
invasione	invasion
corridore	coureur
righe	lignes
somministrati	administré
nozione	notion
ortografia	orthographe
artico	Arctique
ricompense	récompenses
sotto	sous
rafforzare	renforcer
difendere	défendre
infrarosso	infrarouge
settimo	septième
pancia	ventre
aggressivo	agressif
annunci	annonces
alloggio	quarts
rubare	volé
determina	détermine
scultura	sculpture
poli	poly
orecchie	oreilles
pugno	poing
neo	néo
motivazione	motivation
viaggiatori	passagers
costantemente	régulièrement
surplus	surplus
scavare	creuser
Taxi	Taxi
apprezzamento	appréciation
om	om
restrizione	restriction
chitarre	guitares
essenza	essence
potente	puissant
umanità	humanité
trascrizione	transcription
complicazioni	complications
studiosi	savants
galassia	galaxie
cura	soins
testamento	testament
dominante	dominant
stomaco	estomac
parzialmente	partiellement
minimizzare	minimiser
ranghi	rangs
debutto	début
generazioni	générations
tornei	tournois
negare	Nier
anatomia	anatomie
cuffie	écouteurs
frazione	fraction
trio	trio
procedere	instance
cubo	cube
difetti	défauts
incertezza	incertitude
abbattersi	panne
sistemato	colonisé
vaccino	vaccin
destino	sort
prenotazioni	réservations
repubblicani	républicains
giungla	jungle
zen	Zen
dis	dis
predizione	prédiction
ecologico	écologique
ovale	ovale
implica	implique
ser	ser
valutazione	évaluation
prospettiva	perspective
geografico	géographique
donatore	donneur
tensione	tension
spazzatura	poubelle
forme	formes
fila	étage
conte	comte
patria	patrie
campionati	championnats
razze	races
discoteca	disco
aus	aus
finitura	finition
emozioni	émotions
eterno	éternel
rotazione	rotation
nam	nam
produttivo	productif
viale	boulevard
maiale	porc
metrico	métrique
sanzioni	pénalités
vario	varié
Grande	grande
attrice	actrice
assegnare	attribuer
ospitare	accommoder
tigri	tigres
villaggi	villages
ombra	ombre
coro	Refrain
ritmo	rythme
cifra	chiffre
sinfonia	symphonie
improvviso	soudain
accettando	acceptant
piscine	piscines
lirica	lyrique
isolamento	isolement
velocità	vitesses
sostenuta	soutenu
abbinato	appariés
approssimativo	approximatif
corda	corde
razionale	rationnel
programmatore	programmeur
combattenti	combattants
ereditato	hérité
incompleto	incomplet
vocals	voix
Fontana	Fontaine
legittimo	légitime
biografie	Biographies
investigatore	enquêteur
attore	demandeur
dolce	doux
degno	digne
architetti	architectes
santi	saints
imprenditore	entrepreneur
trasporta	porte
duo	duo
eccessivo	excessif
salva	sauve
considerato	considéré
valutazione	évaluation
inaspettato	inattendu
nebbia	brouillard
caratteristica	caractéristiques
atrio	hall
delineato	décrit
enorme	énorme
karma	karma
consistere	consister
regine	reines
accademici	universitaires
tribù	tribus
distinzione	distinction
pericoli	dangers
esenzione	exemption
inquilino	locataire
sostenibilità	durabilité
tatuaggio	tatouage
algebra	algèbre
ombre	ombres
sciocco	idiot
liberamente	librement
mite	doux
pelliccia	fourrure
prontamente	facilement
affiliazione	affiliation
recinto	clôture
infinito	infini
clan	clan
rivoluzionario	révolutionnaire
bracciali	bracelets
rimedio	remède
respirazione	respiration
brevemente	brièvement
spessore	épaisseur
grafico	graphique
genio	génie
discutere	discuter
combattente	combattant
significativo	significatif
adattato	adapté
proprietà	domaines
tappeto	couverture
democratico	démocrate
borgo	arrondissement
mantiene	maintient
ka	ka
mantenuto	retenu
marmo	marbre
DEM	dem
meditazione	méditation
microfono	microphone
combinando	combinant
giganti	géants
organizzazione	organisation
promemoria	note
prosciutto	jambon
risolto	résolu
marea	marée
partizione	cloison
invisibile	invisible
console	consoles
magnete	aimant
traduzioni	traductions
giaguaro	jaguar
merce	marchandise
chilometri	kilomètres
garanzie	garanties
Gotico	gothique
cilindro	cylindre
strega	sorcière
secchio	mâle
nemici	ennemis
consulenza	Conseil
godendo	profiter
pattuglia	patrouille
odore	odeur
carnevale	carnaval
approssimativamente	grossièrement
etichetta	autocollant
promesse	promesses
scogliera	récif
dividere	diviser
consecutivo	consécutif
bon	bon
rappresentazioni	représentations
chan	chan
Tunes	airs
mas	mas
frasi	phrases
kai	kai
penisola	péninsule
noioso	ennuyeuse
dom	dom
discorsi	discours
raggiunge	atteint
schema	schéma
cataloghi	catalogues
ministeri	ministères
parlamentare	parlementaire
prefisso	préfixe
savana	savane
barile	baril
nervo	nerf
dans	Dans
pianeti	planètes
disavanzo	déficit
rinnovare	renouveler
accoppiato	accouplé
circuiti	circuits
struttura	texture
riconoscere	reconnaître
tenda	tente
identifica	identifie
qualificazione	qualification
serrature	serrures
miniatura	miniature
euro	euros
pirati	pirates
aereo	aérien
falco	faucon
conseguenza	conséquence
sistematico	systématique
percepito	perçue
origini	origines
assunti	embauché
trucco	maquillage
ui	ui
pesi	poids
geologica	géologique
durevole	durable
malvagio	méchant
introduce	introduit
spinto	pressé
ro	ro
pendenza	pente
poeta	poète
cospirazione	conspiration
teologia	théologie
unghie	ongles
evidente	évident
cavalcate	manèges
epico	épique
organizzatore	organisateur
allergia	allergie
interesse	Saké
combinazioni	combinaisons
precedente	précédent
merito	mérite
enzima	enzyme
aerei	Avions
dischi	disques
amplificatore	amplificateur
arbitrario	arbitraire
prominente	important
sans	sans
costruisce	construit
contattato	contacté
albero	arbre
magro	maigre
occasionale	occasionnel
innovazioni	innovations
revisione	révision
panico	panique
cittadinanza	citoyenneté
scusa	excuse
riforme	réformes
cipolla	oignon
Sandwich	sandwich
contralto	alto
gerarchia	hiérarchie
abbandonato	abandonné
cerchi	cercles
battiti	Beats
allegro	joyeux
culto	culte
trattino	tiret
passivo	passif
valutato	estimé
gabbia	cage
coraggio	courage
elevazione	élévation
giro	tour
utilizzo	utilisation
bevande	boissons
ping	ping
divertente	divertissant
necessario	prérequis
frontiera	frontière
rifugiati	réfugiés
cavalieri	chevaliers
ipotesi	hypothèse
farmaci	médicaments
alterato	modifié
dottrina	doctrine
panoramico	scénique
miglioramenti	améliorations
intersezione	intersection
cucire	couture
collettori	collectionneurs
riconosciuto	reconnu
rabbia	rage
prix	prix
astrologia	astrologie
consulenti	conseillers
padiglione	pavillon
tattica	tactique
supplementare	additionnel
talentuoso	talentueux
cuscino	oreiller
diffusione	diffusion
province	provinces
rubare	voler
pacco	parcelle
incidenza	incidence
paure	craintes
predire	prédire
gusto	saveur
Affamato	affamé
metallico	métallique
interferenza	ingérence
guerrieri	guerriers
atmosferico	atmosphérique
alone	Halo
parentale	parental
riferimento	référencé
attacchi	grèves
formica	fourmi
proposizione	proposition
adatto	apte
affrontato	traité
commerciante	Commerçant
gettato	jeté
criterio	critère
distintivo	badge
civiltà	civilisation
brughiera	bruyère
enorme	énorme
esegue	exécute
regno	domaine
corretto	corrigée
casco	casque
incontrato	rencontré
tsunami	tsunami
studioso	savant
circondato	entouré
geologia	géologie
creature	créatures
eliminato	dégagé
realizzare	accomplir
angoli	coins
vegetariano	végétarien
lievito	Levure
pas	pas
indagato	enquête
ambasciatore	ambassadeur
rivestito	recouvert
destino	condamner
routine	routines
esseri	êtres
dipendenza	dépendance
mito	mythe
ruscello	ruisseau
fu	fu
fenomeno	phénomène
insieme	ensemble
assicurato	assuré
consapevole	conscient
accento	accent
mogli	épouses
utilizzare	utiliser
impegno	gage
vampiro	vampire
bacino	Dock
organizzato	organisé
musicista	musicien
limitativo	limitant
restaurato	restauré
suggerimento	allusion
armatura	armure
osservazione	remarque
dozzine	douzaines
varia	varie
ragionamento	raisonnement
guardie	gardes
aperture	ouvertures
sostituzione	remplaçant
ricercatore	chercheur
consigli	conseils
occupazioni	professions
riconosciuto	reconnu
Maiale	porc
zu	zu
equilibrio	équilibre
tubi	pipes
cottage	chalets
fondersi	fusionner
privilegio	privilège
sviluppa	développe
telaio	châssis
stima	estimation
fienile	Grange
brina	gel
istituti	instituts
muffa	moule
dama	dame
yacht	yacht
preferisce	préfère
perforazione	forage
erba	herbe
violazione	violation
balena	baleine
viaggiatore	voyageur
stanziamenti	crédits
sospetto	soupçonné
pomodori	tomates
istruttori	instructeurs
impulso	élan
pinna	ailette
pastore	pasteur
fango	boue
Smeraldo	émeraude
cresce	pousse
tratto	tract
ul	ul
balletto	ballet
giornalista	journaliste
religioni	religions
aglio	Ail
brillare	éclat
esplosione	explosion
slip	slips
firme	signatures
ozono	ozone
discipline	disciplines
Casa	casa
conversazioni	conversations
radio	radios
tariffa	tarif
semplificato	simplifié
muscoli	muscles
veloce	rapide
vagina	vagin
Champagne	Champagne
deviazione	déviation
samba	samba
impiegare	employer
pinguino	manchot
magico	magique
influenze	influences
ispezioni	inspections
irrigazione	irrigation
miracolo	miracle
idraulico	hydraulique
penetrazione	pénétration
ferita	blessure
bella	belle
rosa	rosa
convinzione	conviction
pigro	paresseux
qualità	qualités
padri	ancêtres
ricarica	charge
importante	important
petite	menue
apparato	appareil
terreno	terrain
spiegando	expliquant
strisce	bandes
nomina	nomination
empirico	empirique
verme	ver
dipendenza	dépendance
discreto	discret
principiante	débutant
coperchio	couvercle
sessualità	sexualité
zaffiro	saphir
privilegi	privilèges
specializzata	spécialisation
marcatura	marquage
sceriffo	shérif
diminuito	diminué
spie	espions
moto	motocyclettes
eletto	élire
autostrade	autoroutes
concentrarsi	concentrer
intimo	intime
molecole	molécules
giri	tours
frigorifero	réfrigérateur
intervalli	intervalles
frasi	Phrases
olocausto	holocauste
aviatore	prospectus
piselli	pois
dosaggio	dosage
varianza	variance
navigatore	navigateur
ago	aiguille
terme	thermes
Freni	freins
og	og
ko	ko
possiede	propriétaire
destino	destin
paesaggi	paysages
calcolo	calcul
fieno	foins
salvezza	salut
predizioni	prévisions
discenti	apprenants
gettone	jeton
zinco	zinc
sacrificio	sacrifice
asilo	demandeurs
guru	gourou
adatto	adapté
numerico	numérique
antropologia	anthropologie
imperatore	empereur
grad	grad
cinture	ceintures
neri	noirs
educato	cultivé
orgoglio	fièrement
necessità	nécessité
curve	courbes
turismo	tournée
vertice	sommet
pomodoro	tomate
viaggi	voyages
pallido	pâle
funzionamento	fonctionnement
economie	économies
intraprendere	entreprendre
dichiarare	déclarer
valvole	vannes
lacune	lacunes
realizzazioni	réalisations
lacrima	larme
insegna	enseigne
zero	néant
sconosciuto	étranger
nido	nid
tribunale	tribunal
governato	gouverné
pensioni	pensions
preghiere	prières
poliziotto	flic
adolescente	adolescent
nomination	nominations
Banana	banane
introduttivo	préliminaire
serbatoio	réservoir
evento	occurrence
idolo	idole
sanguinoso	sanglant
ricordare	rappeler
affascinante	charmant
dente	dent
rispettata	respecté
soggiorni	séjours
affare	affaire
limitare	restreindre
miniere	mines
ritratti	portraits
interpretato	interprété
valutazioni	évaluations
eliminazione	élimination
metri	mètres
ipotetico	hypothétique
elicottero	hélicoptère
matita	crayon
esecutore	interprète
commissioni	commissions
sfera	sphère
muschio	mousse
rapporti	rapports
concordia	concorde
laureato	graduée
omologati	approuvé
sorprendente	surprenant
lancia	lance
scala	échelle
sughero	Liège
senatori	sénateurs
emorragia	saignement
caratterizzazione	caractérisation
probabilità	probabilité
corsie	voies
fondamenti	fondamentaux
contaminazione	contamination
cupola	dôme
benedire	bénir
trattativa	négociation
cresta	crête
avversari	adversaires
trionfo	triomphe
nominato	nommé
saldatura	soudage
orgasmo	orgasme
lega	alliage
trame	parcelles
delicatamente	doucement
bloccaggio	verrouillage
controverso	controversé
disegna	dessine
frigo	frigo
lame	lames
loop	boucles
ondata	poussée
trauma	traumatisme
annuncio	publicité
difensiva	défensive
proibito	interdit
vaniglia	vanille
programmatori	programmeurs
monitorati	suivi
installazioni	installations
anime	âmes
motivata	motivé
muto	stupide
cavo	creux
volta	voûte
scanalatura	rainure
rivelazione	révélation
ricerca	poursuite
delegazione	délégation
fili	fils
dizionari	dictionnaires
trasparenza	transparence
orbita	orbite
valute	devises
Niger	Niger
posizionamento	placement
colonia	colonie
cannone	canon
circo	cirque
promossa	promu
trota	truite
impresa	exploit
temporaneamente	temporairement
cucinato	cuit
trasmettere	transmettre
frequenze	fréquences
riflessi	réflexions
fame	faim
comune	municipalité
investigatore	détective
cemento	ciment
sperimentare	expérience
camino	cheminée
approvazione	approbation
tessile	textiles
missile	missile
psichiatria	psychiatrie
assist	aide
uditore	Auditeur
violino	violon
profeta	prophète
ossido	oxyde
magnifico	magnifique
prontamente	rapidement
adattamento	adaptation
dannoso	nocif
sessualmente	sexuellement
allegato	enceinte
glucosio	glucose
norma	norme
riproduzione	lecture
tartaruga	tortue
distanze	distances
assorbimento	absorption
tesori	trésors
fossile	fossile
male	mal
comunista	communiste
imprenditori	entrepreneurs
robot	robots
fallo	faute
biodiversità	biodiversité
eccitazione	excitation
verbale	verbal
mari	mers
misterioso	mystérieux
novità	nouveauté
piastrelle	carrelage
bibliotecario	bibliothécaire
commutata	commuté
ru	ru
posa	pose
grammi	grammes
terapista	thérapeute
budget	budgets
capra	chèvre
rendere	rendre
vela	voile
commissari	commissaires
denso	dense
coraggioso	courageux
spedizione	expéditeur
terribile	terrible
aereo	avion
organismi	organismes
telescopio	télescope
amianto	amiante
avanzamento	avancement
salice	saule
riprende	CV
esistito	existait
generatori	générateurs
genera	génère
patate	patates
completo	approfondi
recettori	récepteurs
ottimale	optimum
creatura	créature
solitario	seul
sottile	subtil
strisce	rayures
firmware	firmware
pastore	berger
culla	berceau
cancelliere	chancelier
Farina	farine
controversia	controverse
leggendario	légendaire
coro	chorale
evitando	évitant
magnificamente	magnifiquement
aspetta	attend
salto	sauteur
tessuti	textile
polimero	polymère
igiene	hygiène
virtù	vertu
chirurghi	chirurgiens
mandato	mandat
corpo	corpus
terminologia	terminologie
signore	gentilhomme
condannato	condamné
getti	jets
indici	indices
qui	Qui
minaccioso	menaçant
attivisti	militants
prigioniero	prisonnier
incoraggia	encourage
assemblato	assemblé
terminali	terminaux
greggio	brut
esamina	examine
vichingo	viking
pulire	nettoyer
condizionale	conditionnel
attaccato	attaqué
arriva	arrive
traduttore	traducteur
automobili	automobiles
trattore	tracteur
continente	continent
tariffe	tarifs
longitudine	longitude
sperato	espéré
inserimento	insertion
costrizione	contrainte
potenziamento	renforcement
desiderando	souhaitant
isolamento	isolation
violazione	infraction
piegato	courbé
soggettivo	subjectif
mostri	monstres
asilo	asile
palo	pieu
cocktail	cocktail
varietà	variétés
veleno	poison
dominato	dominé
costoso	cher
derivati	dérivés
impedisce	prévient
fucile	fusil
razzismo	racisme
interpretare	interpréter
accordo	accord
modesto	modeste
giocatori	joueurs
ordinamento	tri
collegamento	liaison
bulbi	bulbes
turisti	touristes
comportamenti	comportements
chiarire	clarifier
vita	taille
attribuito	attribué
gufo	hibou
cristalli	cristaux
supera	dépasse
complementare	complémentaire
battaglie	batailles
amaro	amer
memorandum	mémorandum
draghi	dragons
frastuono	vacarme
incredibilmente	incroyablement
delegati	délégués
psichiatrico	psychiatrique
adolescenti	adolescents
cortile	Cour
presidenti	présidents
partire	partir
espressamente	expressément
giglio	lis
svista	surveillance
resina	résine
alleati	alliés
conservato	conservé
attraversato	franchi
ascendente	Ascendant
nominale	nominal
decadimento	pourriture
quarzo	quartz
registri	registres
ottavo	huitième
autorizzato	autorisé
migliora	améliore
sostenitori	défenseurs
fenomeni	phénomènes
inclinazione	inclinaison
granito	granit
masse	masses
atleta	athlète
franco	franc
somiglianza	similarité
perdita	fuite
consigliere	conseiller
opuscolo	brochure
aspettandosi	attendant
turnover	rotation
urina	urine
asciugamano	serviette
Zenzero	gingembre
cromosoma	chromosome
als	als
mosche	mouches
competenza	compétence
pianto	pleurs
dilettanti	amateurs
gru	grue
indagare	enquête
marcio	pourri
abitudine	habitude
onore	honneur
protegge	protège
iris	iris
gestisce	gère
erosione	érosion
falegname	Charpentier
caravanserraglio	khan
insufficiente	insuffisant
formulazione	formulation
intelligente	intelligent
signori	seigneurs
piacevole	agréable
mezzaluna	croissant
sessanta	soixante
concentrato	concentré
distinguere	distinguer
EI	ei
proiezioni	projections
scintilla	étincelle
fissaggio	fixation
sentiero	sentier
rilevatori	détecteurs
spuntone	pointe
ingrediente	ingrédient
tenda	rideau
divulgato	divulgués
tattico	tactique
piloti	pilotes
spedizione	expédition
operativo	opératoire
umorismo	humour
mol	mol
impronta	imprimer
assistere	assistant
difetto	défaut
male	pauvrement
dea	déesse
osservatori	observateurs
magneti	aimants
formule	formules
spazioso	spacieux
sostiene	soutient
suoli	sols
organi	organes
det	det
lealtà	fidélité
fedele	fidèle
offesa	infraction
litio	lithium
salto	saut
fondazione	fondation
cigno	cygne
piantare	plantation
patto	engagement
archeologia	archéologie
marinaio	marin
cure	soins
santuario	sanctuaire
statua	statue
Quotazione	citation
major	majors
manipolazione	manipulation
campane	cloches
tossicità	toxicité
trasmettitore	émetteur
quartieri	quartiers
trofeo	trophée
emozione	émotion
viste	spectacles
uniformi	uniformes
ferito	blessés
derivato	dérivé
occupazione	occupation
dosi	doses
educare	éduquer
pregiudizio	préjudice
tecnici	techniciens
probabile	probable
emissione	émission
decorazione	décoration
cittadini	ressortissants
trojan	troyen
assistenti	assistants
consulente	conseiller
promulgato	adopté
instabile	instable
sollecitato	pressé
riflettendo	reflétant
guadagnando	gagnant
definitivo	définitive
viaggiato	voyagé
adattare	adapter
accessione	accession
regolatore	régulateur
combustibili	carburants
soia	soja
pulito	soigné
denominazione	appellation
poppa	arrière
artigianale	conçu
idiota	idiot
composto	composé
alieni	extraterrestres
modifiche	modifications
Corvo	corbeau
dimora	habitation
simbolico	symbolique
angoli	angles
pressioni	pressions
Venere	Vénus
fiamme	flammes
primitivo	primitif
calza	stockage
ecosistema	écosystème
sale	salles
semplicità	simplicité
demone	démon
accolto	accueilli
notazione	notation
zia	tante
corvo	corbeau
semantico	sémantique
interrotto	abandonnées
decide	décide
globalizzazione	mondialisation
asini	ânes
bussola	boussole
evoluto	évolué
fanteria	infanterie
rinomato	renommé
corridoio	couloir
filosofico	philosophique
giustificazione	justification
vacante	vacant
fissaggio	fixation
grammo	gramme
bastonatura	cache
colorante	colorant
alfabeto	alphabet
puliti	nettoyé
onorato	honoré
ottico	optique
telefoni	téléphones
diari	agendas
dolore	douleur
sudore	transpiration
delfino	dauphin
meraviglie	merveilles
ventilazione	ventilation
maschere	masques
busto	buste
vicolo	ruelle
percorsi	voies
telegrafo	télégraphe
monumento	monument
formalmente	officiellement
rugiada	rosée
ritirato	retiré
dibattiti	débats
identità	identités
carenza	carence
sella	selle
malaria	paludisme
leale	fidèle
tendenza	tendance
utilizzato	utilisé
Ein	ein
binocolo	jumelles
iniziato	lancer
puramente	purement
vivido	vif
accuse	allégations
corrisponde	correspond
demone	démon
celebre	célèbre
cacciatori	chasseurs
agito	agi
coefficiente	coefficient
cranio	crâne
continuazione	continuation
servitore	serviteur
falco	faucon
insieme	conjointement
evitato	éviter
spiegazioni	explications
rinnovato	renouvelé
critico	critique
sedimento	sédiment
piazze	carrés
furgoni	fourgonnettes
cono	cône
sopravvissuto	survécu
prevalenza	prévalence
frammento	fragment
impegna	engage
cobra	cobra
gettò	jeta
hoc	hoc
interpreti	interprètes
dolce	dessert
dissertazione	thèse
nono	neuvième
entusiasmo	enthousiasme
celebrazioni	célébrations
governatori	gouverneurs
atomi	atomes
tessuti	tissus
rampa	rampe
piacevolmente	bien
della	della
dominio	domination
accordi	accords
menomazione	détérioration
molecola	molécule
