из	di
в	a
в	in
для	per
является	è
на	sopra
что	quella
от	di
это	Questo
с	con
я	io
вы	tu
Это	esso
или	o
быть	essere
находятся	siamo
в	a
все	tutti
иметь	avere
новый	nuovo
мы	noi
будем	volere
Главная	casa
нас	noi
около	di
если	Se
страница	pagina
мой	mio
имеет	ha
поиск	ricerca
свободно	gratuito
но	ma
наш	nostro
один	uno
Другие	altro
делать	fare
Информация	informazione
время	tempo
он	lui
который	quale
их	loro
Новости	notizia
использование	uso
там	Là
видеть	vedere
так	così
кто	chi
Web	web
также	anche
получить	ottenere
вечера	pm
Посмотреть	vista
с	c
е	e
первый	primo
было	stato
бы	voluto
мы	erano
s	S
как	piace
Икс	X
чем	di
найти	trova
цена	prezzo
назад	indietro
Вверх	superiore
люди	persone
имел	aveva
список	elenco
имя	nome
просто	appena
год	anno
день	giorno
в	in
два	Due
здоровье	Salute
N	n
ре	ri
используемый	Usato
идти	partire
б	B
последний	ultimo
делать	rendere
их	loro
должен	dovrebbero
продукт	Prodotto
система	sistema
после	inviare
ее	sua
город	città
T	t
политика	politica
номер	numero
поддержка	supporto
сообщение	Messaggio
после	dopo
тогда	poi
январь	gennaio
хорошо	bene
d	d
где	dove
Информация	Informazioni
права	diritti
книги	libri
высокая	alto
школа	scuola
м	m
каждый	ogni
связи	link
она	lei
лет	anni
заказ	ordine
очень	molto
книга	libro
Предметы	elementi
Компания	azienda
р	r
читать	leggere
группа	gruppo
секс	sesso
многие	molti
пользователь	utente
де	de
задавать	impostato
Генеральная	generale
исследование	ricerca
Университет	Università
январь	gennaio
почта	posta
полный	pieno
отзывы	recensioni
программа	programma
знать	conoscere
игры	Giochi
путь	modo
дней	giorni
п	p
часть	parte
мог	poteva
Великий	grande
единый	unito
реальный	vero
е	f
Международный	internazionale
центр	centro
путешествовать	viaggio
Комментарии	Commenti
сделал	fatto
развитие	sviluppo
доклад	rapporto
член	membro
Детали	dettagli
линия	linea
сроки	condizioni
до	prima
отели	alberghi
сделал	fatto
Отправить	inviare
правильно	destra
тип	genere
местный	Locale
те	quelli
Результаты	risultati
офис	ufficio
национальный	nazionale
автомобиль	auto
дизайн	design
принимать	prendere
отправил	postato
адрес	indirizzo
сообщество	Comunità
в	entro
состояния	stati
хотеть	volere
Телефон	Telefono
DVD	DVD
предмет	soggetto
между	fra
Форум	Forum
семья	famiglia
L	l
длинный	lungo
вес	w
показать	mostrare
о	o
даже	anche
черный	nero
особый	speciale
индекс	indice
являющийся	essere
женщины	donne
много	tanto
знак	cartello
файл	file
ссылка	collegamento
открытый	Aperto
юг	Sud
дело	Astuccio
проект	progetto
страницы	pagine
версия	versione
раздел	sezione
своя	proprio
дом	Casa
безопасность	sicurezza
г	g
округ	contea
американский	americano
Фото	foto
игра	gioco
члены	membri
мощность	energia
сеть	Rete
компьютер	computer
системы	sistemi
три	tre
место	posto
конец	fine
час	h
его	lui
в	per
доступ	accesso
думать	pensare
север	nord
Ресурсы	risorse
текущий	attuale
большой	grande
СМИ	media
закон	legge
контроль	controllo
воды	acqua
история	storia
размер	dimensione
личный	personale
руководство	guida
магазин	negozio
каталог	elenco
изменение	modificare
белый	bianca
текст	testo
маленький	piccolo
рейтинг	valutazione
ставка	Vota
правительство	governo
дети	bambini
вернуть	ritorno
студенты	studenti
v	v
Счет	account
раз	volte
уровень	livello
цифровой	digitale
профиль	profilo
предыдущий	precedente
форма	modulo
Мероприятия	eventi
люблю	amore
старый	vecchio
Джон	John
главный	principale
вызов	chiamata
образ	Immagine
отдел	Dipartimento
заглавие	titolo
не	non
К	K
Y	y
страхование	assicurazione
должен	deve
имущество	proprietà
класс	classe
CD	CD
качественный	qualità
каждый	ogni
список	listato
содержание	soddisfare
страна	nazione
немного	piccolo
инструменты	utensili
низкий	Basso
Ответить	rispondere
клиент	cliente
Декабрь	dicembre
сравнить	confrontare
кино	film
колледж	Università
стоимость	valore
статья	articolo
человек	uomo
работы	lavori
J	j
питание	cibo
автор	autore
другой	diverso
U	u
учить	imparare
продажа	saldi
Распечатать	stampare
курс	corso
работа	lavoro
комната	camera
акции	azione
обучение	formazione
слишком	pure
кредит	credito
точка	punto
наука	scienza
люди	uomini
категории	categorie
запад	ovest
смотреть	Guarda
английский	Inglese
команда	squadra
имущество	tenuta
коробка	scatola
условия	condizioni
фото	fotografie
гей	gay
нить	filo
категория	categoria
заметка	Nota
жить	vivere
большой	grande
галерея	galleria
Таблица	tavolo
Однако	però
июнь	giugno
октябрь	ottobre
ноябрь	novembre
рынок	mercato
библиотека	biblioteca
действие	azione
Начало	inizio
серии	serie
функции	Caratteristiche
воздух	aria
промышленность	industria
план	Piano
человек	umano
да	sì
второй	secondo
горячий	caldo
Стоимость	costo
кино	film
форумы	forum
Март	marzo
ля	la
сентябрь	settembre
сказать	dire
собирается	andando
медицинская	medico
друг	amico
декабрь	dicembre
сервер	server
заявление	applicazione
сотрудники	personale
играть	giocare
вопросы	problemi
апрель	aprile
пользователи	utenti
улица	strada
тема	argomento
против	contro
получил	avuto
блог	blog
вечеринка	festa
оплата	pagamento
оборудование	attrezzatura
позволять	permettere
программы	programmi
правовой	legale
недавний	recente
парк	parco
акт	atto
проблема	problema
красный	rosso
дайте	dare
Память	memoria
представление	prestazione
Социальное	sociale
Q	q
история	storia
продавать	vendere
опции	opzioni
опыт	Esperienza
ключ	chiave
тело	corpo
молодой	giovane
важный	importante
поле	campo
мало	pochi
восток	est
Один	singolo
б	ii
возраст	età
клуб	club
пример	esempio
девочки	ragazze
Z	z
Дорога	strada
подарок	regalo
вопрос	domanda
Калифорния	circa
жесткий	difficile
платить	pagare
четыре	quattro
покер	poker
вопрос	problema
ассортимент	gamma
здание	costruzione
продавец	venditore
суд	Tribunale
февраль	febbraio
результат	risultato
легкий	leggero
записывать	Scrivi
война	guerra
предлагает	offrire
синий	blu
группы	gruppi
аль	al
легко	facile
данный	dato
запрос	richiesta
факс	fax
Китай	Cina
изготовление	fabbricazione
картина	immagine
потребности	esigenze
возможное	possibile
месяц	mese
главный	maggiore
звезда	stella
будущее	futuro
пространство	spazio
комитет	Comitato
рука	mano
солнце	sole
карты	carte
Лондон	Londra
встреча	incontro
стали	diventare
ребенок	bambino
держать	conservare
порно	porno
доля	Condividere
аналогичный	simile
сад	giardino
школы	scuole
миллиона	milione
добавленной	aggiunto
Справка	riferimento
компании	aziende
детка	bambino
обучение	apprendimento
энергия	energia
бег	correre
Доставка	consegna
популярный	popolare
срок	termine
фильм	film
истории	storie
положил	mettere
журнал	rivista
отчеты	rapporti
Колорадо	co
пытаться	provare
изображений	immagini
уведомление	Avviso
Бог	Dio
оригинал	originale
глава	capo
радио	Radio
клетка	cellula
совет	consiglio
включает	include
трек	traccia
обсуждение	discussione
архив	archivio
другие	altri
соглашение	accordo
формат	formato
общество	società
месяцы	mesi
безопасность	sicurezza
друзья	amici
конечно	sicuro
издание	edizione
Сообщения	messaggi
маркетинг	marketing
рассказать	raccontare
ассоциация	associazione
обеспечивает	fornisce
весело	divertimento
уже	già
зеленый	verde
исследования	studi
Закрыть	vicino
общий	Comune
конкретный	specifica
несколько	parecchi
живой	vita
коллекция	collezione
называется	chiamato
короткая	corto
искусства	arti
много	lotto
просить	Chiedere
ограниченное	limitato
решения	soluzioni
директор	direttore
пляж	spiaggia
мимо	passato
натуральный	naturale
электроника	elettronica
на	su
период	periodo
планирование	pianificazione
говорит	dice
официальный	ufficiale
март	mar
сделанный	fatto
технический	tecnico
окно	finestra
профессионал	professionista
область	regione
остров	isola
запись	disco
непосредственный	diretto
конференция	conferenza
учет	record
улица	st
район	quartiere
календарь	calendario
расходы	costi
стиль	stile
заявление	dichiarazione
миль	miglia
ресурс	risorsa
Приложения	applicazioni
документ	documento
слово	parola
работает	lavori
материал	Materiale
законопроект	conto
написано	scritto
правила	regole
окончательный	finale
вещь	cosa
центр	centro
требования	requisiti
ПРАВДА	VERO
минут	minuti
еще	altro
отметка	marchio
камень	roccia
Плохо	cattivo
индивидуальный	individuale
плюс	più
авто	auto
обложка	copertina
редактировать	modificare
вместе	insieme
видео	video
быстро	veloce
функция	funzione
факт	fatto
получение	ottenere
Глобальный	globale
тек	Tech
встретить	incontrare
далеко	lontano
экономической	economico
ан	it
игрок	giocatore
проектов	progetti
количество	quantità
смотреть	orologio
включены	incluso
Чувствовать	sentire
банка	banca
риск	rischio
предложения	offerte
различный	vario
слова	parole
производство	produzione
коммерческая	commerciale
вес	peso
сердце	cuore
лечение	trattamento
точки	punti
знание	conoscenza
журнал	rivista
ошибка	errore
камера	telecamera
девушка	ragazza
строительство	costruzione
игрушки	giocattoli
зарегистрированный	registrato
домен	dominio
методы	metodi
глава	capitolo
защита	protezione
полисы	politiche
широкий	largo
красота	bellezza
менеджер	manager
Индия	India
должность	posizione
взятый	prese
Сортировать	ordinare
объявления	annunci
известен	conosciuto
половина	metà
случаи	casi
шаг	passo
инжиниринг	ingegneria
просто	semplice
быстро	Presto
лицензия	licenza
озеро	lago
все	totale
годовой	annuale
опубликованный	pubblicato
церковь	Chiesa
метод	metodo
активный	attivo
ответ	risposta
фигура	figura
материалы	materiale
достаточно	abbastanza
предназначенный	progettato
среди	tra
смерть	Morte
потеря	perdita
лицо	viso
марка	marca
скидка	sconto
последствия	effetti
созданный	creato
стандарты	norme
немного	po
политическая	politico
Королевство	regno
база	base
дела	fare
кредитование	prestiti
обувь	scarpe
запись	iscrizione
оставаться	restare
заказы	ordini
доступность	disponibilità
резюме	sommario
очередь	turno
рост	crescita
агентство	agenzia
король	re
Европейская	europeo
Мероприятия	attività
копия	copia
вестерн	occidentale
сила	vigore
занятость	occupazione
залив	baia
река	fiume
комиссия	commissione
пакет	pacchetto
видели	visto
игроки	Giocatori
двигатель	motore
порт	porta
альбом	album
региональный	regionale
стоп	Stop
начал	iniziato
администрация	amministrazione
бар	bar
институт	istituto
Просмотры	visualizzazioni
двойной	Doppio
собака	cane
скоро	presto
линии	Linee
электронный	elettronico
выгоды	benefici
необходимый	necessaria
принтер	stampante
состояние	condizione
эффективный	efficace
верить	credere
организация	organizzazione
эффект	effetto
разум	mente
выбор	selezione
казино	casinò
PDF	PDF
тур	giro
пересекать	attraversare
надежда	speranza
корпорация	società
желание	desiderio
решение	soluzione
зрелый	maturo
роль	ruolo
недель	settimane
определенный	certo
ниже	inferiore
необходимо	necessario
союз	unione
понедельник	mon
ком	com
конкретный	particolare
отлично	bene
час	ora
газ	gas
навыки	abilità
шесть	sei
куст	cespuglio
острова	isole
совет	consigli
карьера	carriera
решение	decisione
оставлять	partire
до	pre
огромный	enorme
женщина	donna
оборудование	strutture
предложение	offerta
средний	mezzo
кабель	cavo
возможности	opportunità
принятие	presa
значения	valori
деление	divisione
приход	venuta
объект	oggetto
лесбиянка	lesbica
подходящее	adeguata
машина	macchina
логотип	logo
длина	lunghezza
хороший	simpatico
Гол	Punto
статистика	statistica
клиент	cliente
образец	campione
инвестиции	investimento
послал	inviato
показанный	mostrato
рождество	Natale
культура	cultura
вспышка	veloce
Миз	Signorina
выбор	scelta
курсы	corsi
потребитель	consumatore
Здравствуй	Ciao
иностранные	straniero
художник	artista
мебель	mobilia
канал	canale
письмо	lettera
Режим	modalità
телефоны	telefoni
идеи	idee
состав	struttura
степень	grado
контракт	contrarre
супер	super
мужской	maschio
дело	importa
почти	quasi
располагается	collocato
множественный	multiplo
распределение	distribuzione
редактор	editore
гостиница	Locanda
промышленные	industriale
потенциал	potenziale
песня	canzone
лос	los
падать	autunno
идея	idea
номера	camere
связь	comunicazioni
выиграть	vincere
первичный	primario
рак	cancro
чисел	numeri
причина	ragionare
инструмент	strumento
весна	primavera
Фонд	fondazione
ответ	risposta
голос	voce
график	programma
документы	documenti
цель	scopo
особенность	caratteristica
постель	letto
выходит	viene
полиция	polizia
независимый	indipendente
подход	approccio
коричневый	Marrone
физическое	fisico
холм	collina
карты	mappe
держать	tenere
рейтинги	giudizi
счастливый	contento
кузнец	fabbro
развитая	sviluppato
спасибо	grazie
безопасно	sicuro
уникальный	unico
опрос	sondaggio
предшествующий	precedente
телефон	telefono
спорт	sport
готов	pronto
животное	animale
источники	fonti
Население	popolazione
папа	papà
регулярный	regolare
безопасный	sicuro
операции	operazioni
просто	semplicemente
доказательства	prova
станция	stazione
Понимаю	capire
вариант	opzione
долина	valle
вероятно	probabilmente
море	mare
публикации	pubblicazioni
улучшать	Migliorare
соединение	connessione
издатель	editore
зал	sala
анти	anti
сети	reti
Земля	terra
родители	genitori
влияние	urto
перевод	trasferimento
введение	introduzione
кухня	cucina
сильный	forte
свадьба	nozze
свойства	proprietà
больница	ospedale
земля	terra
корабль	nave
жилье	alloggio
болезнь	malattia
отлично	eccellente
идеально	perfezionare
волосы	capelli
возможность	opportunità
Комплект	kit
классический	classico
основа	base
команда	comando
города	città
экспресс	esprimere
награда	premio
расстояние	distanza
дерево	albero
оценка	valutazione
стена	parete
участвует	coinvolti
эль	EL
дополнительный	extra
особенно	particolarmente
бюджет	bilancio
направляющие	guide
успех	successo
максимальная	massimo
мама	mamma
операция	operazione
существующий	esistente
довольно	abbastanza
выбранный	selezionato
мальчик	ragazzo
ресторан	ristoranti
красивая	bellissimo
предупреждение	avvertimento
места	posizioni
лошадь	cavallo
голос	votazione
цветы	fiori
звезды	stelle
списки	liste
владелец	proprietario
животные	animali
пути	modi
сын	figlio
обеспечение	fornitura
правило	regola
Корпус	alloggiamento
принимает	prende
приносить	portare
каталог	Catalogare
Максимум	max
мама	madre
власть	autorità
сказал	detto
программа	programma
присоединился	Iscritto
вход	ingresso
стратегия	strategia
ноги	piedi
агент	agente
действительный	valido
современное	moderno
старшая	anziano
сексуальный	sexy
обучение	insegnamento
дверь	porta
большой	grande
испытание	prova
единицы	unità
круто	freddo
нормальный	normale
предприятие	impresa
судов	navi
все	intero
положительный	positivo
фитнес	fitness
Китайский	Cinese
мнение	opinione
футбол	calcio
Абстрактные	astratto
вывод	produzione
фонды	fondi
Мистер	Sig
вероятно	probabile
развивать	sviluppare
художники	artisti
альтернатива	alternativa
обязанность	responsabilità
Ява	Giava
гость	ospite
публикация	pubblicazione
проходить	passaggio
связи	relazioni
доверять	fiducia
фургон	furgone
содержит	contiene
много	Multi
республика	repubblica
сборы	tasse
компоненты	componenti
отпуск	vacanza
века	secolo
академический	accademico
помощь	assistenza
завершено	completato
кожа	pelle
графика	grafica
индийский	indiano
кольцо	squillare
класс	grado
гора	montagna
организации	organizzazioni
фильтр	filtro
панель	pannello
пол	pavimento
покупка	acquisto
совпадение	incontro
предложенный	proposto
требовать	richiedere
мальчиков	ragazzi
утро	mattina
позволяет	consente
белок	proteina
растение	pianta
сообщается	segnalati
удар	colpire
мм	mm
бассейн	piscina
мини	mini
политика	politica
партнер	compagno
авторы	autori
доски	tavole
рыба	pesce
членство	membri
миссия	missione
глаз	occhio
строка	stringa
смысл	senso
модифицированный	modificata
выпущенный	rilasciato
сцена	palcoscenico
внутренний	interno
Родился	Nato
подробный	dettagliato
Японский	giapponese
раса	gara
утвержденный	approvato
цель	bersaglio
Кроме	tranne
персонаж	carattere
поддержание	Manutenzione
способность	capacità
издание	Ed
изнасилование	stupro
аккумулятор	batteria
молодежь	gioventù
давление	pressione
Отправлено	presentata
долг	debito
средний	medio
телевидение	televisione
заинтересованный	interessato
ядро	nucleo
ломать	rompere
цели	scopi
наборы	imposta
танец	danza
дерево	legna
определенный	definito
документы	documenti
награды	premi
плата	tassa
студия	studio
читатель	lettore
устройство	dispositivo
установленный	stabilito
ответы	risposte
аренда	affitto
лас	las
темно	buio
внешний	esterno
яблоко	Mela
ле	Le
инструкции	Istruzioni
мин	min
предложенный	offerta
теория	teoria
Удалить	rimuovere
помощь	aiuto
визуальный	visivo
хозяин	ospite
разнообразие	varietà
учителей	insegnanti
руководство	Manuale
блок	bloccare
предметы	soggetti
агенты	agenti
ремонт	riparazione
Справедливая	giusto
стали	acciaio
понимание	comprensione
песни	canzoni
исправлено	fisso
неправильно	sbagliato
начало	inizio
Руки	mani
Аризона	az
Париж	Parigi
получает	prende
сектор	settore
вместимость	capacità
ООН	un
жир	Grasso
отец	padre
электрический	elettrico
увидел	sega
инструменты	strumenti
сотрудник	ufficiale
Водитель	autista
бизнес	aziende
мертвый	morto
неизвестный	sconosciuto
ресторан	ristorante
Майк	Mike
поездка	viaggio
ми	mi
бедные	povero
отношения	relazione
рабочие	lavoratori
мир	pace
традиционный	tradizionale
показ	mostrando
творческий	creativo
берег	costa
выгода	vantaggio
финансирование	finanziamento
приборы	dispositivi
господин	signore
даровать	concedere
суб	sub
фантастика	finzione
часы	orologi
карьера	carriere
идет	va
светодиод	guidato
музей	Museo
поклонник	fan
транспорт	trasporto
интересно	interessante
блоги	blog
оценка	valutazione
бывший	ex
зона	zona
сложный	complesso
го	esimo
Кот	gatto
умереть	morire
представленный	presentata
квартира	piatto
течь	flusso
агентства	agenzie
литература	letteratura
родитель	genitore
установка	ambientazione
доктор	dr
масштаб	scala
экономика	economia
полезный	utile
ежемесячно	mensile
критический	critico
Рамка	telaio
музыкальный	musicale
определение	definizione
секретарь	segretario
дорожка	sentiero
главный	capo
дает	dà
пакеты	Pacchetti
подробно	dettaglio
законы	legislazione
изменено	cambiato
начать	inizio
королевский	reale
чистый	pulito
парень	tipo
названия	titoli
Соответствующий	pertinente
справедливость	giustizia
соединять	Collegare
кружка	tazza
корзина	cestino
прикладная	applicato
еженедельно	settimanalmente
об	vol
монтаж	installazione
стр	pp
внимание	Attenzione
продвижение	avanzare
пропускать	Salta
диета	dieta
армия	esercito
шестерня	Ingranaggio
разница	differenza
позволил	permesso
верный	corretta
нация	nazione
продажа	vendita
много	molte
кусок	pezzo
лист	foglio
фирма	azienda
Семь	Sette
элементы	elementi
вид	specie
Прыгать	saltare
ячейки	cellule
модуль	modulo
курорт	ricorrere
сертификат	certificato
министр	ministro
движение	movimento
мода	moda
направления	indicazioni
посетители	visitatori
документация	documentazione
торговый	commercio
лес	foresta
звонки	chiamate
покрытие	copertura
пара	coppia
дающий	dando
шанс	opportunità
видение	visione
мяч	palla
окончание	fine
клиенты	clienti
действия	Azioni
обсуждать	discutere
Цель	obbiettivo
успешный	riuscito
продан	venduto
ветер	vento
сообщества	comunità
клиническая	clinico
ситуация	situazione
рынки	mercati
издательский	editoriale
появиться	apparire
развивающийся	sviluppando
жизни	vite
определить	determinare
температура	temperatura
объявления	annunci
пациент	paziente
фактический	effettivo
исторический	storico
камень	pietra
боб	peso
коммерция	commercio
лиц	persone
сложно	difficile
научный	scientifico
спутник	satellitare
тесты	test
деревня	villaggio
Счета	conti
любитель	dilettante
бывший	ex
встретил	incontrato
боль	dolore
факторы	fattori
кофе	caffè
покупатель	acquirente
плакат	manifesto
край	bordo
функциональная	funzionale
корень	radice
фи	fi
закрыто	chiuso
каникулы	vacanze
розовый	rosa
баланс	equilibrio
мониторинг	monitoraggio
ответы	risposte
выстрел	tiro
начальная	iniziale
метка	etichetta
сек	secondo
канон	canone
лига	lega
отходы	rifiuto
минут	minuto
автобус	autobus
поставщик	fornitore
Словарь	dizionario
учет	contabilità
производство	produzione
разделы	sezioni
стул	sedia
усилие	sforzo
фаза	fase
фантазия	fantasia
ро	Po
в	va
профессор	Professore
устанавливать	installare
Рубашка	camicia
одежда	abbigliamento
фут	piede
грудь	Seno
методы	tecniche
долларов	dollari
религия	religione
разрешение	autorizzazione
дикий	selvaggio
поколение	generazione
Мисс	Perdere
химическая	chimico
врач	medico
задача	compito
уменьшить	ridurre
привел	portato
упражнение	esercizio
ошибка	insetto
гарантия	garanzia
лидер	capo
се	SE
процессы	processi
мягкий	morbido
встречи	incontri
секунд	secondi
рейс	volo
конгресс	congresso
топливо	carburante
ходить	camminare
произведенный	prodotta
святой	santo
аргумент	discussione
соревнование	concorrenza
наркотики	farmaci
совместный	comune
премия	premio
свежий	fresco
персонажи	personaggi
адвокат	procuratore
ди	di
фактор	fattore
тысячи	migliaia
км	km
поток	ruscello
апартаменты	appartamenti
выбирать	raccogliere
слух	udito
восточный	orientale
терапия	terapia
записи	inserimenti
подписанный	firmato
административный	amministrativo
серьезный	grave
предел	limite
меры	passaggi
магазины	negozi
зависимость	servitù
дель	del
усилия	sforzi
проинформировал	informato
Джорджия	ga
мысли	pensieri
ручей	torrente
фут	ft
количество	quantità
существенный	essenziale
туры	tour
нагрузка	caricare
немедленно	subito
машины	macchine
назначенный	designato
тяжелый	pesante
покрытый	coperto
восстановление	recupero
интегрированный	integrato
конфигурация	configurazione
петух	cazzo
торговец	mercante
комплексный	globale
эксперт	esperto
защищать	proteggere
твердый	solido
презентация	presentazione
стал	divenne
оранжевый	arancia
соблюдение	conformità
тема	tema
богатые	ricco
кампания	campagna
против	vs
гитара	chitarra
обнаружение	scoperta
Примеры	esempi
дух	spirito
Арканзас	ar
требования	reclami
принятие	accettazione
стратегии	strategie
мо	momento
дела	affari
предназначена	destinato
са	sa
цели	obiettivi
Наем	assumere
выборы	elezione
предлагать	suggerire
филиал	ramo
обслуживать	servire
филиалы	affiliati
крепление	montare
латинский	latino
мультимедиа	multimedia
управлять	gestire
угол	angolo
ранг	rango
элемент	elemento
рождение	nascita
вирус	virus
интерактивный	interattivo
Запросы	richieste
отдельный	separato
четверть	trimestre
процедура	procedura
руководство	comando
определять	definire
религиозная	religioso
факты	fatti
завтрак	colazione
колонка	colonna
вера	fede
цепь	catena
идентифицировать	identificare
проспект	viale
отсутствует	mancante
рекомендации	raccomandazioni
переехал	mosso
достичь	raggiungere
сравнение	confronto
момент	momento
расширенный	esteso
последовательность	sequenza
дюймовый	pollice
атака	attacco
центры	centri
открытие	apertura
лаборатория	laboratorio
резерв	Riserva
гамма	gamma
производить	produrre
правда	verità
счетчик	contatore
отказ	fallimento
следует	segue
доллар	dollaro
лагерь	campo
дез	des
фильмы	cinema
мост	ponte
заполнить	riempire
движение	movimento
печать	stampa
проект	bozza
диаграмма	grafico
играл	giocato
контакты	contatti
читатели	lettori
клубы	club
Вашингтон	wa
приключение	avventura
предложение	offerta
прибыль	profitto
лидеры	capi
плакаты	manifesti
учреждения	istituzioni
помощник	assistente
переменная	variabile
диджей	dj
стоянка	parcheggio
вчера	ieri
определенный	determinato
мастерская	laboratorio
прошло	andato
коды	codici
виды	tipi
расширение	estensione
заявления	dichiarazioni
полностью	completamente
команды	squadre
форт	forte
см	centimetro
сенат	senato
веселая	divertente
ген	gene
оказалось	trasformato
диск	disco
шаблон	modello
лодка	barca
театр	Teatro
производители	produttori
спонсор	sponsor
классический	classico
значок	icona
гарантия	garanzia
преданный	dedito
направление	direzione
баскетбол	pallacanestro
объекты	oggetti
Удалить	Elimina
вечер	sera
сборка	montaggio
ядерной	nucleare
мышь	topo
сигнал	segnale
преступник	penale
выпущен	rilasciato
мощный	potente
мечта	sognare
ЛОЖНЫЙ	FALSE
да	da
бросать	lanciare
цветок	fiore
персонал	personale
прошло	passato
поставляется	fornito
падения	cascate
душа	anima
содействовать	promuovere
заявил	dichiarato
статистика	statistiche
профессионалов	professionisti
появляется	appare
нести	trasportare
флаг	bandiera
крышки	coperture
Эм	em
преимущество	vantaggio
Здравствуйте	Ciao
конструкции	disegni
поддерживать	mantenere
туризм	turismo
приоритет	priorità
Взрослые	adulti
графический	grafico
атом	atomo
платежи	pagamenti
переплет	rilegatura
краткое	breve
закончился	conclusa
выигрыш	vincente
анонимный	anonimo
скрипт	copione
служил	servito
хочет	vuole
подготовленный	preparato
недействительным	vuoto
тег	etichetta
интервью	colloquio
смешивание	mescolare
фреймворк	struttura
диск	disco
установлен	installato
Королева	Regina
кредиты	crediti
явно	chiaramente
фиксировать	fissare
ручка	maniglia
милая	dolce
критерии	criteri
ассоциировать	socio
Небраска	NE
поведение	comportamento
увеличить	Ingrandire
луч	raggio
доход	reddito
измерение	misurare
голосов	voti
дю	du
обязанность	dovere
обсуждение	discussioni
медведь	orso
усиление	guadagno
фестиваль	Festival
лаборатория	laboratorio
океан	oceano
рейсы	voli
эксперты	esperti
знаки	segni
глубина	profondità
поезд	treno
сухой	asciutto
исследовать	Esplorare
спа	terme
концепция	concetto
около	quasi
обращение	maneggio
происхождения	origine
миллиард	miliardo
интеллект	intelligenza
купил	comprato
против	contro
нации	nazioni
маршрут	itinerario
сломанный	rotto
боевой	battaglia
говорить	parlare
протокол	protocollo
запрос	domanda
партнерство	associazione
выражение	espressione
эс	es
речь	discorso
провод	filo
предложения	suggerimenti
замена	sostituzione
лента	nastro
стратегическое	strategico
судья	giudice
кислота	acido
байтов	byte
цент	centesimo
принудительный	costretto
совместимый	compatibile
квартира	appartamento
ноль	nullo
нуль	zero
оратор	altoparlante
консалтинг	consulenza
дизайнер	progettista
пр	pr
брак	matrimonio
рулон	rotolo
банки	banche
фр	fr
участники	partecipanti
секрет	segreto
отрицательный	negativo
избранное	preferiti
театр	Teatro
пружины	molle
вар	var
выполнять	eseguire
перевод	traduzione
оценки	stime
травма	ferita
министерство	ministero
водители	driver
адвокат	avvocato
цифры	figure
защищенный	protetta
предложение	proposta
разделение	compartecipazione
портал	portale
бета	beta
бесплатно	gratis
к	verso
немного	leggermente
помощь	assistere
поведение	condotta
содержащиеся	contenuta
законодательство	legislazione
призвание	chiamata
параметры	parametri
профили	profili
вопросы	questioni
дома	case
управления	controlli
комбинированный	combinato
окончательный	finale
представитель	rappresentante
незначительный	minore
ведомства	dipartimenti
жители	residenti
отображается	visualizzati
Мама	mamma
уменьшенный	ridotto
редкий	raro
выполнено	eseguita
экстремальный	estremo
образцы	campioni
брусья	barre
прогноз	previsione
удален	rimosso
цикл	ciclo
содержать	contenere
точность	precisione
спать	dormire
мг	mg
птица	uccello
аптека	farmacia
создание	creazione
статический	statico
охотник	cacciatore
адреса	indirizzi
леди	signora
кристалл	cristallo
известный	famoso
писатель	scrittore
председатель	presidente
напиток	bere
академия	accademia
динамический	dinamico
есть	mangiare
постоянный	permanente
уборка	pulizia
составляет	costituisce
портфолио	portafoglio
практическое	pratico
доставлен	consegnato
инфраструктура	infrastruttura
цвет	colore
продавец	venditore
философия	filosofia
регулирование	regolamento
офицеры	ufficiali
цель	scopo
предложения	offerte
питание	nutrizione
запись	registrazione
младший	junior
ле	les
мыс	mantellina
кольца	anelli
наконечник	mancia
замечательно	meraviglioso
билет	biglietto
объявленный	annunciato
Угадай	indovina
кого	chi
футбольный	calcio
математический	matematica
Импортировать	importare
проводка	spedizione
присутствие	presenza
автоматический	automatico
просмотр	visualizzazione
поддерживается	mantenuto
ч	ch
Дан	dan
собаки	cani
директора	registi
аспекты	aspetti
впереди	avanti
Луна	Luna
участие	partecipazione
схема	schema
летать	volare
манера	maniera
матрица	matrice
сочетание	combinazione
поправка	emendamento
прочность	forza
Турция	tacchino
библиотеки	librerie
правильный	corretto
степени	gradi
предприятия	aziende
дельта	delta
страх	paura
Ищу	cerca
дюймов	pollici
условность	convenzione
акции	azioni
главный	principale
комфорт	comfort
цвета	colori
войны	guerre
заказ	ordinazione
хранится	tenuto
альфа	alfa
обращение	appello
круиз	crociera
бонус	indennità
Привет	Hey
здания	edifici
скидки	Speciali
бить	battere
батареи	batterie
становится	diventa
диски	unità
оружие	braccia
чай	tè
улучшен	migliorata
достигать	raggiungere
позиции	posizioni
платье	vestito
подписка	sottoscrizione
дилер	commerciante
современный	contemporaneo
небо	cielo
ПЗУ	rom
осуществляется	trasportato
воздействие	esposizione
скрывать	nascondere
подпись	firma
мельник	mugnaio
обеспечение	fornitura
одежда	Abiti
кадры	montatura
безусловно	certamente
газета	giornale
игрушка	giocattolo
слой	strato
печатные	stampato
медленный	lento
удаление	rimozione
ответственность	responsabilità
принтеры	stampanti
добавление	aggiungendo
место	individuare
проводить	trascorrere
завод	fabbrica
интерьер	interno
расти	crescere
оптический	ottico
продвижение	promozione
относительный	parente
удивительно	Stupefacente
точка	punto
идентичность	identità
преобразование	conversione
чувство	sensazione
скрытый	nascosto
разумный	ragionevole
пересмотр	revisione
влияние	influenza
соотношение	rapporto
важность	importanza
дождь	pioggia
планета	pianeta
копии	copie
разрешать	permesso
видя	vedendo
доказательство	prova
бас	basso
рецепт	prescrizione
пустой	vuoto
пример	esempio
дыра	buco
поездка	cavalcata
бюро	ufficio
сохранение	conservazione
пара	paio
идеальный	ideale
функции	Specifiche
записанный	registrato
дон	don
куски	pezzi
законченный	finito
парки	parchi
адвокаты	avvocati
стресс	stress
крем	crema
сс	ss
работает	piste
обнаружить	scoprire
ар	ap
узоры	modelli
холмы	colline
нм	nm
консультант	consulente
знать	consapevole
форма	forma
эволюция	Evoluzione
сертификаты	certificati
цели	obiettivi
станций	stazioni
предложенный	suggerito
оп	operazione
остатки	resti
фирмы	aziende
евро	Euro
оператор	operatore
сооружения	strutture
общий	generico
энциклопедия	enciclopedia
Применение	uso
чернила	inchiostro
смешанный	misto
перепись	censimento
колесо	ruota
поставщики	fornitori
компактный	compatto
поэзия	poesia
огни	luci
отслеживание	puntamento
ангел	angelo
подготовка	preparazione
попытка	tentativo
получение	ricevente
Матчи	fiammiferi
соответствие	conformità
ширина	larghezza
двигатели	motori
забывать	dimenticare
массив	schieramento
обсуждается	discusso
точный	preciso
климат	clima
греческий	greco
инструкция	istruzione
управление	gestione
сырье	crudo
различия	differenze
объяснять	spiegare
установить	stabilire
выраженный	espresso
степень	estensione
острый	acuto
Бен	Ben
параграф	paragrafo
убийство	uccidere
математика	matematica
компенсация	compensazione
экспорт	esportare
менеджеры	manager
модули	moduli
проведены	condotto
версии	versioni
знает	conosce
описывать	descrivere
граждане	cittadini
наследие	eredità
беда	guaio
тренер	allenatore
сельскохозяйственное	agricolo
расширять	espandere
аудитория	pubblico
назначенный	assegnato
коллекции	collezioni
возраст	evo
специалист	specialista
готовить	cucinare
аффект	influenzare
девственница	vergine
опытный	esperto
расследование	indagine
поднятый	sollevato
шапка	cappello
учреждение	istituzione
направленный	dirette
пострадавших	influenzato
велосипед	bicicletta
полностью	totalmente
пластина	piatto
затраты	spese
указывать	indicare
блондинка	bionda
производство	procedimento
любимый	preferito
характеристики	caratteristiche
дер	der
потерять	perdere
органический	biologico
искать	ricercare
опыт	esperienze
альбомы	album
контракты	contratti
гости	ospiti
состоялся	ospitato
болезни	malattie
относительно	circa
эквивалент	equivalente
химия	chimica
комплекты	kit
логика	logica
принц	Principe
круг	cerchio
почва	suolo
психология	psicologia
влажный	bagnato
обстоятельства	condizioni
инвестор	investitore
элементарный	elementare
спонсоры	sponsor
лиса	Volpe
неограниченный	illimitato
отвечать	rispondere
размеры	dimensioni
гладкий	pianura
Выход	Uscita
рука	braccio
ключи	chiavi
волна	onda
святой	santo
акты	atti
руководство	guida
след	pista
символ	simbolo
шоссе	autostrada
наблюдаемый	osservata
декан	decano
настроить	impostare
голосование	sondaggio
стили	stili
заполненный	pieno
связь	legame
каналы	canali
приложение	appendice
шоколад	cioccolato
часть	porzione
объем	scopo
поставщик	fornitore
кабели	cavi
хлопок	cotone
требование	Requisiti
убитый	ucciso
граница	confine
древний	antico
обсуждение	discussione
представители	rappresentanti
начинается	inizia
беременность	gravidanza
достопримечательности	attrazioni
научился	imparato
операции	transazioni
исследователь	esploratore
исторический	storico
муж	marito
уполномоченный	autorizzato
псих	pazzo
предстоящий	imminente
концерт	concerto
множество	punteggi
эффективность	efficienza
комедия	commedia
принят	adottato
эффективное	efficiente
линейный	lineare
обязательство	impegno
специальность	specialità
медведи	orsi
хмель	luppolo
перевозчик	vettore
постоянная	costante
виза	Visa
рот	bocca
метр	metro
связанный	connesso
интервью	interviste
концепции	concetti
пистолет	pistola
отражать	riflettere
чистый	puro
ад	inferno
фрукты	frutta
начинается	inizia
квалифицированный	qualificato
реформа	riforma
объектив	lente
обрабатывали	trattati
открытие	scoperta
привлечь	disegnare
объявление	classificato
предполагать	assumere
союз	alleanza
подтвердить	Confermare
инженер	ingegnere
последовательный	coerente
замещать	sostituire
зазор	autorizzazione
конвертер	convertitore
организация	organizzazione
младенец	bambino
проверки	controlli
достиг	raggiunto
становление	diventando
задача	obbiettivo
указанный	indicato
сахар	zucchero
экипаж	equipaggio
ноги	gambe
придерживаться	bastone
связь	relazione
включен	abilitato
жанр	genere
доброволец	volontario
задний	posteriore
демократической	democratico
усилить	accrescere
точный	esatto
связанный	limite
параметр	parametro
процессор	processore
узел	nodo
формальный	formale
буря	tempesta
микро	micro
колледжи	collegi
мили	miglio
проблемы	sfide
редакторы	redattori
высший	supremo
братья	fratelli
признание	riconoscimento
ссылка	arbitro
оценить	stima
дитя	ragazzo
осмотр	ispezione
потребители	consumatori
пределы	limiti
территория	territorio
оружие	Armi
задержка	ritardo
пилот	pilota
взносы	contributi
непрерывный	continuo
инициатива	iniziativa
роман	romanzo
выполнение	esecuzione
инвалидность	invalidità
ультра	ultra
победитель	vincitore
эпизод	episodio
гончар	vasaio
блюдо	piatto
игры	giochi
бюллетень	bollettino
Айова	ia
модифицировать	modificare
действительно	veramente
вселенная	universo
кандидат	candidato
слот	fessura
выдающийся	eccezionale
ха	ah
планируемый	pianificato
домик	casetta
зеркало	specchio
турнир	torneo
рассмотрение	considerazione
сессий	sessioni
ядро	nocciolo
покупатели	acquirenti
журналы	riviste
серый	grigio
каталог	Catalogare
заряженный	carico
широкий	ampio
унд	und
выбранный	scelto
демонстрация	dimostrazione
ненавидеть	odiare
Терминал	terminale
издатели	editori
ночью	notti
жидкость	liquido
рис	riso
бронирование	prenotazione
продукты	Alimenti
охрана	guardia
экономия	Salvataggio
империя	impero
вновь	recentemente
повышение	aumentare
нелегальный	illegale
расширение	espansione
премьер	premier
завтра	Domani
молоко	latte
драма	Dramma
посещение	visitare
конкурс	concorso
собранный	raccolto
группы	bande
подходящее	adatto
абсолютно	assolutamente
аудит	revisione
камера	Camera
Гвинея	Guinea
Выводы	risultati
ISO	iso
типичный	tipico
сумма	somma
курица	pollo
временный	temporaneo
посещать	assistere
душ	doccia
отправка	invio
достаточно	sufficiente
оболочка	conchiglia
провинция	Provincia
католик	cattolico
губернатор	governatore
пиво	birra
вклад	contributo
формула	formula
конституции	costituzione
упаковка	confezione
надежный	affidabile
сомнение	dubbio
зарабатывать	guadagnare
периодов	periodi
нападки	attacchi
товар	merce
симптомы	sintomi
мемориал	memoriale
близнец	gemello
вставить	inserire
шлюз	porta
Рисование	disegno
кандидаты	candidati
приказал	ordinato
биологический	biologico
борьба	combattente
переход	transizione
предпочтения	preferenze
шпион	spiare
романс	romanza
инструмент	strumento
Трещина	Diviso
темы	temi
полномочия	potenze
небо	Paradiso
биты	bit
беременная	incinta
классификация	classificazione
сосредоточены	focalizzata
врач	medico
просить	chiede
блоки	blocchi
вот	Lo
духовный	spirituale
диабет	diabete
мл	ml
сдвиг	cambio
сидеть	sedersi
тела	corpi
фотографии	fotografie
резка	taglio
писатели	scrittori
гибкий	flessibile
любимый	amato
избранное	preferiti
отображение	Mappatura
многочисленные	numerose
относительно	relativamente
представляет	rappresenta
превосходящий	superiore
предпочтительным	preferito
сохранены	salvato
интеллектуальной	intellettuale
предоставляется	concesso
углерод	carbonio
удобный	confortevole
магнитные	magnetico
взаимодействие	interazione
прослушивание	ascoltando
кризис	crisi
прогноз	prospettiva
массивный	massiccio
яркий	luminosa
сформированный	formato
пианино	pianoforte
эхо	eco
революция	rivoluzione
дисплеи	visualizza
плазма	plasma
прибыль	guadagni
тайна	mistero
пейзаж	paesaggio
механический	meccanico
поездка	viaggio
баннер	bandiera
инжир	Figura
графств	contee
получение	acquisizione
признанное	riconosciuto
мечты	sogni
уведомление	notifica
кг	kg
учат	insegnare
быстрый	rapido
вытащить	Tirare
Юта	ut
семинар	seminario
вложения	investimenti
колеса	ruote
указывать	specificare
чувствительный	sensibile
шаблоны	modelli
форматы	formati
держит	detiene
маршрутизатор	router
бетон	calcestruzzo
си	SI
папка	cartella
завершение	completamento
пульс	impulso
техника	tecnica
голосование	voto
суды	tribunali
переоборудованный	convertito
метро	Metro
Годовщина	anniversario
улучшения	miglioramenti
полоса	striscia
Спецификация	specificazione
авария	incidente
Ник	tacca
доступной	accessibile
резидент	residente
сюжет	tracciare
типично	tipicamente
представление	rappresentazione
насос	pompa
существует	esiste
договоренности	accordi
конференций	conferenze
потребление	consumo
узкий	stretto
угроза	minaccia
опросы	sondaggi
сидящий	seduta
консультант	consulente
контроллер	controllore
комитеты	comitati
пенис	pene
замок	castello
сады	giardini
этикетки	etichette
готовы	disposto
био	bio
действующий	recitazione
руководители	teste
экзамен	esame
резиденция	residenza
плотность	densità
сто	centinaio
странный	strano
устойчивый	sostenibile
статистический	statistico
упомянуть	citare
инновация	innovazione
серый	grigio
параллельно	parallelo
работать	operare
банкноты	fatture
стабильный	stabile
определения	definizioni
фон	von
врачи	medici
урок	lezione
кино	cinema
выборы	elezioni
реакция	reazione
пустой	vuoto
повышенная	migliorata
озаглавленный	intitolato
серьезный	grave
генерировать	creare
газеты	giornali
больницы	ospedali
VI	VI
юмор	umorismo
престарелый	anziano
мониторы	monitor
исключение	eccezione
продолжительность	durata
насыпной	massa
посещения	visite
возможности	capacità
рекомендация	raccomandazione
грех	peccato
организованная	organizzato
ба	ba
пункт	parà
принятие	adozione
улучшение	miglioramento
дорогая	costoso
буйвол	bufalo
организации	organizzazioni
самолет	aereo
программы	programmi
механизм	meccanismo
й	EE
отмеченный	segnato
управляемый	guidato
бутылка	bottiglia
инновационный	innovativo
массаж	massaggio
вывод	conclusione
закрытие	chiusura
тысяча	mille
легенда	leggenda
вилла	villa
кость	osso
столбцы	colonne
расстройства	disturbi
сотрудничество	collaborazione
обнаружение	rivelazione
внутренний	interno
образование	formazione
мед	med
инженеры	ingegneri
организация	entità
круизы	crociere
Ворота	cancello
Римский	romano
обязанности	doveri
эротический	erotico
тон	tono
этика	etica
Дракон	Drago
занятый	occupato
капитан	Capitano
приносит	porta
обогрев	riscaldamento
ножка	gamba
шея	collo
крыло	ala
скрипты	script
азбука	abc
назначенный	designato
дело	rapporti
совершить	commettere
рельс	rotaia
поездки	viaggi
разрыв	divario
стороны	lati
трубка	tubo
соответствующий	corrispondente
описания	descrizioni
ремень	cintura
куртка	giacca
анимация	animazione
оракул	oracolo
эр	er
производства	produzioni
авиация	aviazione
гордый	orgoglioso
катастрофа	disastro
консоль	consolle
команды	comandi
младший	jr
связь	telecomunicazioni
инструктор	istruttore
гигант	gigante
достигнутый	raggiunto
травмы	lesioni
подходы	approcci
обычный	solito
Марки	francobolli
угол	angolo
грабить	rapinare
дизайнеры	progettisti
свобода	libertà
эпоха	era
конвертировать	convertire
возможность	possibilità
аналитик	analista
опасно	pericoloso
надежность	affidabilità
соответственно	rispettivamente
добровольцы	volontari
полученный	derivato
удовольствие	piacere
честь	onore
ориентированного	orientata
орел	aquila
молитва	preghiera
мастерские	workshop
ураган	uragano
тихо	silenzioso
режиссер	produttore
представленный	rappresentato
обязанности	responsabilità
сыр	formaggio
внимательно	accuratamente
производительность	produttività
корона	corona
паритет	par
диагностика	diagnosi
производитель	creatore
трещина	crepa
принцип	principio
кирки	picconi
банда	banda
фетиш	feticcio
появление	aspetto
дым	Fumo
фильтры	filtri
включенный	incorporato
ремесло	mestiere
человек	compagno
слепой	cieco
гостиная	sala
Сумасшедший	pazzo
алгоритм	algoritmo
сильно	fortemente
кафе	bar
кругозор	comprensione
белки	proteine
су	su
знакомые	familiare
способный	capace
вход	ammissione
башмак	scarpa
избран	eletto
проведение	portando
терроризм	terrorismo
радость	gioia
издания	edizioni
этнической	etnico
парламент	parlamento
актер	attore
находки	reperti
печать	foca
ситуации	situazioni
пятый	quinto
гражданин	cittadino
вертикальный	verticale
поправки	correzioni
описывает	descrive
инвалидов	disabilità
вещество	sostanza
запрещено	proibito
труба	tubo
солдаты	soldati
опекун	custode
лекция	conferenza
моделирование	simulazione
расположение	disposizione
инициативы	iniziative
больной	malato
концентрация	concentrazione
прокладывать	posare
интерпретация	interpretazione
грязный	sporco
учил	insegnato
работник	lavoratore
оптимизация	ottimizzazione
храм	tempio
вещества	sostanze
доказывать	dimostrare
обнаруженный	scoperto
крылья	Ali
генетический	genetico
ограничения	restrizioni
тонкий	magro
выставка	esposizione
хребет	cresta
модем	modem
приведение	portando
больной	malato
оценивать	valutare
тропический	tropicale
собирать	raccogliere
вектор	vettore
определенно	decisamente
превращение	svolta
существование	esistenza
комментарий	commento
события	sviluppi
иммиграция	immigrazione
направления	destinazioni
взаимное	reciproco
синтаксис	sintassi
литий	Li
атрибут	attributo
тюрьма	prigione
умение	abilità
стулья	sedie
окружающих	circostante
горы	montagne
популярность	popolarità
запрос	inchiesta
проверено	verificato
экспонат	mostra
бросать	gettare
тенденция	tendenza
коты	gatti
пустыня	deserto
я	ya
координатор	coordinatore
Меркурий	mercurio
сжигание	ardente
побег	fuga
получатель	ricevitore
прогрессирующий	progressivo
лодки	Barche
чемпионат	campionato
аркада	portico
невозможно	impossibile
говорит	dice
очевидный	evidente
депрессия	depressione
график	grafico
покрытие	copertura
платина	platino
суждение	giudizio
переговоры	trattativa
подача	limatura
способствовать	adottivo
награжден	premiato
испытания	prove
мастера	maestri
картридж	cartuccia
объяснение	spiegazione
организация	org
мошенничество	frode
электричество	elettricità
спектр	spettro
прибытие	arrivo
керамика	ceramica
акцент	enfasi
здорово	eccezionale
подтвердил	confermato
счетчики	conta
авария	schianto
лифт	sollevamento
между	Inter
высоты	altezza
тень	ombra
расходы	spese
предприятие	avventurarsi
клиника	clinica
исцеление	guarigione
принцесса	Principessa
входящий	entrare
пакет	pacchetto
студии	studios
участие	coinvolgimento
папа	papà
кнопки	pulsanti
размещение	posizionamento
наблюдения	osservazioni
победители	vincitori
дороги	strade
последующий	successivo
двор	cortile
раскрытие	rivelazione
создание	istituzione
воспоминания	ricordi
тэ	TE
создает	crea
лица	facce
турист	turista
убийство	omicidio
адекватный	adeguato
сенатор	senatore
презентации	presentazioni
дайджест	digerire
пыли	polvere
вики	wiki
заменены	sostituito
радиолокационный	radar
потери	perdite
бой	combattere
сокращение	riducendo
остановился	fermato
занятие	occupazione
тесно	strettamente
излучение	radiazione
короли	re
стрельба	tiro
ухо	orecchio
флаги	bandiere
пекарь	panettiere
консервативный	prudente
шок	shock
эффективность	efficacia
галстук	cravatta
крыша	tetto
демонстрировать	dimostrare
атмосфера	atmosfera
поцелуй	bacio
зверь	bestia
ра	RA
управляемый	operato
эксперимент	sperimentare
цели	obiettivi
покупки	acquisti
федерация	federazione
пицца	Pizza
приглашенный	invitato
назначение	assegnazione
модификация	mod
запросы	interrogazioni
отсутствие	assenza
поставщики	fornitori
йога	yoga
служит	servi
сюрприз	sorpresa
лампа	lampada
шутки	scherzi
консультирование	consulenza
дворец	palazzo
доволен	soddisfatto
победы	vittorie
склад	magazzino
предполагаемый	ipotetico
обычный	ordinario
призрак	fantasma
нарушение	violazione
босс	capo
гордость	orgoglio
ожидания	aspettative
независимость	indipendenza
знание	sapendo
репортер	reporter
метаболизм	metabolismo
чемпион	campione
лично	personalmente
много	abbondanza
соло	assolo
горло	gola
богатство	ricchezza
вакуум	vuoto
танцы	danza
признать	riconoscere
пишет	scrive
площадь	plaza
поиск	ricerca
публиковать	pubblicare
скрининг	selezione
транс	trans
пионер	pioniere
забытый	dimenticato
акробат	acrobata
тарелки	piatti
эссе	saggi
поведение	comportamento
говоря	raccontare
довольно	abbastanza
умный	intelligente
режимы	modalità
обязательство	obbligo
гавань	porto
путешественник	viaggiatore
сегмент	segmento
враг	nemico
головоломка	puzzle
углубления	pozzi
ограниченный	limitato
республиканец	repubblicano
секреты	segreti
синдром	sindrome
посещаемость	partecipazione
штраф	pena
барабан	tamburo
позволяет	Abilita
строитель	costruttore
перспектива	vista
наводнение	alluvione
легкость	alleviare
аргументы	argomenti
арена	arena
приключения	avventure
зрачки	allievi
объявление	annuncio
исход	risultato
ценить	apprezzare
расширенный	allargato
взрослый	cresciuto
прекрасный	bello
центры	centri
пункт	clausola
улыбка	Sorriso
земли	terre
войска	truppe
вооруженный	armato
сосна	pino
охлаждение	raffreddamento
залив	golfo
грузовики	camion
механизмы	meccanismi
развод	divorzio
традиция	tradizione
таблетки	pillole
тигр	tigre
люди	gente
датчик	sensore
подвергаются	esposto
охота	caccia
ангелы	angeli
заместитель	vice
тайский	tailandese
выбросы	emissioni
врачи	medici
жалоба	denuncia
сцены	scene
эксперименты	esperimenti
увеличение	Incremento
управление	governo
мельница	mulino
основанный	fondato
хронический	cronico
логово	tana
Палец	dito
держит	mantiene
фунт	libbra
разместить	individuare
пл	pl
обученный	allenato
реализации	attuazione
хлеб	pane
моторы	motori
жесткий	difficile
инцидент	incidente
динамика	dinamica
ложь	menzogna
разговор	conversazione
снижение	diminuire
поклонение	culto
возможность	capacità
Аляска	ak
точность	precisione
убытки	danni
резервы	riserve
решать	risolvere
меньшинство	minoranza
разнообразный	diverso
ингредиенты	ingredienti
ах	ah
тоны	toni
реабилитация	reinserimento
взгляд	vista
глина	argilla
слабый	debole
разделенный	diviso
прием	ricezione
мудрый	saggio
шансы	probabilità
семинары	seminari
последствия	conseguenze
производители	maker
география	geografia
целостность	integrità
наследие	eredità
довольный	contento
Опасность	Pericolo
витамин	vitamina
обработанный	trasformati
фраза	frase
привлечение	raccolta
последствия	implicazioni
функциональность	funzionalità
рай	Paradiso
гибридный	ibrido
читает	legge
эмоциональный	emotivo
слава	gloria
JA	ja
географический	geografico
превышать	superare
стержень	asta
шелк	seta
дети	bambini
би	bi
романтик	romantico
показал	rivelato
специалисты	specialisti
генератор	Generatore
подвеска	sospensione
грустный	triste
коррекция	correzione
волк	lupo
медленно	lentamente
дополнение	supplemento
участки	porzioni
младенец	infantile
секторов	settori
жидкость	fluido
основания	motivo
еда	pasto
та	ta
машины	macchinario
уравнение	equazione
корзины	cesti
вероятность	probabilità
измерение	dimensione
изучал	studiato
доходы	profitti
дьявол	diavolo
трава	erba
иллюстрированный	illustrato
вишня	ciliegia
континентальный	continentale
достижение	realizzazione
ограничения	limitazioni
похороны	funerale
главы	capitoli
пассажир	passeggeri
удобный	conveniente
Марс	Marte
размера	dimensioni
яйцо	uovo
сигналы	segnali
ориентация	orientamento
кража	furto
детство	infanzia
символы	simboli
Lat	lat
мета	meta
аналоговый	analogico
талант	talento
датированный	datato
мудрость	saggezza
граница	confine
элита	elite
солдат	gi
считает	crede
стихи	poesie
юрисдикция	Giurisdizione
робот	robot
отображение	visualizzazione
свидетель	testimone
оборудованный	fornito
этапы	stadi
сюр	sur
приобретенный	acquisita
оценить	valutare
мыть	lavaggio
вход	Ingresso
декларация	dichiarazione
проигрыш	perdere
попытки	tentativi
благородный	nobile
автоматизация	automazione
воздействие	impatti
оборот	rev
преимущества	vantaggi
рыцарь	cavaliere
цели	obiettivi
расширения	estensioni
апелляции	appelli
болезнь	malattia
эй	Ho
альтернативы	alternative
ш	sh
мыло	sapone
варенье	marmellata
необычный	insolito
ответил	risponde
разрушение	distruzione
миграция	migrazione
расстройство	disturbo
обычный	convenzionale
носить	indossare
ось	asse
искать	ricercato
гены	geni
медиана	mediano
сканер	scanner
здесь	qui
мультипликационный	animato
регулировка	registrazione
герой	eroe
лечение	trattamenti
отношение	atteggiamento
ковер	tappeto
линзы	lenti
участие	frequentato
трудность	difficoltà
панк	punk
коалиция	coalizione
регистрация	iscrizione
герцог	duca
темп	ritmo
производители	produttori
дуга	arco
интерфейсы	interfacce
атлас	atlante
наблюдение	osservazione
пытки	tortura
удаленный	cancellato
Пальто	cappotto
восстановление	restauro
удобство	convenienza
возврате	ritorno
оппозиция	opposizione
контейнер	contenitore
ответчик	imputato
руководитель	supervisore
корпус	corpo
актеры	attori
печень	fegato
подлежащий	responsabile
петиция	petizione
антенна	antenna
выбрал	raccolto
вера	credenza
убийство	uccisione
плечо	spalla
оформление	arredamento
ион	ione
диаметр	diametro
подкаст	Podcast
взаимодействия	interazioni
певец	cantante
вестник	araldo
старение	invecchiamento
вмешательство	intervento
плагин	collegare
Привлечение	attrazione
дайвинг	immersione
модификация	modifica
предполагать	supporre
тростник	canna
включать	coinvolgere
умеренный	moderare
мышей	topi
понимать	inteso
быстро	rapidamente
запрет	bandire
гарантия	garanzia
происходит	avvenimento
огромный	vasto
мельницы	mulini
контур	contorno
получает	riceve
джинсы	jeans
сборник	compilazione
странный	dispari
сигма	sigma
гр	gr
привлекательный	attraente
повод	occasione
записи	registrazioni
жертва	vittima
требования	richieste
осторожный	attento
луч	fascio
садоводство	giardinaggio
обязательства	obblighi
прибыть	arrivo
оркестр	orchestra
лицензия	licenza
регулируемый	regolabile
распределение	assegnazione
сочинение	tema
продемонстрировал	dimostrato
диалог	dialogo
лагеря	campi
объявленный	dichiarato
след	traccia
закрыть	chiuso
пакеты	confezioni
GE	ge
установка	installazione
переключатели	interruttori
добровольный	volontario
ты	tu
значительно	molto
нг	ng
обычно	comunemente
ре	pe
фотограф	fotografo
плакать	piangere
квант	quantistico
построенный	costruito
дополнения	aggiunte
требующий	richiedendo
стрела	freccia
помолвка	Fidanzamento
грубый	ruvido
странный	strano
лев	Leone
свадьбы	matrimoni
кислород	ossigeno
каньон	canyon
метры	metri
просто	semplicemente
календари	calendari
договоренность	preparativi
выводы	conclusioni
Библиография	bibliografia
указатель	pointer
совместимость	Compatibilità
протяжение	allungare
разрешения	permessi
кооператив	cooperativa
кормление	alimentazione
городок	municipalità
рейтинги	classifiche
измерения	misurazione
ремень	cinghia
толпа	folla
переводы	trasferimenti
олимпийский	olimpico
преобразование	trasformazione
реж	dir
обычаи	dogana
администраторы	amministratori
личность	personalità
крюк	gancio
рулетка	roulette
снижение	declino
шнур	cordone
облако	nube
содействовать	facilitare
вал	val
объясняет	spiega
продолжить	procedere
чувства	sentimenti
нож	coltello
принять	adottare
отказано	negato
пожертвование	donazione
внешний	esterno
культура	raccolto
реки	fiumi
узлы	nodi
цитируется	citato
хаб	mozzo
целевое	mirata
понял	realizzato
основатель	fondatore
десятилетие	decennio
спор	controversia
устала	stanco
неблагоприятный	avverso
выдержка	estratto
разряд	scarico
напитки	bevande
туз	asso
голоса	voci
альпинизм	arrampicata
тонны	tonnellate
духи	profumo
опасный	pericoloso
восстановить	ristabilire
стек	pila
методология	metodologia
репутации	reputazione
демократы	democratici
вешать	appendere
кривая	curva
создатель	Creatore
янтарный	ambra
музеи	musei
кодирование	codifica
трекер	inseguitore
изменение	variazione
прохождение	passaggio
переданы	trasferito
хобот	tronco
фотография	fotografia
волны	onde
верблюд	cammello
распределитель	distributore
чи	chi
сбор	raduno
проекция	proiezione
математическая	matematico
логический	logico
соус	salsa
известность	fama
специализированный	specializzato
корпорации	aziende
критика	critica
автомобиль	automobile
судьи	giudici
замечания	osservazioni
обнаруженный	rilevato
картины	dipinti
ходил	camminava
возникающий	derivante
популяции	popolazioni
боюсь	impaurito
акустическое	acustico
кассета	cassetta
индикатор	indicatore
JPG	jpg
ошибка	sbaglio
Устранить	eliminare
минеральная	minerale
Рубин	rubino
бисер	perline
состояние	fortuna
холст	tela
порог	soglia
приход	parrocchia
экраны	schermi
кладбище	cimitero
стадион	stadio
исследование	esplorazione
мин	min
стебель	stelo
астрономия	astronomia
конкурсы	concorsi
грипп	influenza
костюм	costume
велосипеды	Bici
епископ	vescovo
вытащил	tirato
кукуруза	Mais
компрессия	compressione
налаживание	stabilire
фермер	contadino
банка	lattina
рабыня	schiavo
немедленно	immediatamente
тренировка	istruire
рассмотрел	esaminato
кодирование	codifica
Доводы	osservazioni
герои	eroi
окрашенный	dipinto
портрет	ritratto
террорист	terrorista
этический	etico
носители	vettori
мобильность	mobilità
борьба	lotta
схемы	schemi
страдающий	sofferenza
нейтральный	neutro
рыболов	pescatore
крыса	ratto
копья	lance
присоединение	accoppiamento
заголовок	intestazione
искусственный	artificiale
подшипник	cuscinetto
захватывающий	spettacolare
миры	mondi
виновный	colpevole
активация	Attivazione
убежище	porto
таблетка	tavoletta
жюри	giuria
DOS	dos
хвост	coda
очарование	fascino
насильственный	violento
потенциально	potenzialmente
ранчо	ranch
ограничения	vincoli
скрещивание	attraversamento
включительно	inclusivo
коттедж	Cottage
пьяный	ubriaco
значительный	considerevole
преступления	crimini
решены	risoluto
байт	byte
нос	naso
ветви	rami
инопланетянин	alieno
процессоры	processori
сломал	rotto
сложность	complessità
постоянно	costantemente
разрешить	risolvere
территории	territori
Тезис	tesi
диски	dischi
частый	frequente
потолок	soffitto
пикселей	pixel
поколения	gen
бриллианты	quadri
флот	flotta
гроздь	mazzo
теоретический	teorico
направления	rinvio
уволиться	smettere
протоколы	protocolli
легкое	polmone
замена	sostituire
блестящий	brillante
ти	ti
гель	gel
разговорный	verbale
омега	omega
оценивали	valutato
остались	rimasto
видит	vede
прекращение	fine
смотрели	guardato
домохозяйства	famiglie
выкупать	riscattare
зерно	grano
режим	regime
бык	Toro
архитектурный	architettonico
отличаться	differire
движения	movimenti
ремонт	riparazione
дыхание	respiro
услуги	servizi
фактически	potenzialmente
рынок	mercato
свеча	candela
подвешивание	sospeso
цветной	colorato
рассказ	racconto
раньше	precedentemente
проектор	proiettore
расположенный	situato
стремится	cerca
строго	rigorosamente
психологический	psicologico
витамины	vitamine
элегантный	elegante
доходы	utile
обновление	rinnovo
генеалогия	genealogia
считается	ritenuto
счет	punteggio
расход	spesa
критики	critica
алгоритмы	algoritmi
хакер	pirata
салон	salone
турбо	turbo
лечение	cura
п	ni
думает	pensa
предложение	suggerimento
солдат	soldato
бомбить	bomba
вред	danno
интервал	intervallo
зеркала	specchi
исследовать	indagare
твой	tuo
панели	pannelli
повторный	ripetuto
нападение	assalto
олень	cervo
язык	lingua
боулинг	bowling
три	tri
обезьяна	scimmia
доля	proporzione
юбка	gonna
анализы	analisi
рисунки	disegni
значение	significato
сценарий	scenario
вы	voi
арабский	Arabo
калибр	valutare
защищающий	proteggere
сталкиваются	affrontato
решение	soluzione
производит	produce
интенсивный	intensivo
цепи	Catene
шестой	sesto
заниматься	impegnare
переключение	commutazione
переписка	corrispondenza
импорт	importazioni
надзор	supervisione
Расходы	spese
разделение	separazione
свидетельство	testimonianza
подозреваемый	sospettare
обязательное	obbligatorio
границы	confini
праздник	celebrazione
фильтрация	filtraggio
супруг	Sposa
экзотический	esotico
зритель	spettatore
достижения	raggiungendo
смех	ridere
хирургический	chirurgico
уничтожить	distruggere
цитата	citazione
Эй	yo
предпосылки	premesse
доказано	dimostrato
наступление	offensivo
имперский	imperiale
дюжина	dozzina
развертывание	distribuzione
ткань	stoffa
лотос	loto
лосось	salmone
грузовой	carico
директива	direttiva
приятель	compagno
масло	burro
перец	Pepe
оружие	arma
бремя	fardello
ленты	nastri
зон	zone
островной	isola
стройное	sottile
кленовый	acero
продуктовый	drogheria
руководящий	governo
депо	deposito
альт	alt
пирог	torta
смесь	miscela
излучение	emissione
очевидный	apparente
учебный	didattico
разрешений	permessi
туалет	gabinetto
занимает	classificato
маршруты	itinerari
монтаж	montaggio
связанный	legato
сбалансированный	equilibrato
задерживается	ritardato
дол	vallata
расчет	calcolo
виллы	ville
случаи	occasioni
уравнения	equazioni
масла	oli
сентябре	settembre
исключительный	eccezionale
тревожность	ansia
пространственный	spaziale
респондентов	intervistati
соображения	considerazioni
платит	paga
солнечно	soleggiato
обеспечивает	fornisce
JE	je
ожерелье	collana
композитный	composito
языки	Lang
театры	teatri
проектирование	progettazione
надеется	speranze
оценки	valutazioni
диаграмма	diagramma
обувь	calzature
SG	sg
народов	popoli
Виктор	vincitore
лицензии	licenze
диапазоны	intervalli
пары	coppie
чувствительность	sensibilità
сохранение	conservazione
изолированный	isolato
промежуточный	provvisorio
помощь	assistito
божественный	divine
одобрить	approvare
соединение	composto
интенсивность	intensità
технологический	tecnologico
аборт	aborto
диалог	dialogo
центры	sedi
взрыв	esplosione
адресация	indirizzamento
столб	polo
щит	scudo
мембрана	membrana
отчаянный	disperato
матери	madri
демонстрация	dimostrazione
правительственный	governo
изготовлен	manufatto
свечи	candele
вариации	variazioni
мамы	mamme
священный	sacro
зависимость	dipendenza
хром	cromo
отказалась	rifiutato
тормоз	freno
экстерьер	esterno
приветствие	saluto
экология	ecologia
лощина	valletta
безработица	disoccupazione
забил	segnato
усиление	aumento
клон	clone
скорость	velocità
лямбда	lambda
состоящий	composto
слезы	lacrime
оазис	oasi
такси	taxi
фа	fa
общества	società
кремний	silicio
идентичный	identico
нефть	petrolio
конкурировать	competere
IST	ist
любовник	amante
принадлежать	appartenere
губы	labbra
эскорт	scorta
пруд	stagno
паром	traghetto
кролик	coniglio
профессия	professione
дамба	diga
физиология	fisiologia
экспорт	esportazioni
шина	pneumatico
участник	partecipante
электрон	elettrone
грузы	carichi
вереск	erica
мотель	motel
союзы	sindacati
казначейство	tesoreria
занятый	occupato
Весы	bilancia
напряжение	sforzo
арестованный	arrestato
исследования	indagini
получили	guadagnato
прачечная	lavanderia
размещение	collocazione
регулировать	regolare
оценивается	valutato
шифрование	crittografia
заполнение	Riempimento
наложенный	imposto
тишина	silenzio
советский	sovietico
владение	possesso
договор	trattato
тренер	allenatore
орган	organo
лимон	Limone
темнота	buio
пролет	campata
шутка	scherzo
упаковка	Imballaggio
статут	statuto
отвергнуто	respinto
укрытие	riparo
часовня	cappella
производство	produzione
слои	strati
праздновать	celebrare
прибор	apparecchio
смесь	miscela
наездник	ciclista
радиус	raggio
впечатляющий	impressionante
овца	pecora
архитектор	architetto
лекции	lezioni
вина	vini
чашки	tazze
ясень	cenere
авторы	contributori
салат	insalata
нарушения	violazioni
температура	temperature
соревнования	concorsi
сохранять	conserva
стих	poesia
пребывание	stare
Пасха	Pasqua
теории	teorie
хранилище	deposito
потоки	flussi
посадка	atterraggio
выполненный	eseguito
переговоры	negoziati
реалистический	realistico
спрашивает	chiede
конспект	sinossi
композитор	compositore
боб	fagiolo
меч	spada
изменения	modifiche
коралловый	corallo
пиксель	pixel
пути	percorsi
пузырь	bolla
Пор	por
приобретать	acquisire
вопреки	contrario
трибуна	tribuna
судно	nave
кислоты	acidi
вирусы	virus
наклейки	adesivi
реакции	reazioni
убеждения	credenze
команда	squadra
анализировать	analizzare
подразделения	divisioni
плавать	nuotare
нано	nano
концерты	concerti
мужчины	maschi
сохранить	conservare
цвета	colori
выполнять	eseguire
тоннель	tunnel
жанры	generi
патенты	brevetti
пшеница	Grano
летописи	Cronache
получение	ottenendo
бобр	castoro
чтения	letture
укрупнение	allargamento
орлов	Aquile
основы	basi
обвиняемый	accusato
кампании	campagne
единство	unità
определяет	definisce
экземпляры	casi
местный	indigeno
начатый	iniziato
пакеты	pacchetti
якорь	ancora
носки	calzini
вызывать	grilletto
холестерин	colesterolo
дифференциал	differenziale
поверхности	superfici
ужасный	terribile
маршрутизаторы	router
часы	orologi
артрит	artrite
BIOS	bios
женщины	femmine
отражает	riflette
налогообложение	tassazione
лихорадка	febbre
кухня	cucina
конечно	certamente
практики	professionisti
теорема	teorema
инфляция	inflazione
тебя	ti
соединений	composti
барабаны	batteria
разумно	ragionevolmente
голый	spoglio
радикал	radicale
рекомендует	raccomanda
управление	controllo
сокровище	Tesoro
пламя	fiamma
яма	fossa
моно	mono
частицы	particelle
плавающий	galleggiante
координировать	coordinata
исключительно	esclusivamente
ограничение	limitazione
пораженный	colpito
иллюстрация	illustrazione
предупреждения	avvertenze
сооружать	costruire
Программы	applicazioni
запросы	indagini
приложение	annesso
вдохновение	ispirazione
грузовой	nolo
затмение	eclisse
влияет	colpisce
прогнозы	previsioni
обнаружить	individuare
активно	attivamente
сложно	complicato
пострадавший	ferito
выражения	espressioni
тонна	tonnellata
курьер	Corriere
Рекомендации	suggerimenti
GIF	gif
конфликты	conflitti
напиток	bevanda
дань	omaggio
иммунный	immune
лесоводство	silvicoltura
барьеры	barriere
косяк	gergo
редко	raramente
предложения	offerte
барьер	barriera
велосипед	bicicletta
обстановка	arredamento
возникать	sorgere
кельтская	celtico
частица	particella
влажность	umidità
бутылки	bottiglie
дм	dm
Ренессанс	Rinascimento
постановление	decreto
фотографы	fotografi
инфекции	infezioni
шахматы	scacchi
работает	opera
фестивали	festival
возможности	possibilità
утка	anatra
канал	canale
способствуя	contribuendo
корова	mucca
аналитический	analitico
костюмы	costumi
строгий	rigoroso
циркуляция	circolazione
преступление	offesa
предположение	assunzione
хобби	passatempo
пытается	cerca
изобретение	invenzione
техник	tecnico
руководство	dirigenti
запросы	indagini
познавательный	conoscitivo
исследование	esplorando
трюк	trucco
запрос	inchiesta
закрытие	chiusura
лесоматериалы	legname
вольт	volt
интенсивный	intenso
сторонников	sostenitori
статуты	statuti
зачислен	iscritto
датчиков	sensori
винт	vite
министры	ministri
публично	pubblicamente
пострадали	subito
потребление	presa
бабочка	farfalla
механика	meccanica
заголовки	intestazioni
ошибки	errori
численный	numerico
определяющий	definizione
подсчет	conteggio
отражение	riflessione
приглашение	invito
натрий	sodio
гормон	ormone
детская	bambini
кирпич	mattone
рукоятка	presa
средневековый	medievale
фарфор	porcellana
захваченный	catturato
порядочный	decente
Кастинг	getto
переведенный	tradotto
Донна	donna
воин	guerriero
кабина	cabina
сканирование	lettura
поло	polo
копирование	copiatura
рог	corno
журналистика	giornalismo
лягушка	rana
грамматика	grammatica
намерение	Intenzione
шины	pneumatici
проведены	intrapreso
опасность	rischio
эпизоды	Episodi
круговой	circolare
гнев	rabbia
иллюстрации	illustrazioni
шансы	possibilità
счастье	felicità
эксцентричный	bizzarro
ур	ur
фрукты	frutta
идентификатор	identificatore
лента	nastro
вычисления	calcoli
JPEG	jpeg
запускать	avviare
удобный	maneggevole
замена	scambiare
освобожденный	esonerare
культуры	colture
уменьшает	riduce
осуществляется	compiuto
геометрия	geometria
впечатление	impressione
гильдия	gilda
корреляция	correlazione
сим	sim
нервное	nervoso
аромат	fragranza
копия	replica
племя	tribù
сделки	compravendite
превосходный	superbo
избавиться	liberare
Троица	Trinità
обрабатываются	maneggiato
легенды	leggende
бум	boom
спокойный	calma
чемпионы	campioni
этажей	piani
выборы	Selezioni
Сравнение	confrontando
говорит	parla
профессиональное	professionale
аптеки	farmacie
пер	ln
ролик	rullo
партия	partita
организовать	organizzare
оценили	gradito
изменять	alterare
края	bordi
смешивание	miscelazione
ручки	maniglie
гармония	armonia
выдающийся	distinto
астма	asma
допущения	assunzioni
регулируется	regolata
треугольник	triangolo
изменить	emendare
ожидаемый	anticipato
восточный	orientale
награда	ricompensa
водород	idrogeno
сравнимый	comparabile
адвокат	avvocato
путаница	confusione
входные	ingressi
гарантии	garanzie
геном	genoma
медаль	medaglia
тренеры	allenatori
суд	vasi
гавань	porto
эко	eco
уязвимый	vulnerabile
организовать	organizzare
художественный	artistico
почести	onori
отраженный	riflessa
унифицированный	unificato
разводить	razza
детектор	rivelatore
игнорируются	ignorato
точный	preciso
оценки	valutare
губа	labbro
собирать	raccogliere
формирование	formatura
журналисты	giornalisti
незначительный	leggero
косвенный	indiretto
среди	tra
устои	fondazioni
горизонт	orizzonte
ню	nu
глубоко	profondamente
обязательства	passivo
призы	premi
снизилась	diminuita
описывающее	descrivendo
оптика	ottica
преследовать	perseguire
молния	fulmine
ОУ	ou
цитаты	citazioni
инспектор	ispettore
змея	serpente
напоминание	promemoria
поиск	cercato
равнины	pianure
понимание	approfondimenti
способности	abilità
начатый	avviato
караоке	karaoke
ловушка	trappola
Одинокий	solitario
ве	ve
наблюдать	osservare
контейнеры	contenitori
отношения	atteggiamenti
ягода	bacca
воротник	collare
интегрировать	integrare
социология	sociologia
экспонаты	mostre
умирает	muore
терраса	terrazza
бактерии	batteri
должен	dovere
вкусно	delizioso
традиции	tradizioni
конечный	finito
посылает	invia
прочный	durevole
союзный	alleato
влажность	umidità
преобразование	trasformare
таймер	Timer
таблетки	compresse
полученный	ottenuto
воспитатели	educatori
овощной	verdura
стих	versetto
независимо	indipendentemente
конкуренты	concorrenti
ракета	razzo
да	sì
пуля	proiettile
башни	torri
видимость	visibilità
широта	latitudine
сознание	coscienza
опухоль	tumore
уродливый	brutta
депозиты	depositi
госпожа	padrona
столкновение	incontrare
Вт	watt
сорок	quaranta
трубы	tubi
попытка	tentata
священник	sacerdote
аналитики	analisti
молоток	martello
вторжение	invasione
бегун	corridore
строки	righe
вводить	somministrati
понятие	nozione
написание	ortografia
Арктический	artico
награды	ricompense
под	sotto
укреплять	rafforzare
защищать	difendere
инфракрасный	infrarosso
седьмой	settimo
живот	pancia
агрессивный	aggressivo
объявления	annunci
помещение	alloggio
похищенный	rubare
определяет	determina
скульптура	scultura
поли	poli
уши	orecchie
кулак	pugno
нео	neo
мотивация	motivazione
пассажиров	viaggiatori
последовательно	costantemente
избыток	surplus
копать	scavare
такси	Taxi
признательность	apprezzamento
ом	om
ограничение	restrizione
гитары	chitarre
сущность	essenza
могущественный	potente
человечество	umanità
транскрипция	trascrizione
осложнения	complicazioni
ученые	studiosi
галактика	galassia
заботливая	cura
завещание	testamento
доминирующий	dominante
желудок	stomaco
частично	parzialmente
минимизировать	minimizzare
ряды	ranghi
дебют	debutto
поколения	generazioni
турниры	tornei
Отрицать	negare
анатомия	anatomia
наушники	cuffie
доля	frazione
трио	trio
судопроизводство	procedere
куб	cubo
дефекты	difetti
неопределенность	incertezza
сломать	abbattersi
решен	sistemato
вакцина	vaccino
судьба	destino
бронирование	prenotazioni
республиканцы	repubblicani
джунгли	giungla
Дзэн	zen
дис	dis
прогнозирование	predizione
экологический	ecologico
овальный	ovale
подразумевает	implica
сер	ser
оценка	valutazione
перспектива	prospettiva
географический	geografico
донор	donatore
напряженность	tensione
мусор	spazzatura
формы	forme
ярус	fila
граф	conte
Родина	patria
чемпионаты	campionati
породы	razze
дискотека	discoteca
AUS	aus
отделка	finitura
эмоции	emozioni
вечный	eterno
вращение	rotazione
Нама	nam
продуктивный	produttivo
бульвар	viale
свинья	maiale
метрический	metrico
штрафы	sanzioni
разнообразный	vario
Гранди	Grande
актриса	attrice
назначать	assegnare
вмещать	ospitare
тигры	tigri
деревни	villaggi
тень	ombra
хор	coro
ритм	ritmo
цифра	cifra
симфония	sinfonia
внезапно	improvviso
принимающий	accettando
бассейны	piscine
лирический	lirica
изоляция	isolamento
скорость	velocità
устойчивый	sostenuta
соответствие	abbinato
приближенный	approssimativo
веревка	corda
рациональный	razionale
программист	programmatore
боевики	combattenti
унаследованный	ereditato
неполный	incompleto
вокал	vocals
фонтан	Fontana
законный	legittimo
биографии	biografie
следователь	investigatore
истец	attore
нежный	dolce
достойный	degno
архитекторы	architetti
святые	santi
предприниматель	imprenditore
осуществляет	trasporta
дуэт	duo
чрезмерное	eccessivo
экономит	salva
рассматривать	considerato
оценка	valutazione
неожиданный	inaspettato
туман	nebbia
характеристика	caratteristica
лобби	atrio
изложены	delineato
огромный	enorme
карма	karma
состоять	consistere
Квинс	regine
ученые	accademici
племена	tribù
различие	distinzione
опасность	pericoli
освобождение	esenzione
арендатор	inquilino
устойчивость	sostenibilità
тату	tatuaggio
алгебра	algebra
тени	ombre
глупый	sciocco
свободно	liberamente
мягкий	mite
мех	pelliccia
легко	prontamente
присоединение	affiliazione
забор	recinto
бесконечный	infinito
клан	clan
революционер	rivoluzionario
браслеты	bracciali
средство	rimedio
дыхание	respirazione
кратко	brevemente
толщина	spessore
графический	grafico
гениальность	genio
обсуждение	discutere
истребитель	combattente
значимым	significativo
адаптированный	adattato
усадеб	proprietà
коврик	tappeto
демократ	democratico
район	borgo
поддерживает	mantiene
ка	ka
сохраняется	mantenuto
мрамор	marmo
дем	DEM
медитация	meditazione
микрофон	microfono
объединение	combinando
гиганты	giganti
организация	organizzazione
меморандум	promemoria
ветчина	prosciutto
решена	risolto
волна	marea
раздел	partizione
невидимый	invisibile
консоли	console
магнит	magnete
переводы	traduzioni
ягуар	giaguaro
товар	merce
километров	chilometri
гарантии	garanzie
готика	Gotico
цилиндр	cilindro
ведьма	strega
доллар	secchio
враги	nemici
консультирование	consulenza
наслаждаясь	godendo
патруль	pattuglia
запах	odore
карнавал	carnevale
грубо	approssimativamente
наклейка	etichetta
обещания	promesse
риф	scogliera
делить	dividere
последовательный	consecutivo
бон	bon
представления	rappresentazioni
чан	chan
мелодии	Tunes
Рождество	mas
фразы	frasi
кай	kai
полуостров	penisola
скучный	noioso
дом	dom
речи	discorsi
достигает	raggiunge
схема	schema
каталоги	cataloghi
министерства	ministeri
парламентский	parlamentare
префикс	prefisso
саванна	savana
бочка	barile
нерв	nervo
данс	dans
планеты	pianeti
дефицит	disavanzo
возобновлять	rinnovare
соединенный	accoppiato
схемы	circuiti
текстура	struttura
признавать	riconoscere
палатка	tenda
определяет	identifica
квалификация	qualificazione
замки	serrature
миниатюрный	miniatura
евро	euro
пираты	pirati
антенна	aereo
ястреб	falco
следствие	conseguenza
систематическая	sistematico
воспринимается	percepito
происхождения	origini
наемный	assunti
составить	trucco
щ	ui
веса	pesi
геологический	geologica
прочный	durevole
злой	malvagio
вводит	introduce
толкнул	spinto
ро	ro
скат	pendenza
поэт	poeta
заговор	cospirazione
теология	teologia
ногти	unghie
очевидный	evidente
аттракционы	cavalcate
эпический	epico
организатор	organizzatore
аллергия	allergia
ради	interesse
комбинации	combinazioni
предшествующий	precedente
заслуга	merito
фермент	enzima
самолеты	aerei
диски	dischi
усилитель	amplificatore
произвольный	arbitrario
видный	prominente
без	sans
строит	costruisce
связаться	contattato
вал	albero
опираться	magro
случайный	occasionale
инновации	innovazioni
рассмотрение	revisione
паника	panico
гражданство	cittadinanza
оправдание	scusa
реформы	riforme
лук	cipolla
сэндвич	Sandwich
альт	contralto
иерархия	gerarchia
заброшенный	abbandonato
круги	cerchi
биения	battiti
веселый	allegro
культ	culto
тир	trattino
пассивный	passivo
ценный	valutato
клетка	gabbia
мужество	coraggio
высота	elevazione
круг	giro
использование	utilizzo
напитки	bevande
пинг	ping
развлекательный	divertente
предпосылка	necessario
граница	frontiera
беженцы	rifugiati
рыцари	cavalieri
гипотеза	ipotesi
медикаменты	farmaci
изменено	alterato
учение	dottrina
сценический	panoramico
улучшения	miglioramenti
пересечение	intersezione
шитье	cucire
коллекторы	collettori
признанное	riconosciuto
ярость	rabbia
Приза	prix
астрология	astrologia
консультанты	consulenti
павильон	padiglione
тактика	tattica
дополнительный	supplementare
талантливый	talentuoso
подушка	cuscino
распространение	diffusione
провинция	province
украсть	rubare
пакет	pacco
падение	incidenza
боится	paure
прогнозировать	predire
аромат	gusto
голодный	Affamato
металлический	metallico
интерференция	interferenza
воины	guerrieri
атмосферный	atmosferico
гало	alone
родительский	parentale
ссылка	riferimento
забастовки	attacchi
муравей	formica
предложение	proposizione
склонный	adatto
дело	affrontato
трейдер	commerciante
выброшены	gettato
критерий	criterio
значок	distintivo
цивилизация	civiltà
вереск	brughiera
огромный	enorme
выполняет	esegue
область	regno
исправленный	corretto
шлем	casco
встречается	incontrato
цунами	tsunami
ученый	studioso
окруженный	circondato
геология	geologia
существа	creature
очищается	eliminato
выполнять	realizzare
углы	angoli
вегетарианец	vegetariano
дрожжи	lievito
па	pas
исследовалась	indagato
посол	ambasciatore
покрытый	rivestito
гибель	destino
подпрограммы	routine
существа	esseri
опора	dipendenza
миф	mito
ручей	ruscello
марихуана	fu
явление	fenomeno
ансамбль	insieme
уверенный	assicurato
сознательный	consapevole
акцент	accento
жены	mogli
использовать	utilizzare
залог	impegno
вампир	vampiro
док	bacino
организованная	organizzato
музыкант	musicista
ограничения	limitativo
восстановлен	restaurato
намек	suggerimento
броня	armatura
замечание	osservazione
множество	dozzine
меняется	varia
рассуждения	ragionamento
гвардия	guardie
отверстия	aperture
замена	sostituzione
Исследователь	ricercatore
советы	consigli
профессий	occupazioni
признанный	riconosciuto
свинина	Maiale
цу	zu
равновесие	equilibrio
трубы	tubi
коттеджи	cottage
сливаться	fondersi
привилегия	privilegio
развивается	sviluppa
шасси	telaio
оценка	stima
сарай	fienile
мороз	brina
институты	istituti
плесень	muffa
дама	dama
яхта	yacht
предпочитает	preferisce
бурение	perforazione
трава	erba
нарушение	violazione
кит	balena
путешественник	viaggiatore
ассигнования	stanziamenti
подозреваемый	sospetto
помидоры	pomodori
инструкторы	istruttori
импульс	impulso
плавник	pinna
пастор	pastore
грязи	fango
изумруд	Smeraldo
растет	cresce
тракт	tratto
уль	ul
балет	balletto
журналист	giornalista
религии	religioni
чеснок	aglio
блеск	brillare
взрыв	esplosione
трусы	slip
подписи	firme
озон	ozono
дисциплины	discipline
Каса	Casa
разговоры	conversazioni
радио	radio
тариф	tariffa
упрощенный	semplificato
мышцы	muscoli
быстрый	veloce
влагалище	vagina
шампанское	Champagne
отклонение	deviazione
самба	samba
использовать	impiegare
пингвин	pinguino
волшебный	magico
влияет	influenze
инспекции	ispezioni
орошение	irrigazione
чудо	miracolo
гидравлический	idraulico
проникновение	penetrazione
рана	ferita
красавица	bella
Роза	rosa
убеждение	convinzione
ленивый	pigro
качества	qualità
отцы	padri
зарядка	ricarica
важно	importante
маленькая	petite
устройство	apparato
местность	terreno
объясняя	spiegando
полоски	strisce
назначение	nomina
эмпирический	empirico
червь	verme
зависимость	dipendenza
дискретный	discreto
начинающий	principiante
крышка	coperchio
сексуальность	sessualità
сапфир	zaffiro
привилегии	privilegi
специализация	specializzata
маркировка	marcatura
шериф	sceriffo
отказался	diminuito
шпионы	spie
мотоциклы	moto
избранные	eletto
шоссе	autostrade
концентрат	concentrarsi
интимный	intimo
молекулы	molecole
туры	giri
холодильник	frigorifero
интервалы	intervalli
предложения	frasi
истребление	olocausto
листовка	aviatore
горох	piselli
дозировка	dosaggio
дисперсия	varianza
навигатор	navigatore
игла	ago
баня	terme
тормоза	Freni
ог	og
ко	ko
владеет	possiede
судьба	destino
пейзажи	paesaggi
вычисление	calcolo
сено	fieno
спасение	salvezza
прогнозы	predizioni
учащихся	discenti
знак	gettone
цинк	zinco
жертва	sacrificio
искатели	asilo
гуру	guru
подходящий	adatto
числовой	numerico
антропология	antropologia
император	imperatore
град	grad
ремни	cinture
негры	neri
образованный	educato
гордо	orgoglio
необходимость	necessità
кривые	curve
туризм	turismo
вершина	vertice
помидор	pomodoro
путешествия	viaggi
бледный	pallido
функционирование	funzionamento
экономики	economie
предпринимать	intraprendere
объявлять	dichiarare
клапаны	valvole
пробелы	lacune
достижения	realizzazioni
слеза	lacrima
учит	insegna
ноль	zero
незнакомец	sconosciuto
гнездо	nido
суд	tribunale
правил	governato
пенсии	pensioni
молитвы	preghiere
полицейский	poliziotto
подросток	adolescente
номинации	nomination
банан	Banana
вводный	introduttivo
резервуар	serbatoio
вхождение	evento
идол	idolo
кровавый	sanguinoso
напоминать	ricordare
обаятельный	affascinante
зуб	dente
уважаемый	rispettata
остается	soggiorni
дело	affare
ограничивать	limitare
мины	miniere
портреты	ritratti
интерпретированы	interpretato
оценки	valutazioni
устранение	eliminazione
метры	metri
гипотетический	ipotetico
вертолет	elicottero
карандаш	matita
исполнитель	esecutore
комиссии	commissioni
сфера	sfera
мох	muschio
коэффициенты	rapporti
созвучие	concordia
закончил	laureato
одобрил	omologati
удивительный	sorprendente
копье	lancia
лестница	scala
пробка	sughero
сенаторы	senatori
кровотечение	emorragia
характеристика	caratterizzazione
вероятность	probabilità
полосы	corsie
основы	fondamenti
загрязнение	contaminazione
купол	cupola
благословить	benedire
Переговоры	trattativa
гребень	cresta
соперники	avversari
триумф	trionfo
номинирована	nominato
сварка	saldatura
оргазм	orgasmo
сплав	lega
участки	trame
осторожно	delicatamente
блокировка	bloccaggio
спорный	controverso
рисует	disegna
холодильник	frigo
лезвия	lame
петли	loop
волна	ondata
травма	trauma
объявление	annuncio
оборонительный	difensiva
запрещено	proibito
ваниль	vaniglia
программисты	programmatori
контролируемый	monitorati
сооружения	installazioni
души	anime
мотивировано	motivata
тупой	muto
полый	cavo
свод	volta
паз	scanalatura
откровение	rivelazione
преследование	ricerca
делегация	delegazione
провода	fili
словари	dizionari
прозрачность	trasparenza
орбита	orbita
валюты	valute
Нигер	Niger
позиционирование	posizionamento
колония	colonia
пушка	cannone
цирк	circo
способствовало	promossa
форель	trota
подвиг	impresa
временно	temporaneamente
приготовленный	cucinato
передавать	trasmettere
частоты	frequenze
размышления	riflessi
голод	fame
муниципалитет	comune
детектив	investigatore
цемент	cemento
испытывают	sperimentare
камин	camino
поддержка	approvazione
текстиль	tessile
ракета	missile
психиатрия	psichiatria
помогает	assist
аудитор	uditore
скрипка	violino
пророк	profeta
окись	ossido
великолепный	magnifico
быстро	prontamente
приспособление	adattamento
вредный	dannoso
сексуально	sessualmente
ограда	allegato
глюкоза	glucosio
норма	norma
воспроизведение	riproduzione
черепаха	tartaruga
расстояния	distanze
поглощение	assorbimento
сокровища	tesori
ископаемое	fossile
плохо	male
коммунист	comunista
предприниматели	imprenditori
роботы	robot
фол	fallo
биоразнообразия	biodiversità
волнение	eccitazione
словесный	verbale
моря	mari
загадочный	misterioso
новинка	novità
плитка	piastrelle
библиотекарь	bibliotecario
переключился	commutata
RU	ru
поза	posa
граммов	grammi
Терапевт	terapista
бюджеты	budget
козел	capra
оказывать	rendere
паруса	vela
комиссары	commissari
плотный	denso
Храбрый	coraggioso
пересылка	spedizione
ужасный	terribile
самолет	aereo
микроорганизмы	organismi
телескоп	telescopio
асбест	amianto
продвижение	avanzamento
ива	salice
резюме	riprende
существовавший	esistito
генераторы	generatori
генерирует	genera
картофель	patate
тщательный	completo
рецепторы	recettori
оптимальный	ottimale
существо	creatura
одинокий	solitario
тонкий	sottile
полосы	strisce
прошивка	firmware
пасти	pastore
колыбель	culla
канцлер	cancelliere
мука	Farina
полемика	controversia
легендарный	leggendario
хор	coro
избегая	evitando
красиво	magnificamente
надеется	aspetta
прыжки	salto
ткань	tessuti
полимер	polimero
гигиена	igiene
добродетель	virtù
хирурги	chirurghi
мандат	mandato
тело	corpo
терминология	terminologia
джентльмен	signore
осужденный	condannato
струи	getti
индексы	indici
Квай	qui
угрожающий	minaccioso
активисты	attivisti
заключенный	prigioniero
призывает	incoraggia
собранный	assemblato
терминалы	terminali
сырой	greggio
осматривает	esamina
викинг	vichingo
уборка	pulire
условный	condizionale
атакован	attaccato
прибывает	arriva
переводчик	traduttore
автомобили	automobili
трактор	trattore
континент	continente
тарифы	tariffe
долгота	longitudine
надеялся	sperato
вставка	inserimento
ограничение	costrizione
укрепление	potenziamento
желающих	desiderando
изоляция	isolamento
нарушение	violazione
изогнутый	piegato
субъективный	soggettivo
монстры	mostri
убежище	asilo
доля	palo
коктейль	cocktail
сорта	varietà
яд	veleno
доминировал	dominato
дорогостоящий	costoso
производные	derivati
предотвращает	impedisce
винтовка	fucile
расизм	razzismo
интерпретировать	interpretare
согласие	accordo
скромный	modesto
геймеров	giocatori
сортировка	ordinamento
связь	collegamento
луковицы	bulbi
туристы	turisti
поведения	comportamenti
прояснить	chiarire
Талия	vita
приписаны	attribuito
сова	gufo
кристаллы	cristalli
превышает	supera
дополнительный	complementare
сражения	battaglie
горький	amaro
меморандум	memorandum
драконы	draghi
шум	frastuono
невероятно	incredibilmente
делегаты	delegati
психиатрический	psichiatrico
подростков	adolescenti
двор	cortile
президенты	presidenti
отходить	partire
специально	espressamente
Лили	giglio
надзор	svista
смола	resina
союзники	alleati
сохраняется	conservato
пересекла	attraversato
Восходящий	ascendente
номинальный	nominale
распад	decadimento
кварц	quarzo
регистры	registri
восьмой	ottavo
уполномоченный	autorizzato
улучшает	migliora
адвокаты	sostenitori
явления	fenomeni
наклон	inclinazione
гранит	granito
массы	masse
спортсмен	atleta
франк	franco
сходство	somiglianza
утечка	perdita
консультант	consigliere
буклет	opuscolo
ожидая	aspettandosi
оборот	turnover
моча	urina
полотенце	asciugamano
имбирь	Zenzero
хромосома	cromosoma
ALS	als
летит	mosche
компетентность	competenza
плач	pianto
любители	dilettanti
кран	gru
расследование	indagare
гнилой	marcio
привычка	abitudine
честь	onore
защищает	protegge
Ирис	iris
управляет	gestisce
эрозия	erosione
столяр	falegname
хан	caravanserraglio
недостаточное	insufficiente
формулировка	formulazione
умная	intelligente
лорды	signori
приятный	piacevole
полумесяц	mezzaluna
шестьдесят	sessanta
концентрированный	concentrato
выделить	distinguere
й	EI
прогнозы	proiezioni
искра	scintilla
обеспечение	fissaggio
путь	sentiero
детекторы	rilevatori
колос	spuntone
ингредиент	ingrediente
занавес	tenda
раскрытый	divulgato
тактический	tattico
пилоты	piloti
экспедиция	spedizione
оперативный	operativo
юмор	umorismo
моль	mol
отпечаток	impronta
содействие	assistere
дефект	difetto
плохо	male
богиня	dea
наблюдателей	osservatori
магниты	magneti
формулы	formule
просторный	spazioso
утверждает	sostiene
почвы	suoli
органы	organi
йе	det
лояльность	lealtà
верный	fedele
преступление	offesa
литий	litio
прыжок	salto
учредительный	fondazione
лебедь	cigno
насаждение	piantare
завет	patto
археология	archeologia
матрос	marinaio
заботы	cure
святилище	santuario
статуя	statua
цитата	Quotazione
майоров	major
манипуляция	manipolazione
колокольчики	campane
токсичность	tossicità
передатчик	trasmettitore
окрестности	quartieri
трофей	trofeo
эмоция	emozione
Достопримечательности	viste
униформа	uniformi
раненый	ferito
производное	derivato
размещение	occupazione
дозы	dosi
воспитывать	educare
предубеждение	pregiudizio
техники	tecnici
вероятный	probabile
выдача	emissione
украшение	decorazione
граждане	cittadini
троянский	trojan
ассистенты	assistenti
консультант	consulente
принятый	promulgato
неустойчивый	instabile
настоятельно	sollecitato
отражающий	riflettendo
получение	guadagnando
окончательный	definitivo
путешествовал	viaggiato
адаптироваться	adattare
присоединение	accessione
регулятор	regolatore
топливо	combustibili
соя	soia
аккуратный	pulito
именование	denominazione
кормовой	poppa
проработаны	artigianale
идиот	idiota
состоит	composto
инопланетяне	alieni
правки	modifiche
вороной	Corvo
жилье	dimora
символический	simbolico
углы	angoli
давление	pressioni
Венера	Venere
огонь	fiamme
примитивный	primitivo
чулок	calza
экосистема	ecosistema
залы	sale
простота	semplicità
демон	demone
приветствовал	accolto
обозначение	notazione
тетка	zia
ворона	corvo
семантический	semantico
прекращено	interrotto
решает	decide
глобализация	globalizzazione
ослы	asini
компас	bussola
эволюционировали	evoluto
пехота	fanteria
прославленный	rinomato
коридор	corridoio
философский	filosofico
обоснование	giustificazione
вакантный	vacante
фиксация	fissaggio
грамм	grammo
прячется	bastonatura
краситель	colorante
алфавит	alfabeto
очищенный	puliti
заслуженный	onorato
оптический	ottico
телефоны	telefoni
дневников	diari
горе	dolore
пот	sudore
дельфин	delfino
чудеса	meraviglie
вентиляция	ventilazione
маски	maschere
бюст	busto
аллея	vicolo
путей	percorsi
телеграф	telegrafo
памятник	monumento
формально	formalmente
роса	rugiada
отозваны	ritirato
дебаты	dibattiti
тождества	identità
дефицит	carenza
седло	sella
малярия	malaria
верный	leale
тенденция	tendenza
используется	utilizzato
Эйн	Ein
бинокль	binocolo
инициировать	iniziato
чисто	puramente
яркий	vivido
утверждения	accuse
соответствует	corrisponde
демон	demone
знаменитый	celebre
охотники	cacciatori
действовал	agito
коэффициент	coefficiente
череп	cranio
продолжение	continuazione
служащий	servitore
сокол	falco
совместно	insieme
избегать	evitato
объяснения	spiegazioni
обновленный	rinnovato
критик	critico
отстой	sedimento
квадраты	piazze
фургоны	furgoni
конус	cono
переживший	sopravvissuto
распространенность	prevalenza
фрагмент	frammento
совершает	impegna
кобра	cobra
бросил	gettò
специальная	hoc
исполнители	interpreti
Десерт	dolce
диссертация	dissertazione
девятый	nono
энтузиазм	entusiasmo
празднования	celebrazioni
губернаторы	governatori
атомы	atomi
тканей	tessuti
скат	rampa
мило	piacevolmente
делла	della
доминирование	dominio
аккорды	accordi
нарушение	menomazione
молекула	molecola
