of	arasında
to	için
in	içinde
for	için
is	olduğu
on	üzerinde
that	o
by	tarafından
this	bu
with	ile
i	ben
you	sen
it	o
or	veya
be	olmak
are	Hangi
at	en
all	herşey
have	var
new	yeni
we	Biz
will	irade
home	ev
us	bize
about	hakkında
if	Eğer
page	sayfa
my	benim
has	vardır
search	arama
free	ücretsiz
but	fakat
our	bizim
one	bir
other	diğer
do	yap
information	bilgi
time	zaman
he	o
which	hangi
their	onların
news	haber
use	kullanım
there	Orada
see	görmek
so	yani
who	kim
web	ağ
also	Ayrıca
get	almak
pm	pm
view	görünüm
c	c
e	e
first	ilk
been	olmuştur
would	olur
were	idi
s	s
like	sevmek
x	x
than	göre
find	bulmak
price	fiyat
back	geri
top	üst
people	insanlar
had	vardı
list	liste
name	isim
just	sadece
year	yıl
day	gün
into	içine
two	iki
health	sağlık
n	n
re	yeniden
used	Kullanılmış
go	gitmek
b	b
last	son
make	Yapmak
them	onları
should	meli
product	ürün
system	sistem
post	posta
her	ona
city	Kent
t	t
policy	politika
number	numara
support	destek
message	mesaj
after	sonra
then	sonra
jan	Ocak
good	iyi
d	d
where	nerede
info	bilgi
rights	haklar
books	kitaplar
high	yüksek
school	okul
m	m
each	her
links	bağlantılar
she	o
years	yıl
order	sipariş
very	çok
book	kitap
items	ürün
company	şirket
r	r
read	okumak
group	grup
sex	seks
many	çok
user	kullanıcı
de	de
set	set
general	genel
research	Araştırma
university	Üniversite
january	Ocak
mail	posta
full	tam
reviews	yorumlar
program	program
know	bilmek
games	oyunlar
way	yol
days	günler
p	p
part	Bölüm
could	could
great	harika
united	birleşmiş
real	gerçek
f	f
international	Uluslararası
center	merkez
travel	seyahat
comments	yorumlar
made	yapılmış
development	gelişme
report	rapor
member	üye
details	ayrıntılar
line	hat
terms	şartlar
before	önce
hotels	oteller
did	did
send	göndermek
right	sağ
type	tip
local	yerel
those	bu
results	Sonuçlar
office	ofis
national	Ulusal
car	araba
design	dizayn
take	almak
posted	gönderildi
address	adres
community	topluluk
within	içinde
states	devletler
want	istemek
phone	telefon
dvd	DVD
subject	konu
between	arasında
forum	forum
family	aile
l	l
long	uzun
w	w
show	göstermek
o	O
even	Üstelik
black	siyah
special	özel
index	indeks
being	olmak
women	KADIN
much	çok
sign	işaret
file	dosya
link	bağlantı
open	açık
south	güney
case	dava
project	proje
pages	sayfalar
version	versiyon
section	Bölüm
own	kendi
house	ev
security	güvenlik
g	g
county	kontluk
american	Amerikan
photo	Fotoğraf
game	oyun
members	üyeler
power	güç
network	ağ
computer	bilgisayar
systems	sistemler
three	üç
place	yer
end	son
h	h
him	onu
per	başına
access	erişim
think	düşünmek
north	kuzeyinde
resources	kaynaklar
current	şimdiki
big	büyük
media	medya
law	kanun
control	kontrol
water	Su
history	Tarihçe
size	boyut
personal	kişisel
guide	kılavuz
shop	Dükkan
directory	rehber
change	değişiklik
white	beyaz
text	Metin
small	küçük
rating	değerlendirme
rate	oran
government	hükümet
children	çocuklar
return	dönüş
students	öğrencilerin
v	v
account	hesap
times	zamanlar
level	seviye
digital	dijital
profile	profil
previous	önceki
form	form
events	olaylar
love	Aşk
old	eski
john	John
main	ana
call	aramak
image	görüntü
department	Bölüm
title	Başlık
non	olmayan
k	k
y	y
insurance	sigorta
shall	acak
property	özellik
class	sınıf
cd	CD
quality	kalite
every	her
listing	listeleme
content	içerik
country	ülke
little	küçük
tools	araçlar
low	düşük
reply	cevap
customer	müşteri
december	Aralık
compare	karşılaştırmak
movies	filmler
college	kolej
value	değer
article	makale
man	adam
jobs	Meslekler
j	j
food	Gıda
author	yazar
different	farklı
u	u
learn	öğrenmek
sale	satış
print	baskı
course	kurs
job	iş
room	oda
stock	Stok
training	Eğitim
too	çok
credit	kredi
point	puan
science	Bilim
men	erkekler
categories	kategoriler
west	batı
look	bak
english	ingilizce
team	takım
estate	arazi
box	Kutu
conditions	koşullar
photos	fotoğraflar
gay	eşcinsel
thread	iplik
category	kategori
note	Not
live	canlı
large	büyük
gallery	galeri
table	tablo
however	ancak
june	Haziran
october	Ekim
november	Kasım
market	Market
library	kütüphane
action	aksiyon
start	başla
series	dizi
features	Özellikler
air	hava
industry	sanayi
plan	plan
human	insan
yes	Evet
second	ikinci
hot	Sıcak
cost	maliyet
movie	film
forums	forumlar
march	Mart
la	la
september	Eylül
say	söylemek
going	gidiyor
medical	tıbbi
friend	arkadaş
dec	Aralık
server	sunucu
application	uygulama
staff	Personel
play	oyun
issues	sorunlar
april	Nisan
users	kullanıcılar
street	sokak
topic	konu
against	karşısında
got	var
blog	Blog
party	Parti
payment	ödeme
equipment	ekipman
let	let
programs	programlar
legal	yasal
recent	son
park	park
act	davranmak
problem	sorun
red	kırmızı
give	vermek
memory	bellek
performance	performans
social	sosyal
q	q
story	Öykü
sell	satmak
options	seçenekleri
experience	deneyim
key	anahtar
body	vücut
young	genç
important	önemli
field	alan
few	az
east	Doğu
single	tek
ii	ii
age	yaş
club	kulüp
example	örnek
girls	kızlar
z	z
road	yol
gift	hediye
question	soru
ca	CA
hard	zor
pay	ödeme
four	dört
poker	poker
issue	konu
range	menzil
building	bina
seller	satıcı
court	mahkeme
february	Şubat
result	sonuç
light	ışık
write	yazmak
war	savaş
offer	teklif
blue	mavi
groups	gruplar
al	ark
easy	kolay
given	verilmiş
request	istek
fax	faks
china	Çin
making	yapma
picture	resim
needs	ihtiyaçlar
possible	mümkün
month	ay
major	majör
star	star
future	gelecek
space	uzay
committee	Kurul
hand	el
sun	Güneş
cards	kartları
london	Londra
meeting	toplantı
become	olmak
child	çocuk
keep	Tut
porn	porno
share	pay
similar	benzer
garden	Bahçe
schools	okullar
million	milyon
added	katma
reference	referans
companies	şirketler
baby	bebek
learning	öğrenme
energy	enerji
run	koşmak
delivery	teslim
popular	popüler
term	terim
film	film
stories	hikayeleri
put	koymak
journal	dergi
reports	raporlar
co	ko
try	Deneyin
images	Görüntüler
notice	ihbar
god	Allah
original	orijinal
head	kafa
radio	radyo
cell	hücre
council	konsey
includes	içerir
track	Izlemek
discussion	tartışma
archive	Arşiv
others	diğerleri
agreement	anlaşma
format	biçim
society	toplum
months	ay
safety	Emniyet
friends	Arkadaş
sure	emin
edition	baskı
messages	mesajları
marketing	pazarlama
tell	söylemek
association	birleşme
provides	sağlar
fun	eğlence
already	zaten
green	yeşil
studies	çalışmalar
close	kapat
common	ortak
specific	özel
several	birkaç
living	yaşam
collection	Toplamak
called	denilen
short	kısa
arts	sanat
lot	çok
ask	Sor
limited	sınırlı
solutions	çözeltiler
director	yönetmen
beach	plaj
past	geçmiş
natural	doğal
electronics	elektronik
upon	üzerine
period	dönem
planning	planlama
says	diyor
official	resmi
mar	mar
done	tamam
technical	teknik
window	pencere
pro	profesyonel
region	bölge
island	ada
record	kayıt
direct	direkt
conference	konferans
records	kayıtlar
st	st
district	ilçe
calendar	takvim
costs	maliyetler
style	stil
statement	Beyan
miles	mil
resource	kaynak
applications	uygulamaları
document	belge
word	sözcük
works	Eserleri
material	malzeme
bill	fatura
written	yazılı
rules	kurallar
final	nihai
thing	şey
centre	merkez
requirements	Gereksinimler
TRUE	DOĞRU
minutes	dakika
else	Başka
mark	işaret
rock	Kaya
bad	kötü
individual	bireysel
plus	artı
auto	Oto
cover	kapak
edit	Düzenle
together	birlikte
videos	videolar
fast	hızlı
function	fonksiyon
fact	gerçek
getting	alma
global	global
tech	teknoloji
meet	karşılamak
far	uzak
economic	ekonomik
en	tr
player	oyuncu
projects	projeler
amount	Miktar
watch	izlemek
included	dahil
feel	hissetmek
bank	banka
risk	risk
deals	fırsatlar
various	çeşitli
words	kelimeler
production	üretim
commercial	ticari
weight	ağırlık
heart	kalp
treatment	tedavi
points	makas
knowledge	bilgi
magazine	dergi
error	hata
camera	kamera
girl	kız
construction	inşaat
toys	oyuncaklar
registered	kayıtlı
domain	domain
methods	yöntemleri
chapter	bölüm
protection	koruma
policies	politikaları
wide	geniş
beauty	güzellik
manager	müdür
india	Hindistan
position	pozisyon
taken	alınmış
sort	çeşit
listings	listeleri
known	bilinen
half	yarım
cases	vakalar
step	adım
engineering	mühendislik
simple	basit
quick	hızlı
license	lisans
lake	göl
whole	bütün
annual	yıllık
published	yayınlanan
church	kilise
method	yöntem
active	aktif
response	tepki
figure	şekil
materials	malzemeler
enough	yeterli
designed	tasarlanmış
among	arasında
death	ölüm
loss	kayıp
face	yüz
brand	marka
discount	indirim
effects	Etkileri
created	oluşturulan
standards	standartlar
bit	bit
political	siyasi
kingdom	krallık
base	baz
doing	iş
loans	krediler
shoes	ayakkabı
entry	giriş
stay	kalmak
orders	emirler
availability	kullanılabilirlik
summary	özet
turn	dönüş
growth	büyüme
agency	Ajans
king	kral
european	Avrupa
activity	aktivite
copy	kopya
western	batı
force	Kuvvet
employment	iş
bay	Defne
river	nehir
commission	komisyon
package	paket
seen	görüldü
players	oyuncu
engine	motor
port	Liman
album	albüm
regional	bölgesel
stop	durdurmak
started	başladı
administration	yönetim
bar	bar
institute	enstitü
views	görünümler
double	çift
dog	köpek
soon	yakında
lines	hatlar
electronic	elektronik
benefits	faydaları
needed	gerekli
printer	yazıcı
condition	şart
effective	etkili
believe	inanmak
organization	organizasyon
effect	Efekt
mind	us
selection	seçim
casino	kumarhane
pdf	pdf
tour	tur
cross	çapraz
hope	umut
corporation	şirket
wish	dilek
solution	çözüm
mature	olgun
role	rol
weeks	haftalar
certain	belli
lower	alt
necessary	gerekli
union	Birlik
mon	Pazartesi
com	com
particular	belirli
fine	ince
hour	saat
gas	gaz
skills	becerileri
six	altı
bush	çalı
islands	adaları
advice	tavsiye
career	kariyer
decision	karar
leave	ayrılmak
pre	önceden
huge	Kocaman
woman	Kadın
facilities	tesisler
bid	teklif
middle	orta
cable	kablo
opportunities	fırsatlar
taking	alma
values	değerler
division	bölünme
coming	gelecek
object	nesne
lesbian	lezbiyen
appropriate	uygun
machine	makine
logo	logo
length	uzunluk
nice	Güzel
score	Gol
statistics	istatistik
client	müşteri
sample	Numune
investment	yatırım
sent	gönderilen
shown	gösterilen
christmas	Noel
culture	kültür
flash	flaş
ms	MS
choice	seçim
courses	dersler
consumer	tüketici
hi	Merhaba
foreign	yabancı
artist	sanatçı
furniture	mobilya
channel	kanal
letter	mektup
mode	kip
phones	telefonlar
ideas	fikirler
structure	yapı
degree	derece
contract	sözleşme
super	Süper
male	erkek
matter	madde
almost	neredeyse
located	bulunan
multiple	çoklu
distribution	dağıtım
editor	editör
inn	Han
industrial	Sanayi
potential	potansiyel
song	şarkı
los	los
fall	düşmek
idea	Fikir
rooms	Odalar
communications	iletişim
win	kazanmak
primary	birincil
cancer	kanser
numbers	sayılar
reason	neden
tool	araç
spring	bahar
foundation	vakıf
answer	Cevap
voice	ses
schedule	program
documents	evraklar
purpose	amaç
feature	özellik
bed	yatak
comes	geliyor
police	polis
independent	bağımsız
approach	yaklaşım
brown	kahverengi
physical	fiziksel
hill	Tepe
maps	haritalar
hold	ambar
ratings	derecelendirme
happy	mutlu
smith	demirci
developed	gelişmiş
thank	teşekkür
safe	kasa
unique	benzersiz
survey	anket
prior	önceki
telephone	telefon
sport	spor
ready	hazır
animal	hayvan
sources	kaynaklar
population	nüfus
pa	baba
regular	düzenli
secure	güvenli
operations	operasyonlar
simply	basitçe
evidence	kanıt
station	istasyon
understand	anlama
option	seçenek
valley	vadi
probably	muhtemelen
sea	deniz
publications	yayınlar
improve	iyileştirmek
connection	bağ
publisher	Yayımcı
hall	salon
anti	anti
networks	ağlar
earth	toprak
parents	ebeveyn
impact	darbe
transfer	Aktar
introduction	Giriş
kitchen	mutfak
strong	kuvvetli
wedding	düğün
properties	özellikleri
hospital	hastane
ground	zemin
ship	gemi
accommodation	Konaklama
disease	hastalık
excellent	mükemmel
perfect	mükemmel
hair	saç
opportunity	fırsat
kit	malzeme
classic	klasik
basis	temel
command	komuta
cities	şehirler
express	ekspres
award	ödül
distance	mesafe
tree	ağaç
assessment	değerlendirme
wall	duvar
involved	ilgili
el	el
extra	ekstra
especially	özellikle
budget	bütçe
guides	kılavuzlar
success	başarı
maximum	maksimum
ma	anne
operation	operasyon
existing	mevcut
quite	oldukça
selected	seçilmiş
boy	oğlan
restaurants	restoranlar
beautiful	güzel
warning	uyarı
locations	yerleri
horse	at
vote	oy
flowers	Çiçekler
stars	yıldızlar
lists	listeleri
owner	sahip
animals	hayvanlar
ways	yolları
son	oğul
providing	sağlama
rule	kural
housing	Konut
takes	alır
bring	getirmek
catalog	katalog
max	maksimum
mother	anne
authority	yetki
told	söyledi
programme	program
joined	katıldı
input	giriş
strategy	strateji
feet	ayaklar
agent	ajan
valid	geçerli
modern	modern
senior	kıdemli
sexy	seksi
teaching	öğretim
door	kapı
grand	büyük
trial	Deneme
units	birimler
cool	güzel
normal	normal
enterprise	kuruluş
ships	gemiler
entire	tüm
positive	pozitif
fitness	Fitness
chinese	Çince
opinion	görüş
football	Futbol
abstract	soyut
output	çıktı
funds	para
mr	Bay
likely	muhtemelen
develop	geliştirmek
artists	sanatçılar
alternative	alternatif
responsibility	sorumluluk
java	java
guest	konuk
publication	yayın
pass	pas
relations	ilişkiler
trust	güven
van	kamyonet
contains	içeren
multi	çok
republic	cumhuriyet
fees	harç
components	bileşenler
vacation	tatil
century	yüzyıl
academic	akademik
assistance	yardım
completed	tamamlanan
skin	cilt
graphics	grafik
indian	Hintli
ring	halka
grade	sınıf
mountain	dağ
organizations	organizasyonlar
filter	filtre
panel	panel
floor	zemin
buying	alış
match	maç
proposed	önerilen
require	gerektirir
boys	çocuklar
morning	sabah
allows	verir
protein	protein
plant	bitki
reported	rapor
hit	vurmak
mm	aa
pool	havuz
mini	mini
politics	siyaset
partner	ortak
authors	yazarlar
boards	panoları
fish	balık
membership	üyelik
mission	misyon
eye	göz
string	sicim
sense	duyu
modified	değiştirilmiş
released	yayınlandı
stage	evre
internal	iç
born	doğmuş
detailed	detaylı
japanese	Japonca
race	yarış
approved	onaylı
target	hedef
except	dışında
character	karakter
maintenance	bakım
ability	kabiliyet
ed	ed
rape	kolza
battery	pil
youth	gençlik
pressure	basınç
submitted	gönderilen
debt	borç
medium	orta
television	televizyon
interested	Ilgilenen
core	çekirdek
break	mola
purposes	amaçlar
sets	kümeler
dance	dans
wood	ahşap
defined	tanımlanmış
papers	kâğıtlar
awards	ödülleri
fee	ücret
studio	stüdyo
reader	okuyucu
device	cihaz
established	kurulmuş
answers	cevaplar
rent	kira
las	las
dark	karanlık
external	dış
apple	elma
le	le
instructions	Talimatlar
min	min
offered	sunulan
theory	teori
remove	Kaldır
aid	yardım
visual	görsel
host	evsahibi
variety	Çeşitlilik
teachers	öğretmenler
manual	Manuel
block	blok
subjects	konular
agents	ajanları
repair	onarım
fair	adil
steel	çelik
understanding	anlayış
songs	şarkılar
fixed	sabit
wrong	yanlış
beginning	başlangıç
hands	eller
az	az
paris	Paris
gets	alır
sector	sektör
capacity	kapasite
un	un
fat	şişman
father	baba
electric	elektrik
saw	testere
instruments	enstrümanlar
officer	subay
driver	sürücü
businesses	işletmeler
dead	ölü
unknown	Bilinmeyen
restaurant	restoran
mike	mikrofon
trip	gezi
mi	mi
poor	fakir
relationship	ilişki
workers	işçiler
peace	Barış
traditional	geleneksel
showing	gösterme
creative	yaratıcı
coast	sahil
benefit	yarar
funding	finansman
devices	cihazlar
lord	Kral
grant	hibe
sub	alt
fiction	kurgu
watches	saatler
careers	kariyer
goes	gider
led	Led
museum	müze
fan	yelpaze
transport	taşıma
interesting	ilginç
blogs	bloglar
evaluation	değerlendirme
former	eski
zone	bölge
complex	karmaşık
th	inci
cat	kedi
die	ölmek
presented	sunulan
flat	düz
flow	akış
agencies	ajanslar
literature	Edebiyat
parent	ebeveyn
setting	ayar
dr	dr
scale	ölçek
economy	ekonomi
helpful	faydalı
monthly	aylık
critical	kritik
frame	çerçeve
musical	müzikal
definition	tanım
secretary	Sekreter
path	yol
chief	şef
gives	verir
packages	paketler
detail	detay
laws	yasalar
changed	değişmiş
begin	başla
royal	royal
clean	temiz
guy	adam
titles	başlıkları
relevant	uygun
justice	adalet
connect	bağlamak
cup	Fincan
basket	sepet
applied	uygulamalı
weekly	haftalık
vol	cilt
installation	Kurulum
pp	s
attention	Dikkat
advance	ilerlemek
skip	atlamak
diet	diyet
army	ordu
gear	vites
difference	fark
allowed	izin
correct	doğru
nation	ulus
selling	satış
lots	çok
piece	parça
sheet	tabaka
firm	firma
seven	Yedi
elements	elementler
species	Türler
jump	atlama
cells	hücreler
module	modül
resort	çare
certificate	sertifika
minister	bakan
motion	hareket
fashion	moda
directions	talimatlar
visitors	Ziyaretçi
documentation	belgeleme
trading	ticari
forest	orman
calls	aramalar
coverage	kapsama
couple	çift
giving	vererek
chance	şans
vision	vizyon
ball	top
ending	bitirme
clients	istemciler
actions	eylemler
discuss	tartışmak
goal	hedef
successful	başarılı
sold	satıldı
wind	rüzgar
communities	topluluklar
clinical	klinik
situation	durum
markets	piyasalar
publishing	yayıncılık
appear	görünmek
developing	gelişen
lives	hayatları
determine	belirlemek
temperature	sıcaklık
announcements	duyurular
patient	hasta
actual	gerçek
historical	tarihi
stone	taş
bob	şilin
commerce	ticaret
persons	kişiler
difficult	zor
scientific	ilmi
satellite	uydu
tests	testler
village	köy
accounts	hesapları
amateur	amatör
ex	eski
met	met
pain	Ağrı
factors	faktörler
coffee	Kahve
buyer	alıcı
poster	afiş
edge	kenar
functional	fonksiyonel
root	kök
fi	fi
closed	kapalı
holidays	Bayram
pink	pembe
balance	denge
monitoring	izleme
replies	cevaplar
shot	atış
initial	ilk
label	etiket
sec	sek
canon	kanon
league	lig
waste	atık
minute	dakika
bus	otobüs
provider	sağlayan
dictionary	sözlük
accounting	muhasebe
manufacturing	imalat
sections	bölümler
chair	sandalye
effort	çaba
phase	faz
fantasy	fantezi
po	po
va	va
professor	profesör
install	kurmak
shirt	gömlek
apparel	giysi
foot	ayak
breast	meme
techniques	teknikleri
dollars	dolar
religion	din
permission	izin
wild	vahşi
generation	nesil
miss	bayan
chemical	kimyasal
doctor	doktor
task	görev
reduce	azaltmak
brought	getirdi
exercise	egzersiz
bug	böcek
guarantee	garanti
leader	lider
se	se
processes	süreçler
soft	yumuşak
meetings	toplantılar
seconds	saniye
flight	uçuş
congress	kongre
fuel	yakıt
walk	yürümek
produced	üretilmiş
saint	aziz
argument	tartışma
competition	yarışma
drugs	ilaçlar
joint	ortak
premium	ödül
fresh	taze
characters	karakterler
attorney	avukat
di	di
factor	faktör
thousands	binlerce
km	km
stream	Akış
apartments	daireler
pick	almak
hearing	işitme
eastern	doğu
therapy	terapi
entries	girdileri
signed	imzalı
administrative	idari
serious	ciddi
limit	sınır
steps	adımlar
shops	dükkanlar
bondage	esaret
del	del
efforts	çabaları
informed	bilgili
ga	ga
thoughts	düşünceler
creek	dere
ft	ft
quantity	miktar
essential	gerekli
tours	turlar
load	yük
immediately	hemen
machines	makineler
designated	belirlenmiş
heavy	ağır
covered	kapalı
recovery	kurtarma
integrated	entegre
configuration	yapılandırma
cock	horoz
merchant	tüccar
comprehensive	kapsamlı
expert	uzman
protect	korumak
solid	katı
presentation	sunum
became	oldu
orange	Portakal
compliance	uyma
theme	tema
rich	zengin
campaign	kampanya
vs	vs
guitar	gitar
finding	bulgu
examples	örnekler
spirit	ruh
ar	ar
claims	iddialar
acceptance	kabul
strategies	stratejiler
mo	mo
affairs	işler
intended	istenilen
sa	sa
goals	hedefleri
hire	kiralama
election	seçim
suggest	önermek
branch	şube
serve	servis
affiliates	bağlı
mount	dağ
latin	Latince
multimedia	multimedya
manage	yönetmek
corner	köşe
rank	rütbe
element	eleman
birth	doğum
virus	virüs
interactive	interaktif
requests	istekler
separate	ayrı
quarter	çeyrek
procedure	prosedür
leadership	liderlik
define	tanımlamak
religious	dini
facts	Gerçekler
breakfast	kahvaltı
column	kolon
faith	inanç
chain	Zincir
identify	belirlemek
avenue	cadde
missing	eksik
recommendations	tavsiyeler
moved	taşındı
reach	ulaşmak
comparison	karşılaştırma
moment	an
extended	Genişletilmiş
sequence	sıra
inch	inç
attack	saldırı
centers	merkezleri
opening	açılış
lab	laboratuvar
reserve	rezerv
gamma	gama
produce	üretmek
truth	hakikat
counter	sayaç
failure	başarısızlık
follows	şu
dollar	dolar
camp	kamp
des	des
films	filmler
bridge	köprü
fill	doldurmak
movement	hareket
printing	baskı
draft	taslak
chart	grafik
played	Oyunun
contacts	kontaklar
readers	okuyucular
clubs	kulüpleri
wa	WA
adventure	macera
offering	teklif
profit	kâr
leaders	liderler
posters	afişler
institutions	kurumlar
assistant	asistan
variable	değişken
dj	dj
parking	otopark
yesterday	dün
determined	belirlenen
workshop	atölye
gone	gitmiş
codes	kodlar
kinds	çeşit
extension	uzantı
statements	ifadeleri
completely	tamamen
teams	takımlar
fort	kale
cm	santimetre
senate	senato
funny	komik
gene	gen
turned	dönük
disc	disk
pattern	Desen
boat	tekne
theatre	tiyatro
manufacturers	üreticileri
sponsor	sponsor
classical	klasik
icon	ikon
warranty	garanti
dedicated	adanmış
direction	yön
basketball	Basketbol
objects	nesneleri
delete	silmek
evening	akşam
assembly	montaj
nuclear	nükleer
mouse	fare
signal	işaret
criminal	adli
issued	Veriliş
powerful	güçlü
dream	rüya
FALSE	YANLIŞ
da	da
cast	oyuncular
flower	çiçek
personnel	personel
passed	geçti
supplied	verilen
falls	düşme
soul	ruh
promote	desteklemek
stated	belirtilen
stats	istatistikler
professionals	profesyoneller
appears	belirir
carry	Taşımak
flag	bayrak
covers	kapaklar
em	em
advantage	avantaj
hello	Merhaba
designs	tasarımlar
maintain	sürdürmek
tourism	turizm
priority	öncelik
adults	yetişkinler
graphic	grafik
atom	atom
payments	ödemeler
binding	bağlayıcı
brief	kısa
ended	Bitti
winning	kazanan
anonymous	anonim
script	senaryo
served	hizmet
wants	istiyor
prepared	hazırlanmış
void	geçersiz
tag	etiket
interview	röportaj
mix	karıştırmak
framework	iskelet
disk	disk
installed	Kurulmuş
queen	kraliçe
credits	kredi
clearly	Açıkça
fix	düzeltmek
handle	sap
sweet	tatlı
criteria	kriterleri
associate	ortak
ne	ne
behavior	davranış
enlarge	büyütmek
ray	ışın
revenue	gelir
measure	ölçmek
votes	oy
du	du
duty	görev
discussions	tartışmalar
bear	ayı
gain	kazanç
festival	Festival
laboratory	laboratuvar
ocean	okyanus
flights	uçuşlar
experts	uzmanlar
signs	işaretler
depth	derinlik
train	tren
dry	kuru
explore	keşfetmek
spa	spa
concept	kavram
nearly	neredeyse
handling	kullanma
origin	Menşei
billion	milyar
intelligence	zeka
bought	satın
con	aleyhte
nations	milletler
route	rota
broken	kırık
battle	savaş
speak	konuşmak
protocol	protokol
query	sorgu
partnership	ortaklık
expression	ifade
es	es
speech	konuşma
wire	tel
suggestions	öneri
replacement	değiştirme
tape	bant
strategic	stratejik
judge	hakim
acid	asit
bytes	bayt
cent	sent
forced	zorunlu
compatible	uyumlu
apartment	apartman
null	boş
zero	sıfır
speaker	konuşmacı
consulting	Danışmanlık
designer	tasarımcı
pr	pr
marriage	evlilik
roll	rulo
banks	bankalar
fr	fr
participants	katılımcılar
secret	gizli
negative	negatif
favorites	Favoriler
theater	tiyatro
springs	yaylar
var	var
perform	yapmak
translation	çeviri
estimates	tahminler
injury	hasar
ministry	bakanlık
drivers	sürücüler
lawyer	avukat
figures	rakamlar
protected	korumalı
proposal	öneri
sharing	paylaşım
portal	kapı
beta	beta
gratis	bedava
toward	karşı
slightly	hafifçe
assist	yardım
conduct	davranış
contained	içeriyordu
legislation	mevzuat
calling	çağrı
parameters	parametreler
profiles	profiller
matters	hususlar
houses	evler
controls	kontroller
combined	kombine
ultimate	nihai
representative	temsilci
minor	küçük
departments	bölümler
residents	sakinleri
displayed	görüntülenen
mom	anne
reduced	indirimli
rare	nadir
performed	gerçekleştirilen
extreme	aşırı
samples	örnekler
bars	Barlar
forecast	tahmin
removed	çıkarıldı
cycle	Çevrim
contain	içermek
accuracy	doğruluk
sleep	uyku
mg	mg
bird	kuş
pharmacy	eczane
creation	oluşturma
static	statik
hunter	avcı
addresses	adresler
lady	bayan
crystal	kristal
famous	ünlü
writer	yazar
chairman	başkan
drink	içki
academy	akademi
dynamic	dinamik
eat	yemek
permanent	kalıcı
cleaning	temizlik
constitutes	teşkil
portfolio	portföy
practical	pratik
delivered	teslim
infrastructure	altyapı
colour	renk
vendor	satıcı
philosophy	Felsefe
regulation	düzenleme
officers	görevlileri
aim	amaç
bids	teklifleri
nutrition	beslenme
recording	kayıt
junior	genç
les	les
cape	pelerin
rings	halkalar
tip	bahşiş
wonderful	olağanüstü
ticket	bilet
announced	açıkladı
guess	tahmin
whom	kime
soccer	Futbol
math	matematik
import	ithalat
posting	gönderme
presence	varlık
automatic	otomatik
viewing	görüntüleme
maintained	muhafaza
ch	ch
dan	dan
dogs	köpekler
directors	yönetmenler
aspects	yönleri
ahead	önde
moon	ay
participation	katılım
scheme	düzen
fly	sinek
manner	tavır
matrix	matris
combination	kombinasyon
amendment	düzeltme
strength	kuvvet
turkey	Türkiye
libraries	kütüphaneler
proper	uygun
degrees	derece
enterprises	işletmelerin
delta	delta
fear	korku
seeking	arayan
inches	inç
convention	Kongre
shares	hisseleri
principal	asıl
comfort	konfor
colors	renkler
wars	savaşlar
ordering	sipariş
kept	tuttu
alpha	alfa
appeal	temyiz
cruise	seyir
bonus	bonus
hey	Hey
buildings	binalar
specials	özel
beat	dövmek
batteries	piller
becomes	olur
drives	sürücüler
arms	silâh
tea	Çay
improved	gelişmiş
achieve	başarmak
positions	pozisyonları
dress	elbise
subscription	abone
dealer	satıcı
contemporary	çağdaş
sky	gökyüzü
rom	ROM
carried	taşınan
exposure	poz
hide	saklamak
signature	imza
miller	değirmenci
provision	hüküm
clothes	çamaşırlar
frames	çerçeveler
certainly	kesinlikle
newspaper	gazete
toy	oyuncak
layer	tabaka
printed	basılı
slow	yavaş
removal	uzaklaştırma
liability	yükümlülük
printers	yazıcılar
adding	ekleme
spot	yer
spend	harcamak
factory	fabrika
interior	iç
grow	büyümek
optical	optik
promotion	tanıtım
relative	bağıl
amazing	şaşırtıcı
dot	nokta
identity	Kimlik
conversion	dönüştürme
feeling	duygu
hidden	gizli
reasonable	makul
revision	revizyon
influence	etki
ratio	oran
importance	önem
rain	yağmur
planet	gezegen
copies	kopyalar
permit	izin
seeing	görme
proof	kanıt
bass	bas
prescription	reçete
empty	boş
instance	örnek
hole	delik
ride	binmek
bureau	büro
conservation	koruma
pair	çift
ideal	ideal
specs	gözlük
recorded	kaydedilmiş
don	don
pieces	parçalar
finished	bitmiş
parks	parklar
lawyers	avukatları
stress	stres
cream	krem
ss	ss
runs	koşar
discover	keşfetmek
ap	ap
patterns	desenler
hills	tepeler
nm	mil
advisor	danışman
aware	farkında
shape	şekil
evolution	evrim
certificates	sertifikalar
objectives	hedefleri
stations	istasyonlar
suggested	önerdi
op	op
remains	kalıntılar
firms	firmalar
euro	euro
operator	Şebeke
structures	yapıları
generic	genel
encyclopedia	ansiklopedi
usage	kullanım
ink	mürekkep
mixed	karışık
census	sayım
wheel	tekerlek
suppliers	tedarikçileri
compact	kompakt
poetry	şiir
lights	ışıklar
tracking	izleme
angel	melek
preparation	hazırlık
attempt	girişim
receiving	kabul
matches	maçlar
accordance	uyum
width	Genişlik
engines	motorlar
forget	unutmak
array	dizi
discussed	tartışılan
accurate	doğru
climate	iklim
greek	Yunan
instruction	talimat
managing	yönetme
raw	çiğ
differences	farklar
explain	açıklamak
establish	kurmak
expressed	ifade
extent	derece
sharp	keskin
ben	ben
paragraph	paragraf
kill	öldürmek
mathematics	matematik
compensation	tazminat
export	ihracat
managers	yöneticileri
modules	modüller
conducted	yürütülen
versions	versiyonları
knows	bilir
describe	tanımlamak
citizens	vatandaşlar
heritage	miras
trouble	sorun
coach	Koç
agricultural	tarım
expand	genişletmek
audience	seyirci
assigned	atanmış
collections	koleksiyonları
ages	yaşlar
specialist	uzman
cook	pişirmek
affect	etkilemek
virgin	bakire
experienced	deneyimli
investigation	soruşturma
raised	kalkık
hat	şapka
institution	kurum
directed	yönlendirilmiş
affected	etkilenmiş
bike	bisiklet
totally	bütünüyle
plate	plaka
expenses	giderler
indicate	belirtmek
blonde	sarışın
proceedings	kovuşturma
favourite	favori
characteristics	karakteristikleri
der	der
lose	kaybetmek
organic	organik
seek	aramak
experiences	deneyimler
albums	albüm
contracts	sözleşmeler
guests	misafir
hosted	barındırılan
diseases	hastalıklar
concerning	ilişkin
equivalent	eşdeğer
chemistry	kimya
kits	kitleri
logic	mantık
prince	prens
circle	daire
soil	toprak
psychology	Psikoloji
wet	ıslak
circumstances	koşullar
investor	yatırımcı
elementary	temel
sponsors	sponsorlar
fox	tilki
unlimited	sınırsız
respond	yanıtlamak
sizes	boyutları
plain	sade
exit	çıkış
arm	kol
keys	anahtarlar
wave	dalga
holy	kutsal
acts	eylemler
guidance	rehberlik
trail	iz
symbol	sembol
highway	karayolu
observed	gözlenen
dean	dekan
setup	kurmak
poll	anket
styles	stilleri
filled	dolu
bond	bağ
channels	kanallar
appendix	apandis
chocolate	çikolata
portion	kısım
scope	kapsam
supplier	satıcı
cables	kablolar
cotton	pamuk
requirement	gereklilik
killed	öldürdü
border	sınır
ancient	eski
debate	tartışma
representatives	temsilcileri
starts	başlar
pregnancy	gebelik
attractions	konumlar
learned	bilgili
transactions	işlemler
explorer	kâşif
historic	tarihi
husband	koca
authorized	yetkili
crazy	çılgın
upcoming	yaklaşan
concert	konser
scores	Skorlar
efficiency	verim
comedy	komedi
adopted	benimsenen
efficient	verimli
linear	doğrusal
commitment	taahhüt
specialty	uzmanlık
bears	ayılar
hop	atlama
carrier	taşıyıcı
constant	sabit
visa	Visa
mouth	ağız
meter	metre
linked	bağlantılı
interviews	görüşmeler
concepts	kavramlar
gun	tabanca
reflect	yansıtmak
pure	saf
hell	cehennem
fruit	meyve
begins	başlar
qualified	nitelikli
reform	reform
lens	lens
treated	işlenmiş
discovery	keşif
draw	çekmek
classified	sınıflandırılmış
assume	üstlenmek
alliance	ittifak
confirm	onaylamak
engineer	mühendis
consistent	tutarlı
replace	değiştirmek
clearance	Boşluk
converter	dönüştürücü
organisation	organizasyon
babe	bebek
checks	çekler
reached	ulaştı
becoming	olma
objective	amaç
indicated	belirtilen
sugar	şeker
crew	mürettebat
legs	bacaklar
stick	Çubuk
relation	ilişki
enabled	etkin
genre	Tür
volunteer	gönüllü
rear	arka
democratic	demokratik
enhance	artırmak
exact	kesin
bound	ciltli
parameter	parametre
processor	işlemci
node	düğüm
formal	biçimsel
storm	fırtına
micro	mikro
colleges	kolejler
mile	mil
challenges	zorluklar
editors	editörler
supreme	yüce
brothers	Kardeşler
recognition	tanıma
ref	ref
estimate	tahmin
kid	çocuk
inspection	teftiş
consumers	tüketicilerin
limits	sınırları
territory	bölge
weapons	silahlar
delay	gecikme
pilot	pilot
contributions	katkıları
continuous	sürekli
initiative	girişim
novel	yeni
execution	icra
disability	sakatlık
ultra	ultra
winner	kazanan
episode	bölüm
potter	çömlekçi
dish	tabak
plays	oyunlar
bulletin	bülten
ia	ia
modify	değiştirmek
truly	gerçekten
universe	Evren
candidate	aday
slot	yarık
outstanding	ödenmemiş
ha	Ha
planned	planlı
lodge	loca
mirror	ayna
tournament	turnuva
consideration	düşünce
sessions	oturumları
kernel	çekirdek
buyers	alıcılar
journals	dergi
gray	gri
catalogue	katalog
charged	yüklü
broad	geniş
und	und
chosen	seçilmiş
demo	gösteri
hate	nefret
terminal	terminal
publishers	yayıncılar
nights	gece
liquid	sıvı
rice	pirinç
reservation	rezervasyon
foods	gıdalar
guard	bekçi
saving	tasarruf
empire	imparatorluk
newly	yeni
raise	yükseltmek
illegal	yasadışı
expansion	genişleme
premier	başbakan
tomorrow	yarın
milk	Süt
drama	dram
visiting	ziyaret
contest	yarışma
collected	toplanmış
bands	bantları
suitable	uygun
absolutely	kesinlikle
audit	denetim
chamber	bölme
guinea	Gine
findings	bulgular
iso	iso
typical	tipik
sum	toplam
chicken	tavuk
temporary	geçici
attend	katılmak
shower	duş
sending	gönderme
sufficient	yeterli
shell	kabuk
province	il
catholic	liberal
governor	Vali
beer	bira
contribution	katkı
formula	formül
constitution	anayasa
packaging	paketleme
reliable	dürüst
doubt	şüphe
earn	kazanmak
periods	dönemleri
attacks	saldırılar
merchandise	mal
symptoms	semptomlar
memorial	anıt
twin	ikiz
insert	eklemek
gateway	geçit
drawing	çizim
candidates	adaylar
ordered	düzenli
biological	biyolojik
fighting	kavga
transition	geçiş
preferences	tercihleri
spy	casus
romance	romantik
instrument	enstrüman
split	Bölünmüş
themes	temalar
powers	güçler
heaven	cennet
bits	bit
pregnant	hamile
classification	sınıflandırma
focused	odaklı
physician	doktor
asking	sormak
blocks	bloklar
lo	bak
spiritual	manevi
diabetes	diyabet
ml	mi
shift	vardiya
sit	oturmak
bodies	bedenler
photographs	fotoğraflar
cutting	kesim
writers	yazarlar
flexible	esnek
loved	sevilen
favourites	Favoriler
mapping	haritalama
numerous	sayısız
relatively	Nispeten
represents	temsil
superior	üstün
preferred	tercihli
saved	kaydedilmiş
intellectual	entellektüel
granted	verilmiş
carbon	karbon
comfortable	rahat
magnetic	manyetik
interaction	etkileşim
listening	dinleme
crisis	kriz
outlook	görünüm
massive	masif
bright	parlak
formed	oluşturulan
piano	piyano
echo	Eko
revolution	devrim
displays	görüntüler
plasma	plazma
earnings	kazanç
mystery	gizem
landscape	peyzaj
mechanical	mekanik
journey	seyahat
banner	afiş
fig	incir
counties	ilçeler
acquisition	edinme
recognized	tanınan
dreams	rüyalar
notification	bildirim
kg	kilogram
teach	öğretmek
rapid	hızlı
pull	Çek
ut	ut
seminar	seminer
investments	yatırımlar
wheels	tekerlekler
specify	belirtmek
sensitive	hassas
templates	şablonları
formats	formatları
holds	tutar
router	yönlendirici
concrete	beton
si	si
folder	Klasör
completion	tamamlama
pulse	nabız
technique	teknik
voting	oylama
courts	mahkemeler
converted	dönüştürülmüş
metro	metro
anniversary	yıldönümü
improvements	iyileştirmeler
strip	şerit
specification	Şartname
accident	kaza
nick	Nick
accessible	ulaşılabilir
resident	oturan
plot	arsa
typically	tipik
representation	temsil
pump	pompa
exists	var
arrangements	düzenlemeler
conferences	konferanslar
consumption	tüketim
narrow	dar
threat	tehdit
surveys	anketler
sitting	oturma
consultant	danışman
controller	kontrolör
committees	komiteler
penis	penis
castle	kale
gardens	bahçeleri
labels	etiketler
willing	istekli
bio	biyo
acting	oyunculuk
heads	kafaları
exam	sınav
residence	Konut
density	yoğunluk
hundred	yüz
strange	garip
sustainable	sürdürülebilir
statistical	istatistiksel
mention	Anma
innovation	yenilik
grey	gri
parallel	paralel
operate	işletmek
bills	fatura
stable	kararlı
definitions	tanımlar
von	von
doctors	doktorlar
lesson	ders
cinema	sinema
elections	seçimler
reaction	reaksiyon
blank	boş
enhanced	gelişmiş
entitled	adlı
severe	şiddetli
generate	üretmek
newspapers	gazeteler
hospitals	hastaneler
vi	vi
humor	Mizah
aged	yaşlı
monitors	monitör
exception	istisna
duration	süre
bulk	kütle
visits	ziyaret
capabilities	yetenekleri
recommendation	tavsiye
sin	günah
organized	örgütlü
ba	ba
para	paragraf
adoption	Benimseme
improving	geliştirme
expensive	pahalı
buffalo	bizon
organisations	organizasyonlar
plane	uçak
programmes	programlar
mechanism	mekanizma
ee	ee
marked	işaretlenmiş
driven	tahrik
bottle	şişe
innovative	yenilikçi
massage	masaj
conclusion	Sonuç
closing	kapanış
thousand	bin
legend	efsane
villa	villa
bone	kemik
columns	sütunlar
disorders	bozukluklar
collaboration	işbirliği
detection	bulma
inner	iç
formation	formasyon
med	med
engineers	mühendisler
entity	varlık
cruises	yolculukları
gate	kapı
roman	Roma
duties	görevleri
erotic	erotik
tone	ton
ethics	ahlâk
dragon	Ejderha
busy	meşgul
captain	Kaptan
brings	getiriyor
heating	ısıtma
leg	bacak
neck	boyun
wing	kanat
scripts	senaryo
abc	ABC
appointed	döşenmiş
dealing	muamele
commit	işlemek
rail	Demiryolu
trips	gezileri
gap	boşluk
sides	taraf
tube	tüp
corresponding	uyan
descriptions	açıklamaları
belt	kemer
jacket	ceket
animation	animasyon
oracle	torpil
er	er
productions	yapımları
aviation	havacılık
proud	gururlu
disaster	afet
console	konsol
commands	komutlar
jr	jr
telecommunications	telekomünikasyon
instructor	eğitmen
giant	dev
achieved	elde
injuries	yaralanmalar
approaches	yaklaşımlar
usual	olağan
stamps	pullar
angle	açı
rob	soymak
designers	tasarımcılar
liberty	özgürlük
era	çağ
convert	dönüştürmek
possibility	olasılık
analyst	analist
dangerous	tehlikeli
reliability	güvenilirlik
respectively	sırasıyla
volunteers	gönüllüler
derived	türetilmiş
pleasure	Zevk
honor	Onur
oriented	yönlü
eagle	kartal
prayer	namaz
workshops	atölyeler
hurricane	kasırga
quiet	sessiz
producer	yapımcı
represented	temsil
responsibilities	sorumluluklar
cheese	peynir
carefully	dikkatlice
productivity	verimlilik
crown	taç
par	eşitlik
diagnosis	Teşhis
maker	yapıcı
crack	çatlak
principle	prensip
picks	seçtikleri
gang	çete
fetish	fetiş
appearance	görünüm
smoke	duman
filters	filtreler
incorporated	Anonim
craft	zanaat
fellow	adam
blind	kör
lounge	salon
mad	deli
algorithm	algoritma
strongly	şiddetle
cafe	kafe
ken	ken
proteins	proteinler
su	su
familiar	tanıdık
capable	yetenekli
admission	kabul
shoe	ayakkabı
elected	seçildi
carrying	taşıma
terrorism	terörizm
joy	sevinç
editions	sürümleri
ethnic	etnik
parliament	parlamento
actor	aktör
finds	buluntular
seal	mühür
situations	durumlar
fifth	beşinci
citizen	vatandaş
vertical	dikey
corrections	düzeltmeler
describes	açıklar
disabilities	engelli
substance	madde
prohibited	yasak
pipe	boru
soldiers	askerler
guardian	Gardiyan
lecture	ders
simulation	simülasyon
layout	düzen
initiatives	girişimler
ill	hasta
concentration	konsantrasyon
lay	yatırmak
interpretation	yorumlama
dirty	kirli
taught	öğretilen
worker	işçi
optimization	optimizasyon
temple	tapınak
substances	maddeler
prove	kanıtlamak
discovered	keşfedilen
wings	kanatlar
genetic	genetik
restrictions	kısıtlamalar
thin	ince
exhibition	sergi
ridge	sırt
modem	modem
bringing	getiren
sick	hasta
evaluate	değerlendirmek
tropical	tropikal
collect	toplamak
vector	vektör
definitely	kesinlikle
turning	döndürme
existence	varoluş
commentary	yorum
developments	gelişmeler
immigration	göç
destinations	yerler
mutual	karşılıklı
syntax	sözdizimi
li	li
attribute	nitelik
prison	hapis
skill	beceri
chairs	sandalye
surrounding	çevreleyen
mountains	dağlar
popularity	popülerlik
inquiry	soruşturma
checked	kontrol
exhibit	sergi
throw	atmak
trend	akım
cats	kediler
desert	çöl
ya	ya
coordinator	koordinatör
mercury	Merkür
burning	yanan
escape	kaçış
receiver	alıcı
progressive	ilerici
boats	tekneler
championship	şampiyonluk
arcade	çarşı
impossible	imkansız
tells	anlatır
obvious	açık
depression	depresyon
graph	grafik
covering	kaplama
platinum	platin
judgment	yargı
talks	görüşmeler
filing	dosyalama
foster	beslemek
awarded	layık
trials	denemeler
masters	ustaları
cartridge	kartuş
explanation	açıklama
org	org
fraud	dolandırıcılık
electricity	elektrik
spectrum	spektrum
arrival	varış
pottery	çömlekçilik
emphasis	vurgu
awesome	müthiş
confirmed	onaylı
counts	sayımları
crash	kaza
lift	asansör
inter	arası
heights	yükseklikleri
shadow	gölge
expense	gider
venture	girişim
clinic	klinik
healing	şifa
princess	prenses
entering	girme
packet	paket
studios	stüdyoları
involvement	ilgi
dad	baba
buttons	düğmeleri
placement	yerleştirme
observations	gözlemler
winners	kazananlar
roads	yollar
subsequent	sonraki
yard	avlu
disclosure	ifşa
establishment	kuruluş
memories	hatıralar
te	te
creates	yaratır
faces	yüzleri
tourist	turist
murder	cinayet
adequate	yeterli
senator	senatör
presentations	sunumlar
digest	özet
dust	toz
wiki	wiki
replaced	değiştirilir
radar	radar
losses	kayıplar
combat	savaş
reducing	indirgen
stopped	durduruldu
occupation	Meslek
closely	yakından
radiation	radyasyon
kings	krallar
shooting	çekim
ear	kulak
flags	bayraklar
baker	fırıncı
conservative	muhafazakâr
shock	şok
effectiveness	etki
tie	kravat
roof	çatı
demonstrate	göstermek
atmosphere	atmosfer
kiss	öpücük
beast	canavar
ra	ra
operated	ameliyat
experiment	deney
targets	hedefler
purchases	alımları
federation	federasyon
pizza	Pizza
invited	davet
assignment	atama
mod	şık
queries	sorguları
absence	yokluk
vendors	satıcıları
yoga	yoga
serves	vermektedir
surprise	sürpriz
lamp	Lamba
jokes	espriler
counseling	danışmanlık
palace	Saray
satisfied	memnun
wins	kazanç
warehouse	depo
supposed	sözde
ordinary	sıradan
ghost	hayalet
violation	ihlal
boss	patron
pride	gurur
expectations	beklentiler
independence	bağımsızlık
knowing	bilme
reporter	muhabir
metabolism	metabolizma
champion	şampiyon
personally	Şahsen
plenty	bol
solo	solo
throat	boğaz
wealth	servet
vacuum	vakum
dancing	dans
recognize	tanımak
writes	yazıyor
plaza	plaza
quest	araştırma
publish	Yayınla
screening	tarama
trans	trans
pioneer	öncü
forgotten	unutulmuş
acrobat	akrobat
plates	plakalar
essays	denemeler
behaviour	davranış
telling	söylüyorum
fairly	oldukça
intelligent	akıllı
modes	modları
obligation	yükümlülük
harbor	liman
traveler	gezgin
segment	bölüm
enemy	düşman
puzzle	bulmaca
wells	kuyular
restricted	kısıtlı
republican	cumhuriyetçi
secrets	sırlar
syndrome	sendrom
attendance	katılım
penalty	ceza
drum	davul
enables	sağlayan
builder	kurucu
vista	manzara
flood	sel
ease	kolaylaştırmak
arguments	argümanlar
arena	arena
adventures	maceralar
pupils	öğrenciler
announcement	duyuru
outcome	sonuç
appreciate	anlamak
expanded	genişletilmiş
grown	yetişkin
lovely	güzel
centres	merkezleri
clause	fıkra
smile	gülümseme
lands	topraklar
troops	asker
armed	silâhlı
pine	çam
cooling	soğutma
gulf	körfez
trucks	kamyonlar
mechanisms	mekanizmalar
divorce	boşanma
tradition	gelenek
pills	haplar
tiger	kaplan
folks	arkadaşlar
sensor	algılayıcı
exposed	maruz
hunt	av
angels	melekler
deputy	milletvekili
thai	Tayland
emissions	emisyonları
physicians	hekimler
complaint	şikâyet
scenes	sahneler
experiments	deneyler
boost	artırmak
governance	Yönetim
mill	değirmen
founded	kurulmuş
chronic	kronik
den	den
finger	parmak
keeps	tutar
pound	pound
locate	yerleştirmek
pl	pl
trained	eğitilmiş
implementing	uygulanması
bread	ekmek
motors	motorlar
tough	sert
incident	olay
dynamics	dinamik
lie	Yalan
conversation	konuşma
decrease	azaltmak
worship	ibadet
capability	kabiliyet
ak	ak
precision	hassas
damages	tazminat
reserves	rezervler
solve	çözmek
minority	azınlık
diverse	çeşitli
ingredients	malzemeler
ah	Ah
tones	sesleri
rehabilitation	rehabilitasyon
sight	görme
clay	kil
weak	zayıf
divided	bölünmüş
reception	resepsiyon
wise	bilge
odds	olasılık
seminars	seminer
consequences	sonuçları
makers	vericiler
geography	coğrafya
integrity	bütünlük
legacy	miras
pleased	memnun
danger	Tehlike
vitamin	vitamin
processed	işlenmiş
phrase	ifade
raising	yükselen
implications	etkileri
functionality	işlevselliği
paradise	cennet
hybrid	melez
reads	okur
emotional	duygusal
glory	şan
ja	ja
geographic	coğrafi
exceed	aşmak
rod	çubuk
silk	ipek
babies	bebekler
bi	bi
romantic	romantik
revealed	ortaya
specialists	uzmanlar
generator	jeneratör
suspension	süspansiyon
sad	üzgün
correction	düzeltme
wolf	Kurt
slowly	yavaşça
supplement	ek
portions	bölümleri
infant	bebek
sectors	sektörler
fluid	akışkan
grounds	zeminler
meal	yemek
ta	ta
machinery	makinalar
equation	denklem
baskets	sepetler
probability	olasılık
dimension	boyut
studied	okudu
profits	kar
devil	şeytan
grass	çimen
illustrated	resimli
cherry	Kiraz
continental	kıta
achievement	başarı
limitations	sınırlamaları
funeral	cenaze
chapters	bölümler
passenger	yolcu
convenient	uygun
mars	Mars
sized	boy
egg	Yumurta
signals	sinyalleri
orientation	oryantasyon
theft	Çalınması
childhood	çocukluk
symbols	semboller
lat	lat
meta	meta
analog	analog
talent	yetenek
dated	tarihli
wisdom	bilgelik
boundary	sınır
elite	seçkinler
gi	gi
believes	inanır
poems	şiirler
jurisdiction	yargı
robot	robot
displaying	sergileyen
witness	tanık
equipped	donanımlı
stages	aşamaları
sur	sur
acquired	Edinilen
assess	belirlemek
wash	yıkama
entrance	Giriş
declaration	deklarasyon
losing	kaybetme
attempts	denemeler
noble	asil
automation	otomasyon
impacts	etkiler
rev	devir
advantages	avantajları
knight	şövalye
aims	Amaçları
extensions	uzantılar
appeals	itirazlar
illness	hastalık
ho	ho
alternatives	alternatifleri
sh	sh
soap	sabun
jam	reçel
unusual	olağandışı
answered	cevap
destruction	imha
migration	göç
disorder	düzensizlik
conventional	Konvansiyonel
wearing	giyme
axis	eksen
sought	aranan
genes	genler
median	medyan
scanner	tarayıcı
herein	burada
animated	canlandırılmış
adjustment	ayarlama
hero	kahraman
treatments	tedaviler
attitude	tutum
carpet	halı
lenses	lensler
attended	katıldı
difficulty	zorluk
punk	punk
coalition	koalisyon
enrollment	kayıt
duke	dük
pace	hız
producers	üreticileri
arc	yay
interfaces	arayüzleri
atlas	Atlas
observation	gözlem
torture	işkence
deleted	silindi
coat	ceket
restoration	restorasyon
convenience	Kolaylık
returning	dönen
opposition	muhalefet
container	konteyner
defendant	sanık
supervisor	gözetmen
corps	kolordu
actors	aktörler
liver	karaciğer
liable	sorumlu
petition	dilekçe
antenna	anten
picked	seçilmiş
belief	inanç
killing	öldürme
shoulder	omuz
decor	dekor
ion	iyon
diameter	çap
podcast	podcast
interactions	etkileşimler
singer	şarkıcı
herald	haberci
aging	yaşlanma
intervention	müdahale
plugin	Eklenti
attraction	cazibe
diving	dalış
modification	değişiklik
suppose	varsaymak
reed	kamış
involve	dahil
moderate	ılımlı
mice	fareler
understood	anladım
rapidly	hızla
ban	yasak
assurance	güvence
happening	olay
vast	Muazzam
mills	üreticiler
outline	taslak
receives	aldığı
jeans	kot
compilation	derleme
odd	garip
sigma	sigma
gr	gr
attractive	çekici
occasion	fırsat
recordings	kayıtları
victim	kurban
demands	talepler
careful	dikkatli
beam	kiriş
gardening	Bahçıvanlık
obligations	yükümlülükleri
arrive	varmak
orchestra	orkestra
licence	lisans
adjustable	ayarlanabilir
allocation	tahsis
essay	deneme
demonstrated	gösterdi
dialogue	diyalog
camps	kampları
declared	beyan
trace	iz
shut	kapamak
packs	paketleri
