of	arasında
to	için
in	içinde
for	için
is	olduğu
on	üzerinde
that	o
by	tarafından
this	bu
with	ile
i	ben
you	sen
it	o
or	veya
be	olmak
are	Hangi
at	en
all	herşey
have	var
new	yeni
we	Biz
will	irade
home	ev
us	bize
about	hakkında
if	Eğer
page	sayfa
my	benim
has	vardır
search	arama
free	ücretsiz
but	fakat
our	bizim
one	bir
other	diğer
do	yap
information	bilgi
time	zaman
he	o
which	hangi
their	onların
news	haber
use	kullanım
there	Orada
see	görmek
so	yani
who	kim
web	ağ
also	Ayrıca
get	almak
pm	pm
view	görünüm
c	c
e	e
first	ilk
been	olmuştur
would	olur
were	idi
s	s
like	sevmek
x	x
than	göre
find	bulmak
price	fiyat
back	geri
top	üst
people	insanlar
had	vardı
list	liste
name	isim
just	sadece
year	yıl
day	gün
into	içine
two	iki
health	sağlık
n	n
re	yeniden
used	Kullanılmış
go	gitmek
b	b
last	son
make	Yapmak
them	onları
should	meli
product	ürün
system	sistem
post	posta
her	ona
city	Kent
t	t
policy	politika
number	numara
support	destek
message	mesaj
after	sonra
then	sonra
jan	Ocak
good	iyi
d	d
where	nerede
info	bilgi
rights	haklar
books	kitaplar
high	yüksek
school	okul
m	m
each	her
links	bağlantılar
she	o
years	yıl
order	sipariş
very	çok
book	kitap
items	ürün
company	şirket
r	r
read	okumak
group	grup
sex	seks
many	çok
user	kullanıcı
de	de
set	set
general	genel
research	Araştırma
university	Üniversite
january	Ocak
mail	posta
full	tam
reviews	yorumlar
program	program
know	bilmek
games	oyunlar
way	yol
days	günler
p	p
part	Bölüm
could	could
great	harika
united	birleşmiş
real	gerçek
f	f
international	Uluslararası
center	merkez
travel	seyahat
comments	yorumlar
made	yapılmış
development	gelişme
report	rapor
member	üye
details	ayrıntılar
line	hat
terms	şartlar
before	önce
hotels	oteller
did	did
send	göndermek
right	sağ
type	tip
local	yerel
those	bu
results	Sonuçlar
office	ofis
national	Ulusal
car	araba
design	dizayn
take	almak
posted	gönderildi
address	adres
community	topluluk
within	içinde
states	devletler
want	istemek
phone	telefon
dvd	DVD
subject	konu
between	arasında
forum	forum
family	aile
l	l
long	uzun
w	w
show	göstermek
o	O
even	Üstelik
black	siyah
special	özel
index	indeks
being	olmak
women	KADIN
much	çok
sign	işaret
file	dosya
link	bağlantı
open	açık
south	güney
case	dava
project	proje
pages	sayfalar
version	versiyon
section	Bölüm
own	kendi
house	ev
security	güvenlik
g	g
county	kontluk
american	Amerikan
photo	Fotoğraf
game	oyun
members	üyeler
power	güç
network	ağ
computer	bilgisayar
systems	sistemler
three	üç
place	yer
end	son
h	h
him	onu
per	başına
access	erişim
think	düşünmek
north	kuzeyinde
resources	kaynaklar
current	şimdiki
big	büyük
media	medya
law	kanun
control	kontrol
water	Su
history	Tarihçe
size	boyut
personal	kişisel
guide	kılavuz
shop	Dükkan
directory	rehber
change	değişiklik
white	beyaz
text	Metin
small	küçük
rating	değerlendirme
rate	oran
government	hükümet
children	çocuklar
return	dönüş
students	öğrencilerin
v	v
account	hesap
times	zamanlar
level	seviye
digital	dijital
profile	profil
previous	önceki
form	form
events	olaylar
love	Aşk
old	eski
john	John
main	ana
call	aramak
image	görüntü
department	Bölüm
title	Başlık
non	olmayan
k	k
y	y
insurance	sigorta
shall	acak
property	özellik
class	sınıf
cd	CD
quality	kalite
every	her
listing	listeleme
content	içerik
country	ülke
little	küçük
tools	araçlar
low	düşük
reply	cevap
customer	müşteri
december	Aralık
compare	karşılaştırmak
movies	filmler
college	kolej
value	değer
article	makale
man	adam
jobs	Meslekler
j	j
food	Gıda
author	yazar
different	farklı
u	u
learn	öğrenmek
sale	satış
print	baskı
course	kurs
job	iş
room	oda
stock	Stok
training	Eğitim
too	çok
credit	kredi
point	puan
science	Bilim
men	erkekler
categories	kategoriler
west	batı
look	bak
english	ingilizce
team	takım
estate	arazi
box	Kutu
conditions	koşullar
photos	fotoğraflar
gay	eşcinsel
thread	iplik
category	kategori
note	Not
live	canlı
large	büyük
gallery	galeri
table	tablo
however	ancak
june	Haziran
october	Ekim
november	Kasım
market	Market
library	kütüphane
action	aksiyon
start	başla
series	dizi
features	Özellikler
air	hava
industry	sanayi
plan	plan
human	insan
yes	Evet
second	ikinci
hot	Sıcak
cost	maliyet
movie	film
forums	forumlar
march	Mart
la	la
september	Eylül
say	söylemek
going	gidiyor
medical	tıbbi
friend	arkadaş
dec	Aralık
server	sunucu
application	uygulama
staff	Personel
play	oyun
issues	sorunlar
april	Nisan
users	kullanıcılar
street	sokak
topic	konu
against	karşısında
got	var
blog	Blog
party	Parti
payment	ödeme
equipment	ekipman
let	let
programs	programlar
legal	yasal
recent	son
park	park
act	davranmak
problem	sorun
red	kırmızı
give	vermek
memory	bellek
performance	performans
social	sosyal
q	q
story	Öykü
sell	satmak
options	seçenekleri
experience	deneyim
key	anahtar
body	vücut
young	genç
important	önemli
field	alan
few	az
east	Doğu
single	tek
ii	ii
age	yaş
club	kulüp
example	örnek
girls	kızlar
z	z
road	yol
gift	hediye
question	soru
ca	CA
hard	zor
pay	ödeme
four	dört
poker	poker
issue	konu
range	menzil
building	bina
seller	satıcı
court	mahkeme
february	Şubat
result	sonuç
light	ışık
write	yazmak
war	savaş
offer	teklif
blue	mavi
groups	gruplar
al	ark
easy	kolay
given	verilmiş
request	istek
fax	faks
china	Çin
making	yapma
picture	resim
needs	ihtiyaçlar
possible	mümkün
month	ay
major	majör
star	star
future	gelecek
space	uzay
committee	Kurul
hand	el
sun	Güneş
cards	kartları
london	Londra
meeting	toplantı
become	olmak
child	çocuk
keep	Tut
porn	porno
share	pay
similar	benzer
garden	Bahçe
schools	okullar
million	milyon
added	katma
reference	referans
companies	şirketler
baby	bebek
learning	öğrenme
energy	enerji
run	koşmak
delivery	teslim
popular	popüler
term	terim
film	film
stories	hikayeleri
put	koymak
journal	dergi
reports	raporlar
co	ko
try	Deneyin
images	Görüntüler
notice	ihbar
god	Allah
original	orijinal
head	kafa
radio	radyo
cell	hücre
council	konsey
includes	içerir
track	Izlemek
discussion	tartışma
archive	Arşiv
others	diğerleri
agreement	anlaşma
format	biçim
society	toplum
months	ay
safety	Emniyet
friends	Arkadaş
sure	emin
edition	baskı
messages	mesajları
marketing	pazarlama
tell	söylemek
association	birleşme
provides	sağlar
fun	eğlence
already	zaten
green	yeşil
studies	çalışmalar
close	kapat
common	ortak
specific	özel
several	birkaç
living	yaşam
collection	Toplamak
called	denilen
short	kısa
arts	sanat
lot	çok
ask	Sor
limited	sınırlı
solutions	çözeltiler
director	yönetmen
beach	plaj
past	geçmiş
natural	doğal
electronics	elektronik
upon	üzerine
period	dönem
planning	planlama
says	diyor
official	resmi
mar	mar
done	tamam
technical	teknik
window	pencere
pro	profesyonel
region	bölge
island	ada
record	kayıt
direct	direkt
conference	konferans
records	kayıtlar
st	st
district	ilçe
calendar	takvim
costs	maliyetler
style	stil
statement	Beyan
miles	mil
resource	kaynak
applications	uygulamaları
document	belge
word	sözcük
works	Eserleri
material	malzeme
bill	fatura
written	yazılı
rules	kurallar
final	nihai
thing	şey
centre	merkez
requirements	Gereksinimler
TRUE	DOĞRU
minutes	dakika
else	Başka
mark	işaret
rock	Kaya
bad	kötü
individual	bireysel
plus	artı
auto	Oto
cover	kapak
edit	Düzenle
together	birlikte
videos	videolar
fast	hızlı
function	fonksiyon
fact	gerçek
getting	alma
global	global
tech	teknoloji
meet	karşılamak
far	uzak
economic	ekonomik
en	tr
player	oyuncu
projects	projeler
amount	Miktar
watch	izlemek
included	dahil
feel	hissetmek
bank	banka
risk	risk
deals	fırsatlar
various	çeşitli
words	kelimeler
production	üretim
commercial	ticari
weight	ağırlık
heart	kalp
treatment	tedavi
points	makas
knowledge	bilgi
magazine	dergi
error	hata
camera	kamera
girl	kız
construction	inşaat
toys	oyuncaklar
registered	kayıtlı
domain	domain
methods	yöntemleri
chapter	bölüm
protection	koruma
policies	politikaları
wide	geniş
beauty	güzellik
manager	müdür
india	Hindistan
position	pozisyon
taken	alınmış
sort	çeşit
listings	listeleri
known	bilinen
half	yarım
cases	vakalar
step	adım
engineering	mühendislik
simple	basit
quick	hızlı
license	lisans
lake	göl
whole	bütün
annual	yıllık
published	yayınlanan
church	kilise
method	yöntem
active	aktif
response	tepki
figure	şekil
materials	malzemeler
enough	yeterli
designed	tasarlanmış
among	arasında
death	ölüm
loss	kayıp
face	yüz
brand	marka
discount	indirim
effects	Etkileri
created	oluşturulan
standards	standartlar
bit	bit
political	siyasi
kingdom	krallık
base	baz
doing	iş
loans	krediler
shoes	ayakkabı
entry	giriş
stay	kalmak
orders	emirler
availability	kullanılabilirlik
summary	özet
turn	dönüş
growth	büyüme
agency	Ajans
king	kral
european	Avrupa
activity	aktivite
copy	kopya
western	batı
force	Kuvvet
employment	iş
bay	Defne
river	nehir
commission	komisyon
package	paket
seen	görüldü
players	oyuncu
engine	motor
port	Liman
album	albüm
regional	bölgesel
stop	durdurmak
started	başladı
administration	yönetim
bar	bar
institute	enstitü
views	görünümler
double	çift
dog	köpek
soon	yakında
lines	hatlar
electronic	elektronik
benefits	faydaları
needed	gerekli
printer	yazıcı
condition	şart
effective	etkili
believe	inanmak
organization	organizasyon
effect	Efekt
mind	us
selection	seçim
casino	kumarhane
pdf	pdf
tour	tur
cross	çapraz
hope	umut
corporation	şirket
wish	dilek
solution	çözüm
mature	olgun
role	rol
weeks	haftalar
certain	belli
lower	alt
necessary	gerekli
union	Birlik
mon	Pazartesi
com	com
particular	belirli
fine	ince
hour	saat
gas	gaz
skills	becerileri
six	altı
bush	çalı
islands	adaları
advice	tavsiye
career	kariyer
decision	karar
leave	ayrılmak
pre	önceden
huge	Kocaman
woman	Kadın
facilities	tesisler
bid	teklif
middle	orta
cable	kablo
opportunities	fırsatlar
taking	alma
values	değerler
division	bölünme
coming	gelecek
object	nesne
lesbian	lezbiyen
appropriate	uygun
machine	makine
logo	logo
length	uzunluk
nice	Güzel
score	Gol
statistics	istatistik
client	müşteri
sample	Numune
investment	yatırım
sent	gönderilen
shown	gösterilen
christmas	Noel
culture	kültür
flash	flaş
ms	MS
choice	seçim
courses	dersler
consumer	tüketici
hi	Merhaba
foreign	yabancı
artist	sanatçı
furniture	mobilya
channel	kanal
letter	mektup
mode	kip
phones	telefonlar
ideas	fikirler
structure	yapı
degree	derece
contract	sözleşme
super	Süper
male	erkek
matter	madde
almost	neredeyse
located	bulunan
multiple	çoklu
distribution	dağıtım
editor	editör
inn	Han
industrial	Sanayi
potential	potansiyel
song	şarkı
los	los
fall	düşmek
idea	Fikir
rooms	Odalar
communications	iletişim
win	kazanmak
primary	birincil
cancer	kanser
numbers	sayılar
reason	neden
tool	araç
spring	bahar
foundation	vakıf
answer	Cevap
voice	ses
schedule	program
documents	evraklar
purpose	amaç
feature	özellik
bed	yatak
comes	geliyor
police	polis
independent	bağımsız
approach	yaklaşım
brown	kahverengi
physical	fiziksel
hill	Tepe
maps	haritalar
hold	ambar
ratings	derecelendirme
happy	mutlu
smith	demirci
developed	gelişmiş
thank	teşekkür
safe	kasa
unique	benzersiz
survey	anket
prior	önceki
telephone	telefon
sport	spor
ready	hazır
animal	hayvan
sources	kaynaklar
population	nüfus
pa	baba
regular	düzenli
secure	güvenli
operations	operasyonlar
simply	basitçe
evidence	kanıt
station	istasyon
understand	anlama
option	seçenek
valley	vadi
probably	muhtemelen
sea	deniz
publications	yayınlar
improve	iyileştirmek
connection	bağ
publisher	Yayımcı
hall	salon
anti	anti
networks	ağlar
earth	toprak
parents	ebeveyn
impact	darbe
transfer	Aktar
introduction	Giriş
kitchen	mutfak
strong	kuvvetli
wedding	düğün
properties	özellikleri
hospital	hastane
ground	zemin
ship	gemi
accommodation	Konaklama
disease	hastalık
excellent	mükemmel
perfect	mükemmel
hair	saç
opportunity	fırsat
kit	malzeme
classic	klasik
basis	temel
command	komuta
cities	şehirler
express	ekspres
award	ödül
distance	mesafe
tree	ağaç
assessment	değerlendirme
wall	duvar
involved	ilgili
el	el
extra	ekstra
especially	özellikle
budget	bütçe
guides	kılavuzlar
success	başarı
maximum	maksimum
ma	anne
operation	operasyon
existing	mevcut
quite	oldukça
selected	seçilmiş
boy	oğlan
restaurants	restoranlar
beautiful	güzel
warning	uyarı
locations	yerleri
horse	at
vote	oy
flowers	Çiçekler
stars	yıldızlar
lists	listeleri
owner	sahip
animals	hayvanlar
ways	yolları
son	oğul
providing	sağlama
rule	kural
housing	Konut
takes	alır
bring	getirmek
catalog	katalog
max	maksimum
mother	anne
authority	yetki
told	söyledi
programme	program
joined	katıldı
input	giriş
strategy	strateji
feet	ayaklar
agent	ajan
valid	geçerli
modern	modern
senior	kıdemli
sexy	seksi
teaching	öğretim
door	kapı
grand	büyük
trial	Deneme
units	birimler
cool	güzel
normal	normal
enterprise	kuruluş
ships	gemiler
entire	tüm
positive	pozitif
fitness	Fitness
chinese	Çince
opinion	görüş
football	Futbol
abstract	soyut
output	çıktı
funds	para
mr	Bay
likely	muhtemelen
develop	geliştirmek
artists	sanatçılar
alternative	alternatif
responsibility	sorumluluk
java	java
guest	konuk
publication	yayın
pass	pas
relations	ilişkiler
trust	güven
van	kamyonet
contains	içeren
multi	çok
republic	cumhuriyet
fees	harç
components	bileşenler
vacation	tatil
century	yüzyıl
academic	akademik
assistance	yardım
completed	tamamlanan
skin	cilt
graphics	grafik
indian	Hintli
ring	halka
grade	sınıf
mountain	dağ
organizations	organizasyonlar
filter	filtre
panel	panel
floor	zemin
buying	alış
match	maç
proposed	önerilen
require	gerektirir
boys	çocuklar
morning	sabah
allows	verir
protein	protein
plant	bitki
reported	rapor
hit	vurmak
mm	aa
pool	havuz
mini	mini
politics	siyaset
partner	ortak
authors	yazarlar
boards	panoları
fish	balık
membership	üyelik
mission	misyon
eye	göz
string	sicim
sense	duyu
modified	değiştirilmiş
released	yayınlandı
stage	evre
internal	iç
born	doğmuş
detailed	detaylı
