von	из
zu	в
im	в
zum	для
ist	является
auf	на
Das	что
durch	от
Dies	это
mit	с
ich	я
Sie	вы
es	Это
oder	или
Sein	быть
sind	находятся
beim	в
alle	все
haben	иметь
Neu	новый
wir	мы
werden	будем
Zuhause	Главная
uns	нас
Über	около
ob	если
Seite	страница
meine	мой
hat	имеет
Suche	поиск
frei	свободно
aber	но
unser	наш
ein	один
andere	Другие
machen	делать
Information	Информация
Zeit	время
er	он
welche	который
ihr	их
Nachrichten	Новости
benutzen	использование
Dort	там
sehen	видеть
damit	так
Wer	кто
Netz	Web
ebenfalls	также
bekommen	получить
pm	вечера
Aussicht	Посмотреть
c	с
e	е
zuerst	первый
gewesen	было
würde	бы
wurden	мы
s	s
mögen	как
x	Икс
als	чем
finden	найти
Preis	цена
zurück	назад
oben	Вверх
Menschen	люди
hätten	имел
Liste	список
Name	имя
gerade	просто
Jahr	год
Tag	день
in	в
zwei	два
Gesundheit	здоровье
n	N
Re	ре
benutzt	используемый
gehen	идти
b	б
letzte	последний
machen	делать
Sie	их
sollte	должен
Produkt	продукт
System	система
Post	после
ihr	ее
Stadt	город
t	T
Politik	политика
Nummer	номер
Unterstützung	поддержка
Botschaft	сообщение
nach	после
dann	тогда
Januar	январь
gut	хорошо
d	d
woher	где
Info	Информация
Rechte	права
Bücher	книги
hoch	высокая
Schule	школа
m	м
jeder	каждый
Links	связи
sie	она
Jahre	лет
Auftrag	заказ
sehr	очень
Buch	книга
Artikel	Предметы
Unternehmen	Компания
r	р
lesen	читать
Gruppe	группа
Sex	секс
viele	многие
Benutzer	пользователь
de	де
einstellen	задавать
Allgemeines	Генеральная
Forschung	исследование
Universität	Университет
Januar	январь
Post	почта
voll	полный
Bewertungen	отзывы
Programm	программа
kennt	знать
Spiele	игры
Weg	путь
Tage	дней
p	п
Teil	часть
könnte	мог
groß	Великий
vereinigt	единый
echt	реальный
f	е
International	Международный
Center	центр
Reise	путешествовать
Bemerkungen	Комментарии
gemacht	сделал
Entwicklung	развитие
Bericht	доклад
Mitglied	член
Einzelheiten	Детали
Linie	линия
Bedingungen	сроки
Vor	до
Hotels	отели
tat	сделал
senden	Отправить
Recht	правильно
Art	тип
lokal	местный
jene	те
Ergebnisse	Результаты
Büro	офис
National	национальный
Auto	автомобиль
Design	дизайн
nehmen	принимать
Gesendet	отправил
Adresse	адрес
Gemeinschaft	сообщество
innerhalb	в
Zustände	состояния
wollen	хотеть
Telefon	Телефон
DVD	DVD
Gegenstand	предмет
zwischen	между
Forum	Форум
Familie	семья
l	L
lange	длинный
w	вес
Show	показать
O	о
sogar	даже
schwarz	черный
Besondere	особый
Index	индекс
Sein	являющийся
Frau	женщины
viel	много
Schild	знак
Datei	файл
Verknüpfung	ссылка
öffnen	открытый
Süd	юг
Fall	дело
Projekt	проект
Seiten	страницы
Ausführung	версия
Sektion	раздел
besitzen	своя
Haus	дом
Sicherheit	безопасность
G	г
Bezirk	округ
amerikanisch	американский
Foto	Фото
Spiel	игра
Mitglieder	члены
Leistung	мощность
Netzwerk	сеть
Computer	компьютер
Systeme	системы
drei	три
Ort	место
Ende	конец
h	час
ihm	его
pro	в
Zugriff	доступ
denken	думать
Norden	север
Ressourcen	Ресурсы
Strom	текущий
groß	большой
Medien	СМИ
Recht	закон
Steuerung	контроль
Wasser	воды
Geschichte	история
Größe	размер
persönlich	личный
führen	руководство
Geschäft	магазин
Verzeichnis	каталог
Veränderung	изменение
Weiß	белый
Text	текст
klein	маленький
Wertung	рейтинг
Bewertung	ставка
Regierung	правительство
Kinder	дети
Rückkehr	вернуть
Studenten	студенты
v	v
Konto	Счет
mal	раз
Niveau	уровень
Digital	цифровой
Profil	профиль
Bisherige	предыдущий
bilden	форма
Veranstaltungen	Мероприятия
Liebe	люблю
alt	старый
John	Джон
Main	главный
Anruf	вызов
Bild	образ
Abteilung	отдел
Titel	заглавие
nicht	не
k	К
y	Y
Versicherung	страхование
soll	должен
Eigentum	имущество
Klasse	класс
CD	CD
Qualität	качественный
jeden	каждый
Auflistung	список
Inhalt	содержание
Land	страна
wenig	немного
Werkzeuge	инструменты
niedrig	низкий
Antworten	Ответить
Kunde	клиент
Dezember	Декабрь
vergleichen	сравнить
Filme	кино
Hochschule	колледж
Wert	стоимость
Artikel	статья
Mann	человек
Arbeitsplätze	работы
j	J
Lebensmittel	питание
Autor	автор
anders	другой
u	U
lernen	учить
Verkauf	продажа
drucken	Распечатать
Kurs	курс
Job	работа
Zimmer	комната
Stock	акции
Ausbildung	обучение
auch	слишком
Kredit	кредит
Punkt	точка
Wissenschaft	наука
Männer	люди
Kategorien	категории
Westen	запад
aussehen	смотреть
Englisch	английский
Mannschaft	команда
Gut	имущество
Box	коробка
Bedingungen	условия
Fotos	фото
Fröhlich	гей
Faden	нить
Kategorie	категория
Hinweis	заметка
Leben	жить
groß	большой
Galerie	галерея
Tabelle	Таблица
jedoch	Однако
Juni	июнь
Oktober	октябрь
November	ноябрь
Markt	рынок
Bibliothek	библиотека
Aktion	действие
Anfang	Начало
Serie	серии
Eigenschaften	функции
Luft	воздух
Industrie	промышленность
planen	план
Mensch	человек
Ja	да
zweite	второй
heiß	горячий
Kosten	Стоимость
Film	кино
Foren	форумы
März	Март
la	ля
September	сентябрь
sagen	сказать
gehen	собирается
medizinisch	медицинская
Freund	друг
Dezember	декабрь
Server	сервер
Anwendung	заявление
Mitarbeiter	сотрудники
abspielen	играть
Probleme	вопросы
April	апрель
Benutzer	пользователи
Straße	улица
Thema	тема
gegen	против
bekam	получил
Blog	блог
Party	вечеринка
Zahlung	оплата
Ausrüstung	оборудование
Lassen	позволять
Programme	программы
legal	правовой
kürzlich	недавний
Park	парк
Handlung	акт
Problem	проблема
rot	красный
geben	дайте
Erinnerung	Память
Performance	представление
Sozial	Социальное
q	Q
Geschichte	история
verkaufen	продавать
Optionen	опции
Erfahrung	опыт
Schlüssel	ключ
Karosserie	тело
jung	молодой
wichtig	важный
Feld	поле
wenige	мало
Osten	восток
Single	Один
ii	б
Alter	возраст
Verein	клуб
Beispiel	пример
Mädchen	девочки
z	Z
Straße	Дорога
Geschenk	подарок
Frage	вопрос
ca	Калифорния
hart	жесткий
Zahlen	платить
vier	четыре
Poker	покер
Problem	вопрос
Angebot	ассортимент
Gebäude	здание
Verkäufer	продавец
Gericht	суд
Februar	февраль
Ergebnis	результат
Licht	легкий
schreiben	записывать
Krieg	война
Angebot	предлагает
Blau	синий
Gruppen	группы
al	аль
einfach	легко
gegeben	данный
anfordern	запрос
Fax	факс
China	Китай
Herstellung	изготовление
Bild	картина
Bedürfnisse	потребности
möglich	возможное
Monat	месяц
Haupt	главный
Star	звезда
Zukunft	будущее
Raum	пространство
Ausschuss	комитет
Hand	рука
Sonne	солнце
Karten	карты
London	Лондон
Treffen	встреча
werden	стали
Kind	ребенок
behalten	держать
Porno	порно
Aktie	доля
ähnlich	аналогичный
Garten	сад
Schulen	школы
Million	миллиона
hinzugefügt	добавленной
Referenz	Справка
Firmen	компании
Baby	детка
Lernen	обучение
Energie	энергия
Lauf	бег
Lieferung	Доставка
Beliebt	популярный
Begriff	срок
Film	фильм
Geschichten	истории
stellen	положил
Tagebuch	журнал
Berichte	отчеты
co	Колорадо
Versuchen	пытаться
Bilder	изображений
beachten	уведомление
Gott	Бог
Original	оригинал
Kopf	глава
Radio	радио
Zelle	клетка
Rat	совет
enthält	включает
Spur	трек
Diskussion	обсуждение
Archiv	архив
Andere	другие
Zustimmung	соглашение
Format	формат
Gesellschaft	общество
Monate	месяцы
Sicherheit	безопасность
Freunde	друзья
sicher	конечно
Auflage	издание
Mitteilungen	Сообщения
Marketing	маркетинг
sagen	рассказать
Verband	ассоциация
bietet	обеспечивает
Spaß	весело
bereits	уже
Grün	зеленый
Studien	исследования
schließen	Закрыть
verbreitet	общий
Spezifisch	конкретный
mehrere	несколько
Leben	живой
Sammlung	коллекция
namens	называется
kurz	короткая
Kunst	искусства
Menge	много
Fragen	просить
begrenzt	ограниченное
Lösungen	решения
Direktor	директор
Strand	пляж
Vergangenheit	мимо
natürlich	натуральный
Elektronik	электроника
auf	на
Zeitraum	период
Planung	планирование
sagt	говорит
offiziell	официальный
beschädigen	март
erledigt	сделанный
technisch	технический
Fenster	окно
Profi	профессионал
Region	область
Insel	остров
Aufzeichnung	запись
Direkte	непосредственный
Konferenz	конференция
Aufzeichnungen	учет
st	улица
Kreis	район
Kalender	календарь
Kosten	расходы
Stil	стиль
Erklärung	заявление
Meilen	миль
Ressource	ресурс
Anwendungen	Приложения
Dokument	документ
Wort	слово
Werk	работает
Material	материал
Rechnung	законопроект
geschrieben	написано
Regeln	правила
Finale	окончательный
Ding	вещь
Center	центр
Anforderungen	требования
WAHR	ПРАВДА
Protokoll	минут
sonst	еще
Kennzeichen	отметка
Rock	камень
Schlecht	Плохо
Individuell	индивидуальный
Plus	плюс
Auto	авто
Abdeckung	обложка
bearbeiten	редактировать
zusammen	вместе
Videos	видео
schnell	быстро
Funktion	функция
Tatsache	факт
bekommen	получение
global	Глобальный
Technik	тек
Treffen	встретить
weit	далеко
wirtschaftlich	экономической
en	ан
Spieler	игрок
Projekte	проектов
Menge	количество
Uhr	смотреть
inbegriffen	включены
Gefühl	Чувствовать
Bank	банка
Risiko	риск
Angebote	предложения
verschiedene	различный
Wörter	слова
Produktion	производство
kommerziell	коммерческая
Gewicht	вес
Herz	сердце
Behandlung	лечение
Punkte	точки
Wissen	знание
Zeitschrift	журнал
Error	ошибка
Kamera	камера
Mädchen	девушка
Konstruktion	строительство
Spielzeuge	игрушки
Eingetragen	зарегистрированный
Domain	домен
Methoden	методы
Kapitel	глава
Schutz	защита
Politik	полисы
breit	широкий
Schönheit	красота
Manager	менеджер
Indien	Индия
Position	должность
genommen	взятый
Sortieren	Сортировать
Inserate	объявления
bekannt	известен
Hälfte	половина
Fälle	случаи
Schritt	шаг
Ingenieurwesen	инжиниринг
einfach	просто
schnell	быстро
Lizenz	лицензия
See	озеро
ganze	все
jährlich	годовой
veröffentlicht	опубликованный
Kirche	церковь
Methode	метод
aktiv	активный
Antwort	ответ
Zahl	фигура
Materialien	материалы
genug	достаточно
entworfen	предназначенный
unter	среди
Tod	смерть
Verlust	потеря
Gesicht	лицо
Marke	марка
Rabatt	скидка
Auswirkungen	последствия
erstellt	созданный
Normen	стандарты
Bit	немного
politisch	политическая
Königreich	Королевство
Base	база
tun	дела
Darlehen	кредитование
Schuhe	обувь
Eintrag	запись
bleibe	оставаться
Aufträge	заказы
Verfügbarkeit	доступность
Zusammenfassung	резюме
Wende	очередь
Wachstum	рост
Agentur	агентство
König	король
europäisch	Европейская
Aktivität	Мероприятия
Kopieren	копия
Western	вестерн
Macht	сила
Beschäftigung	занятость
Bucht	залив
Fluss	река
Kommission	комиссия
Paket	пакет
gesehen	видели
Spieler	игроки
Motor	двигатель
Hafen	порт
Album	альбом
regional	региональный
halt	стоп
gestartet	начал
Verwaltung	администрация
Bar	бар
Institut	институт
Ansichten	Просмотры
doppelt	двойной
Hund	собака
bald	скоро
Linien	линии
elektronisch	электронный
Leistungen	выгоды
erforderlich	необходимый
Drucker	принтер
Bedingung	состояние
Wirksam	эффективный
glauben	верить
Organisation	организация
bewirken	эффект
Verstand	разум
Auswahl	выбор
Kasino	казино
pdf	PDF
Tour	тур
Kreuz	пересекать
Hoffnung	надежда
Konzern	корпорация
Wunsch	желание
Lösung	решение
reifen	зрелый
Rolle	роль
Wochen	недель
sicher	определенный
niedriger	ниже
notwendig	необходимо
Union	союз
mon	понедельник
com	ком
besonders	конкретный
fein	отлично
Stunde	час
Gas	газ
Kompetenzen	навыки
sechs	шесть
Buchse	куст
Inseln	острова
Rat	совет
Werdegang	карьера
Entscheidung	решение
verlassen	оставлять
Vor	до
enorm	огромный
Frau	женщина
Anlagen	оборудование
bieten	предложение
Mitte	средний
Kabel	кабель
Chancen	возможности
Einnahme	принятие
Werte	значения
Aufteilung	деление
Kommen	приход
Objekt	объект
lesbisch	лесбиянка
angemessen	подходящее
Maschine	машина
Logo	логотип
Länge	длина
nett	хороший
Ergebnis	Гол
Statistiken	статистика
Klient	клиент
Probe	образец
Investition	инвестиции
geschickt	послал
gezeigt	показанный
Weihnachten	рождество
Kultur	культура
Blitz	вспышка
Frau	Миз
Wahl	выбор
Kurse	курсы
Verbraucher	потребитель
Hallo	Здравствуй
fremd	иностранные
Künstler	художник
Möbel	мебель
Kanal	канал
Brief	письмо
Modus	Режим
Telefone	телефоны
Ideen	идеи
Struktur	состав
Grad	степень
Vertrag	контракт
Super	супер
männlich	мужской
Angelegenheit	дело
fast	почти
gelegen	располагается
mehrere	множественный
Verteilung	распределение
Editor	редактор
Gasthaus	гостиница
industriell	промышленные
Potenzial	потенциал
Lied	песня
los	лос
fallen	падать
Idee	идея
Räume	номера
Kommunikations	связь
Sieg	выиграть
primär	первичный
Krebs	рак
Zahlen	чисел
Grund	причина
Werkzeug	инструмент
Frühling	весна
Stiftung	Фонд
Antworten	ответ
Stimme	голос
Zeitplan	график
Unterlagen	документы
Zweck	цель
Feature	особенность
Bett	постель
kommt	выходит
Polizei	полиция
unabhängig	независимый
Ansatz	подход
braun	коричневый
physikalisch	физическое
Hügel	холм
Karten	карты
halt	держать
Bewertungen	рейтинги
glücklich	счастливый
Schmied	кузнец
entwickelt	развитая
danken	спасибо
sicher	безопасно
einzigartig	уникальный
Umfrage	опрос
vor	предшествующий
Telefon	телефон
Sport	спорт
bereit	готов
Tier	животное
Quellen	источники
Population	Население
pa	папа
regulär	регулярный
sichern	безопасный
Geschäftstätigkeit	операции
einfach	просто
Beweis	доказательства
Bahnhof	станция
verstehen	Понимаю
Möglichkeit	вариант
Tal	долина
wahrscheinlich	вероятно
Meer	море
Publikationen	публикации
verbessern	улучшать
Verbindung	соединение
Herausgeber	издатель
Halle	зал
Anti	анти
Netzwerke	сети
Erde	Земля
Eltern	родители
Auswirkung	влияние
Transfer	перевод
Einführung	введение
Küche	кухня
stark	сильный
Hochzeit	свадьба
Eigenschaften	свойства
Krankenhaus	больница
Boden	земля
Schiff	корабль
Unterkunft	жилье
Krankheit	болезнь
Ausgezeichnet	отлично
perfekt	идеально
Haar	волосы
Gelegenheit	возможность
Ausrüstung	Комплект
klassisch	классический
Basis	основа
Befehl	команда
Städte	города
ausdrücken	экспресс
vergeben	награда
Entfernung	расстояние
Baum	дерево
Bewertung	оценка
Mauer	стена
beteiligt	участвует
el	эль
extra	дополнительный
insbesondere	особенно
Budget	бюджет
Führungen	направляющие
Erfolg	успех
maximal	максимальная
ma	мама
Betrieb	операция
bestehende	существующий
ganz	довольно
ausgewählt	выбранный
Junge	мальчик
Restaurants	ресторан
schön	красивая
Warnung	предупреждение
Standorte	места
Pferd	лошадь
Abstimmung	голос
Blumen	цветы
Sterne	звезды
Listen	списки
Inhaber	владелец
Tiere	животные
Wege	пути
Sohn	сын
Bereitstellen	обеспечение
Regel	правило
Gehäuse	Корпус
nimmt	принимает
bringen	приносить
Katalog	каталог
max	Максимум
Mutter	мама
Behörde	власть
erzählte	сказал
Programm	программа
beigetreten	присоединился
Eingang	вход
Strategie	стратегия
Füße	ноги
Agent	агент
gültig	действительный
modern	современное
Senior	старшая
sexy	сексуальный
Lehren	обучение
Tür	дверь
großartig	большой
Versuch	испытание
Einheiten	единицы
cool	круто
normal	нормальный
Unternehmen	предприятие
Schiffe	судов
ganz	все
positiv	положительный
Fitness	фитнес
Chinesisch	Китайский
Meinung	мнение
Fußball	футбол
abstrakt	Абстрактные
Ausgabe	вывод
Mittel	фонды
Herr	Мистер
wahrscheinlich	вероятно
entwickeln	развивать
Künstler	художники
Alternative	альтернатива
Verantwortung	обязанность
Java	Ява
Gast	гость
Veröffentlichung	публикация
bestehen	проходить
Verhältnis	связи
Vertrauen	доверять
Transporter	фургон
enthält	содержит
Mehr	много
Republik	республика
Gebühren	сборы
Komponenten	компоненты
Ferien	отпуск
Jahrhundert	века
akademisch	академический
Hilfe	помощь
abgeschlossen	завершено
Haut	кожа
Grafik	графика
indisch	индийский
Ring	кольцо
Klasse	класс
Berg	гора
Organisationen	организации
Filter	фильтр
Platte	панель
Fußboden	пол
Kauf	покупка
Spiel	совпадение
vorgeschlagen	предложенный
benötigen	требовать
Jungen	мальчиков
Morgen	утро
erlaubt	позволяет
Eiweiß	белок
Pflanze	растение
berichtet	сообщается
schlagen	удар
Millimeter	мм
Schwimmbad	бассейн
Mini	мини
Politik	политика
Partner	партнер
Autoren	авторы
Bretter	доски
Fisch	рыба
Mitgliedschaft	членство
Mission	миссия
Auge	глаз
Schnur	строка
Sinn	смысл
geändert	модифицированный
freigegeben	выпущенный
Bühne	сцена
intern	внутренний
geboren	Родился
ausführlich	подробный
japanisch	Японский
Rennen	раса
genehmigt	утвержденный
Ziel	цель
außer	Кроме
Charakter	персонаж
Instandhaltung	поддержание
Fähigkeit	способность
ed	издание
vergewaltigen	изнасилование
Batterie	аккумулятор
Jugend	молодежь
Druck	давление
eingereicht	Отправлено
Schuld	долг
Mittel	средний
Fernsehen	телевидение
interessiert	заинтересованный
Ader	ядро
Unterbrechung	ломать
Zwecke	цели
Sets	наборы
tanzen	танец
Holz	дерево
definiert	определенный
Papiere	документы
Auszeichnungen	награды
Gebühr	плата
Studio	студия
Leser	читатель
Gerät	устройство
etabliert	установленный
Antworten	ответы
Miete	аренда
las	лас
dunkel	темно
extern	внешний
Apfel	яблоко
le	ле
Anleitung	инструкции
Mindest	мин
angeboten	предложенный
Theorie	теория
Löschen	Удалить
Hilfe	помощь
visuell	визуальный
Gastgeber	хозяин
Vielfalt	разнообразие
Lehrer	учителей
Handbuch	руководство
Block	блок
Fächer	предметы
Mittel	агенты
Reparatur	ремонт
Messe	Справедливая
stehlen	стали
Verstehen	понимание
Lieder	песни
Fest	исправлено
falsch	неправильно
Anfang	начало
Hände	Руки
az	Аризона
Paris	Париж
wird	получает
Sektor	сектор
Kapazität	вместимость
un	ООН
Fett	жир
Vater	отец
elektrisch	электрический
sah	увидел
Instrumente	инструменты
Offizier	сотрудник
Treiber	Водитель
Unternehmen	бизнес
tot	мертвый
unbekannte	неизвестный
Restaurant	ресторан
Mike	Майк
Ausflug	поездка
mi	ми
Arm	бедные
Beziehung	отношения
Arbeitskräfte	рабочие
Frieden	мир
traditionell	традиционный
zeigt	показ
kreativ	творческий
Küste	берег
Vorteil	выгода
Finanzierung	финансирование
Geräte	приборы
Herr	господин
gewähren	даровать
Unter	суб
Fiktion	фантастика
Uhren	часы
Karriere	карьера
geht	идет
LED	светодиод
Museum	музей
Ventilator	поклонник
Transport	транспорт
interessant	интересно
Blogs	блоги
Auswertung	оценка
ehemalige	бывший
Zone	зона
Komplex	сложный
th	го
Katze	Кот
sterben	умереть
vorgeführt	представленный
eben	квартира
fließen	течь
Agenturen	агентства
Literatur	литература
Elternteil	родитель
Rahmen	установка
DR	доктор
Rahmen	масштаб
Wirtschaft	экономика
hilfreich	полезный
monatlich	ежемесячно
kritisch	критический
Rahmen	Рамка
Musical	музыкальный
Definition	определение
Sekretär	секретарь
Pfad	дорожка
Chef	главный
gibt	дает
Pakete	пакеты
Detail	подробно
Gesetze	законы
geändert	изменено
Start	начать
königlich	королевский
reinigen	чистый
Kerl	парень
Titel	названия
relevant	Соответствующий
Gerechtigkeit	справедливость
verbinden	соединять
Tasse	кружка
Korb	корзина
angewandt	прикладная
wöchentlich	еженедельно
vol	об
Installation	монтаж
pp	стр
Beachtung	внимание
vorrücken	продвижение
überspringen	пропускать
Diät	диета
Armee	армия
Ausrüstung	шестерня
Unterschied	разница
dürfen	позволил
richtig	верный
Nation	нация
Verkauf	продажа
viele	много
Stück	кусок
Blatt	лист
Feste	фирма
Sieben	Семь
Elemente	элементы
Spezies	вид
springen	Прыгать
Zellen	ячейки
Modul	модуль
Urlaubsort	курорт
Zertifikat	сертификат
Minister	министр
Bewegung	движение
Mode	мода
Richtungen	направления
Besucher	посетители
Dokumentation	документация
Handel	торговый
Wald	лес
Anrufe	звонки
Berichterstattung	покрытие
Paar	пара
Angabe	дающий
Chance	шанс
Vision	видение
Ball	мяч
Ende	окончание
Kunden	клиенты
Aktionen	действия
diskutieren	обсуждать
Tor	Цель
erfolgreich	успешный
verkauft	продан
Wind	ветер
Gemeinden	сообщества
klinisch	клиническая
Lage	ситуация
Märkte	рынки
Verlagswesen	издательский
erscheinen	появиться
Entwicklung	развивающийся
Leben	жизни
bestimmen	определить
Temperatur	температура
Ankündigungen	объявления
geduldig	пациент
tatsächlich	фактический
historisch	исторический
Stein	камень
Bob	боб
Handel	коммерция
Personen	лиц
schwer	сложно
wissenschaftlich	научный
Satellit	спутник
Tests	тесты
Dorf	деревня
Konten	Счета
Amateur	любитель
Ex	бывший
getroffen	встретил
Schmerzen	боль
Faktoren	факторы
Kaffee	кофе
Käufer	покупатель
Poster	плакат
Kante	край
funktional	функциональная
Wurzel	корень
fi	фи
geschlossen	закрыто
Ferien	каникулы
Rosa	розовый
Balance	баланс
Überwachung	мониторинг
Antworten	ответы
Schuss	выстрел
Initiale	начальная
Etikette	метка
Sekunde	сек
Kanon	канон
Liga	лига
Abfall	отходы
Minute	минут
Bus	автобус
Anbieter	поставщик
Wörterbuch	Словарь
Buchhaltung	учет
Herstellung	производство
Abschnitte	разделы
Stuhl	стул
Anstrengung	усилие
Phase	фаза
Fantasie	фантазия
po	ро
va	в
Professor	профессор
Installieren	устанавливать
Hemd	Рубашка
Kleider	одежда
Fuß	фут
Brust	грудь
Techniken	методы
Dollar	долларов
Religion	религия
Genehmigung	разрешение
wild	дикий
Generation	поколение
Fräulein	Мисс
chemisch	химическая
Arzt	врач
Aufgabe	задача
reduzieren	уменьшить
gebracht	привел
Übung	упражнение
Fehler	ошибка
Garantie	гарантия
Führer	лидер
se	се
Prozesse	процессы
weich	мягкий
Treffen	встречи
Sekunden	секунд
Flug	рейс
Kongress	конгресс
Treibstoff	топливо
gehen	ходить
hergestellt	произведенный
Heilige	святой
Streit	аргумент
Wettbewerb	соревнование
Drogen	наркотики
Joint	совместный
Prämie	премия
frisch	свежий
Figuren	персонажи
Rechtsanwalt	адвокат
di	ди
Faktor	фактор
tausende	тысячи
km	км
Strom	поток
Wohnungen	апартаменты
pflücken	выбирать
Hören	слух
östlich	восточный
Therapie	терапия
Einträge	записи
unterzeichnet	подписанный
administrativ	административный
ernst	серьезный
Grenze	предел
Schritte	меры
Geschäfte	магазины
Knechtschaft	зависимость
del	дель
Anstrengungen	усилия
informiert	проинформировал
ga	Джорджия
Gedanken	мысли
Bach	ручей
ft	фут
Menge	количество
wesentlich	существенный
Touren	туры
Belastung	нагрузка
sofort	немедленно
Maschinen	машины
vorgesehen	назначенный
schwer	тяжелый
bedeckt	покрытый
Wiederherstellung	восстановление
integriert	интегрированный
Aufbau	конфигурация
Schwanz	петух
Händler	торговец
umfassend	комплексный
Experte	эксперт
schützen	защищать
solide	твердый
Präsentation	презентация
wurde	стал
Orange	оранжевый
Beachtung	соблюдение
Thema	тема
Reich	богатые
Kampagne	кампания
vs	против
Gitarre	гитара
finden	обнаружение
Beispiele	Примеры
Geist	дух
ar	Арканзас
Ansprüche	требования
Annahme	принятие
Strategien	стратегии
mo	мо
Angelegenheiten	дела
beabsichtigt	предназначена
sa	са
Tore	цели
mieten	Наем
Wahl	выборы
vorschlagen	предлагать
Ast	филиал
Dienen	обслуживать
Mitgliedsorganisationen	филиалы
montieren	крепление
Latein	латинский
Multimedia	мультимедиа
verwalten	управлять
Ecke	угол
Rang	ранг
Element	элемент
Geburt	рождение
Virus	вирус
interaktiv	интерактивный
Anfragen	Запросы
trennen	отдельный
Quartal	четверть
Verfahren	процедура
Führung	руководство
definieren	определять
religiös	религиозная
Fakten	факты
Frühstück	завтрак
Säule	колонка
Glauben	вера
Kette	цепь
identifizieren	идентифицировать
Avenue	проспект
fehlt	отсутствует
Empfehlungen	рекомендации
gerührt	переехал
erreichen	достичь
Vergleich	сравнение
Moment	момент
verlängert	расширенный
Sequenz	последовательность
Zoll	дюймовый
Attacke	атака
Zentren	центры
Öffnung	открытие
Labor	лаборатория
Reservieren	резерв
Gamma	гамма
produzieren	производить
Wahrheit	правда
Zähler	счетчик
Fehler	отказ
folgt	следует
Dollar	доллар
Lager	лагерь
die	дез
Filme	фильмы
Brücke	мост
füllen	заполнить
Bewegung	движение
Drucken	печать
Entwurf	проект
Diagramm	диаграмма
gespielt	играл
Kontakte	контакты
Leser	читатели
Clubs	клубы
wa	Вашингтон
Abenteuer	приключение
Opfer	предложение
profitieren	прибыль
Führung	лидеры
Poster	плакаты
Institutionen	учреждения
Assistent	помощник
Variable	переменная
dj	диджей
Parken	стоянка
gestern	вчера
entschlossen	определенный
Werkstatt	мастерская
Weg	прошло
Codes	коды
Arten	виды
Erweiterung	расширение
Aussagen	заявления
vollständig	полностью
Mannschaften	команды
Fort	форт
cm	см
Senat	сенат
komisch	веселая
Gen	ген
gedreht	оказалось
Scheibe	диск
Muster	шаблон
Boot	лодка
Theater	театр
Hersteller	производители
Sponsor	спонсор
klassisch	классический
Symbol	значок
Garantie	гарантия
gewidmet	преданный
Richtung	направление
Basketball	баскетбол
Objekte	объекты
löschen	Удалить
Abend	вечер
Versammlung	сборка
nuklear	ядерной
Maus	мышь
Signal	сигнал
Verbrecher	преступник
ausgegeben	выпущен
mächtig	мощный
Traum	мечта
FALSCH	ЛОЖНЫЙ
da	да
Besetzung	бросать
Blume	цветок
Personal	персонал
bestanden	прошло
geliefert	поставляется
Stürze	падения
Seele	душа
fördern	содействовать
angegeben	заявил
Statistiken	статистика
Profis	профессионалов
erscheint	появляется
tragen	нести
Flagge	флаг
Abdeckungen	крышки
em	Эм
Vorteil	преимущество
Hallo	Здравствуйте
Design	конструкции
pflegen	поддерживать
Tourismus	туризм
Priorität	приоритет
Erwachsene	Взрослые
Grafik	графический
Atom	атом
Zahlungen	платежи
Bindung	переплет
kurz	краткое
beendet	закончился
gewinnt	выигрыш
anonym	анонимный
Skript	скрипт
serviert	служил
will	хочет
bereit	подготовленный
Leere	недействительным
Etikett	тег
Interview	интервью
mischen	смешивание
Rahmen	фреймворк
Scheibe	диск
Eingerichtet	установлен
Königin	Королева
Kredite	кредиты
deutlich	явно
Fix	фиксировать
Griff	ручка
Süss	милая
Kriterien	критерии
assoziieren	ассоциировать
ne	Небраска
Verhalten	поведение
vergrößern	увеличить
Strahl	луч
Einnahmen	доход
messen	измерение
Stimmen	голосов
du	дю
Pflicht	обязанность
Diskussionen	обсуждение
Bär	медведь
gewinnen	усиление
Festival	фестиваль
Labor	лаборатория
Ozean	океан
Flüge	рейсы
Fachwelt	эксперты
Zeichen	знаки
Tiefe	глубина
Zug	поезд
trocken	сухой
erkunden	исследовать
Spa	спа
Konzept	концепция
fast	около
Handhabung	обращение
Ursprung	происхождения
Milliarde	миллиард
Intelligenz	интеллект
gekauft	купил
con	против
Nationen	нации
Route	маршрут
gebrochen	сломанный
Schlacht	боевой
sprechen	говорить
Protokoll	протокол
Abfrage	запрос
Partnerschaft	партнерство
Ausdruck	выражение
es	эс
Rede	речь
Draht	провод
Vorschläge	предложения
Ersatz	замена
Band	лента
strategisch	стратегическое
Richter	судья
Acid	кислота
Bytes	байтов
Cent	цент
gezwungen	принудительный
kompatibel	совместимый
Wohnung	квартира
Null	ноль
Null	нуль
Redner	оратор
Beratung	консалтинг
Konstrukteur	дизайнер
pr	пр
Ehe	брак
rollen	рулон
Banken	банки
fr	фр
Teilnehmer	участники
Geheimnis	секрет
Negativ	отрицательный
Favoriten	избранное
Theater	театр
Federung	пружины
var	вар
ausführen	выполнять
Übersetzung	перевод
Schätzungen	оценки
Verletzung	травма
Ministerium	министерство
Treiber	водители
Anwalt	адвокат
Figuren	цифры
geschützt	защищенный
Vorschlag	предложение
teilen	разделение
Portal	портал
Beta	бета
gratis	бесплатно
zu	к
leicht	немного
helfen	помощь
Verhalten	поведение
enthalten	содержащиеся
Gesetzgebung	законодательство
Berufung	призвание
Parameter	параметры
Profile	профили
Angelegenheiten	вопросы
Häuser	дома
Steuerung	управления
kombiniert	комбинированный
letzte	окончательный
Vertreter	представитель
geringer	незначительный
Abteilungen	ведомства
Bewohner	жители
angezeigt	отображается
Mama	Мама
reduziert	уменьшенный
Selten	редкий
durchgeführt	выполнено
extrem	экстремальный
Proben	образцы
Riegel	брусья
Prognose	прогноз
entfernt	удален
Zyklus	цикл
enthalten	содержать
Richtigkeit	точность
Schlaf	спать
mg	мг
Vogel	птица
Apotheke	аптека
Schaffung	создание
statisch	статический
Jäger	охотник
Adressen	адреса
Dame	леди
Kristall	кристалл
berühmt	известный
Schriftsteller	писатель
Vorsitzende	председатель
Getränk	напиток
Akademie	академия
dynamisch	динамический
Essen	есть
permanent	постоянный
Reinigung	уборка
bildet	составляет
Mappe	портфолио
praktisch	практическое
geliefert	доставлен
Infrastruktur	инфраструктура
Farbe	цвет
Verkäufer	продавец
Philosophie	философия
Verordnung	регулирование
Offiziere	офицеры
Ziel	цель
Gebote	предложения
Ernährung	питание
Aufzeichnung	запись
Junior	младший
les	ле
Kap	мыс
Ringe	кольца
Spitze	наконечник
wunderbar	замечательно
Fahrkarte	билет
angekündigt	объявленный
vermuten	Угадай
wem	кого
Fußball	футбольный
Mathematik	математический
einführen	Импортировать
Entsendung	проводка
Gegenwart	присутствие
automatisch	автоматический
Besichtigung	просмотр
gepflegt	поддерживается
CH	ч
Dan	Дан
Hunde	собаки
Direktoren	директора
Aspekte	аспекты
voraus	впереди
Mond	Луна
Beteiligung	участие
planen	схема
Fliege	летать
Weise	манера
Matrix	матрица
Kombination	сочетание
Änderung	поправка
Stärke	прочность
Truthahn	Турция
Bibliotheken	библиотеки
richtig	правильный
Grad	степени
Unternehmen	предприятия
Delta	дельта
Angst	страх
suche	Ищу
Zoll	дюймов
Konvention	условность
Anteile	акции
Schulleiter	главный
Komfort	комфорт
Farben	цвета
Kriege	войны
Bestellung	заказ
gehalten	хранится
Alpha	альфа
Beschwerde	обращение
Kreuzfahrt	круиз
Bonus	бонус
Hallo	Привет
Gebäude	здания
Angebote	скидки
schlagen	бить
Batterien	батареи
wird	становится
fährt	диски
Waffen	оружие
Tee	чай
verbessert	улучшен
leisten	достигать
Positionen	позиции
Kleid	платье
Abonnement	подписка
Händler	дилер
zeitgenössisch	современный
Himmel	небо
Rom	ПЗУ
getragen	осуществляется
Exposition	воздействие
verbergen	скрывать
Unterschrift	подпись
Müller	мельник
Bereitstellung	обеспечение
Kleider	одежда
Rahmen	кадры
bestimmt	безусловно
Zeitung	газета
Spielzeug	игрушка
Schicht	слой
gedruckt	печатные
langsam	медленный
Entfernung	удаление
Haftung	ответственность
Drucker	принтеры
Hinzufügen	добавление
Stelle	место
verbringen	проводить
Fabrik	завод
Innere	интерьер
wachsen	расти
optisch	оптический
Beförderung	продвижение
relativ	относительный
tolle	удивительно
Punkt	точка
Identität	идентичность
Umwandlung	преобразование
Gefühl	чувство
versteckt	скрытый
angemessen	разумный
Revision	пересмотр
beeinflussen	влияние
Verhältnis	соотношение
Bedeutung	важность
Regen	дождь
Planet	планета
Kopien	копии
erlauben	разрешать
Sehen	видя
Beweis	доказательство
Bass	бас
Rezept	рецепт
leer	пустой
Beispiel	пример
Loch	дыра
Reiten	поездка
Büro	бюро
Erhaltung	сохранение
Paar	пара
Ideal	идеальный
Brille	функции
verzeichnet	записанный
Don	дон
Stücke	куски
fertig	законченный
Parks	парки
Rechtsanwälte	адвокаты
Stress	стресс
Sahne	крем
ss	сс
läuft	работает
entdecken	обнаружить
ap	ар
Muster	узоры
Hügel	холмы
nm	нм
Berater	консультант
bewusst	знать
gestalten	форма
Evolution	эволюция
Zertifikate	сертификаты
Ziele	цели
Stationen	станций
empfohlen	предложенный
op	оп
Überreste	остатки
Firmen	фирмы
Euro	евро
Operator	оператор
Strukturen	сооружения
generisch	общий
Enzyklopädie	энциклопедия
Verwendung	Применение
Tinte	чернила
gemischt	смешанный
Volkszählung	перепись
Rad	колесо
Lieferanten	поставщики
kompakt	компактный
Poesie	поэзия
Beleuchtung	огни
Verfolgung	отслеживание
Engel	ангел
Vorbereitung	подготовка
Versuch	попытка
Empfang	получение
Streichhölzer	Матчи
Übereinstimmung	соответствие
Breite	ширина
Motoren	двигатели
vergessen	забывать
Feld	массив
diskutiert	обсуждается
genau	точный
Klima	климат
griechisch	греческий
Anweisung	инструкция
Verwaltung	управление
roh	сырье
Unterschiede	различия
erklären	объяснять
Gründen	установить
ausgedrückt	выраженный
Umfang	степень
Scharf	острый
ben	Бен
Absatz	параграф
töten	убийство
Mathematik	математика
Vergütung	компенсация
Export	экспорт
Manager	менеджеры
Module	модули
geführt	проведены
Versionen	версии
weiß	знает
beschreiben	описывать
Bürger	граждане
Erbe	наследие
Ärger	беда
Trainer	тренер
landwirtschaftlich	сельскохозяйственное
erweitern	расширять
Publikum	аудитория
zugewiesen	назначенный
Sammlungen	коллекции
Ewigkeit	возраст
Spezialist	специалист
Koch	готовить
beeinflussen	аффект
Jungfrau	девственница
erfahren	опытный
Ermittlung	расследование
angehoben	поднятый
Hut	шапка
Institution	учреждение
gerichtet	направленный
betroffen	пострадавших
Fahrrad	велосипед
total	полностью
Teller	пластина
Kosten	затраты
zeigen	указывать
blond	блондинка
Verfahren	производство
Favorit	любимый
Eigenschaften	характеристики
der	дер
verlieren	потерять
organisch	органический
suchen	искать
Erfahrungen	опыт
Alben	альбомы
Verträge	контракты
Gäste	гости
Gastgeber	состоялся
Krankheiten	болезни
über	относительно
äquivalent	эквивалент
Chemie	химия
Kits	комплекты
Logik	логика
Prinz	принц
Kreis	круг
Boden	почва
Psychologie	психология
nass	влажный
Umstände	обстоятельства
Investor	инвестор
elementar	элементарный
Sponsoren	спонсоры
Fuchs	лиса
unbegrenzt	неограниченный
reagieren	отвечать
Größen	размеры
einfach	гладкий
Ausfahrt	Выход
Arm	рука
Schlüssel	ключи
Welle	волна
heilig	святой
Handlungen	акты
Beratung	руководство
Weg	след
Symbol	символ
Autobahn	шоссе
beobachtete	наблюдаемый
Dean	декан
Konfiguration	настроить
Umfrage	голосование
Arten	стили
gefüllt	заполненный
Bindung	связь
Kanäle	каналы
Blinddarm	приложение
Schokolade	шоколад
Portion	часть
Umfang	объем
Lieferant	поставщик
Kabel	кабели
Baumwolle	хлопок
Anforderung	требование
getötet	убитый
Rand	граница
alt	древний
Debatte	обсуждение
Vertreter	представители
beginnt	начинается
Schwangerschaft	беременность
Sehenswürdigkeiten	достопримечательности
gelernt	научился
Transaktionen	операции
Forscher	исследователь
historisch	исторический
Mann	муж
autorisiert	уполномоченный
verrückt	псих
bevorstehende	предстоящий
Konzert	концерт
Partituren	множество
Wirksamkeit	эффективность
Komödie	комедия
angenommen	принят
effizient	эффективное
linear	линейный
Engagement	обязательство
Spezialität	специальность
Bären	медведи
hüpfen	хмель
Träger	перевозчик
Konstante	постоянная
Visa	виза
Mund	рот
Meter	метр
verbunden	связанный
Interviews	интервью
Konzepte	концепции
Gewehr	пистолет
reflektieren	отражать
rein	чистый
Hölle	ад
Obst	фрукты
beginnt	начинается
qualifiziert	квалифицированный
Reform	реформа
Linse	объектив
behandelt	обрабатывали
Entdeckung	открытие
zeichnen	привлечь
klassifiziert	объявление
annehmen	предполагать
Allianz	союз
bestätigen	подтвердить
Ingenieur	инженер
konsistent	последовательный
ersetzen	замещать
Spielraum	зазор
Konverter	конвертер
Organisation	организация
Baby	младенец
Schecks	проверки
erreicht	достиг
Werden	становление
Zielsetzung	задача
angezeigt	указанный
Zucker	сахар
Crew	экипаж
Beine	ноги
Stock	придерживаться
Beziehung	связь
aktiviert	включен
Genre	жанр
Freiwillige	доброволец
Rückseite	задний
demokratisch	демократической
verbessern	усилить
genau	точный
gebunden	связанный
Parameter	параметр
Prozessor	процессор
Knoten	узел
formal	формальный
Sturm	буря
Mikro	микро
Hochschulen	колледжи
Meile	мили
Herausforderungen	проблемы
Redakteure	редакторы
höchste	высший
Brüder	братья
Anerkennung	признание
ref	ссылка
schätzen	оценить
Kind	дитя
Inspektion	осмотр
Verbraucher	потребители
Grenzen	пределы
Gebiet	территория
Bewaffnung	оружие
verzögern	задержка
Pilot	пилот
Beiträge	взносы
kontinuierlich	непрерывный
Initiative	инициатива
Roman	роман
Ausführung	выполнение
Behinderung	инвалидность
Ultra	ультра
Gewinner	победитель
Folge	эпизод
Töpfer	гончар
Gericht	блюдо
Theaterstücke	игры
Bekanntmachung	бюллетень
ia	Айова
ändern	модифицировать
wirklich	действительно
Universum	вселенная
Kandidat	кандидат
Slot	слот
hervorragend	выдающийся
Ha	ха
geplant	планируемый
Hütte	домик
Spiegel	зеркало
Turnier	турнир
Berücksichtigung	рассмотрение
Sitzungen	сессий
Kern	ядро
Käufer	покупатели
Zeitschriften	журналы
grau	серый
Katalog	каталог
berechnet	заряженный
breit	широкий
und	унд
gewählt	выбранный
Demo	демонстрация
Hass	ненавидеть
Terminal	Терминал
Verlag	издатели
Nächte	ночью
Flüssigkeit	жидкость
Reis	рис
Reservierung	бронирование
Lebensmittel	продукты
bewachen	охрана
Einsparung	экономия
Reich	империя
neu	вновь
erziehen	повышение
illegal	нелегальный
Erweiterung	расширение
Premier	премьер
Morgen	завтра
Milch	молоко
Theater	драма
Besuch	посещение
Wettbewerb	конкурс
gesammelt	собранный
Bands	группы
geeignet	подходящее
absolut	абсолютно
Prüfung	аудит
Kammer	камера
Guinea	Гвинея
Ergebnisse	Выводы
iso	ISO
typisch	типичный
Summe	сумма
Hähnchen	курица
vorübergehend	временный
besuchen	посещать
Dusche	душ
Versendung	отправка
ausreichend	достаточно
Schale	оболочка
Provinz	провинция
katholisch	католик
Gouverneur	губернатор
Bier	пиво
Beitrag	вклад
Formel	формула
Verfassung	конституции
Verpackung	упаковка
zuverlässig	надежный
Zweifel	сомнение
verdienen	зарабатывать
Perioden	периодов
Anschläge	нападки
Waren	товар
Symptome	симптомы
Denkmal	мемориал
Zwilling	близнец
einfügen	вставить
Tor	шлюз
Zeichnung	Рисование
Kandidaten	кандидаты
bestellt	приказал
biologisch	биологический
Kampf	борьба
Übergang	переход
Vorlieben	предпочтения
Spion	шпион
Romantik	романс
Instrument	инструмент
Teilt	Трещина
Themen	темы
Befugnisse	полномочия
Himmel	небо
Bits	биты
schwanger	беременная
Einstufung	классификация
konzentriert	сосредоточены
Arzt	врач
fragen	просить
Blöcke	блоки
lo	вот
geistig	духовный
Diabetes	диабет
ml	мл
Verschiebung	сдвиг
sitzen	сидеть
Körper	тела
Fotos	фотографии
Schneiden	резка
Schriftsteller	писатели
flexibel	гибкий
liebte	любимый
Favoriten	избранное
Kartierung	отображение
zahlreich	многочисленные
verhältnismäßig	относительно
repräsentiert	представляет
überlegen	превосходящий
bevorzugt	предпочтительным
Gerettet	сохранены
intellektuelle	интеллектуальной
gewährt	предоставляется
Kohlenstoff	углерод
gemütlich	удобный
magnetisch	магнитные
Interaktion	взаимодействие
Hören	прослушивание
Krise	кризис
Ausblick	прогноз
massiv	массивный
hell	яркий
gebildet	сформированный
Klavier	пианино
Echo	эхо
Revolution	революция
Displays	дисплеи
Plasma	плазма
Verdienste	прибыль
Geheimnis	тайна
Landschaft	пейзаж
mechanisch	механический
Reise	поездка
Banner	баннер
Feige	инжир
Grafschaften	графств
Erwerb	получение
anerkannt	признанное
Träume	мечты
Benachrichtigung	уведомление
kg	кг
lehren	учат
schnell	быстрый
ziehen	вытащить
ut	Юта
Seminar	семинар
Investitionen	вложения
Räder	колеса
angeben	указывать
empfindlich	чувствительный
Vorlagen	шаблоны
Formate	форматы
hält	держит
Router	маршрутизатор
Beton	бетон
si	си
Mappe	папка
Fertigstellung	завершение
Impuls	пульс
Technik	техника
Wählen	голосование
Justiz	суды
umgewandelt	переоборудованный
Metro	метро
Jahrestag	Годовщина
Verbesserungen	улучшения
Streifen	полоса
Spezifikation	Спецификация
Unfall	авария
Kerbe	Ник
zugänglich	доступной
Bewohner	резидент
Handlung	сюжет
typisch	типично
Darstellung	представление
Pumpe	насос
existiert	существует
Vereinbarungen	договоренности
Konferenzen	конференций
Verbrauch	потребление
eng	узкий
Bedrohung	угроза
Umfragen	опросы
Sitzung	сидящий
Berater	консультант
Regler	контроллер
Ausschüsse	комитеты
Penis	пенис
Schloss	замок
Gardens	сады
Etiketten	этикетки
bereit	готовы
bio	био
Schauspielkunst	действующий
Köpfe	руководители
Prüfung	экзамен
Residenz	резиденция
Dichte	плотность
hundert	сто
seltsam	странный
nachhaltig	устойчивый
statistisch	статистический
erwähnen	упомянуть
Innovation	инновация
grau	серый
parallel	параллельно
arbeiten	работать
Banknoten	банкноты
stabil	стабильный
Definitionen	определения
von	фон
Ärzte	врачи
Lektion	урок
Kino	кино
Wahlen	выборы
Reaktion	реакция
leer	пустой
verbessert	повышенная
berechtigt	озаглавленный
schwer	серьезный
generieren	генерировать
Zeitungen	газеты
Krankenhäuser	больницы
vi	VI
Humor	юмор
alt	престарелый
Monitore	мониторы
Ausnahme	исключение
Dauer	продолжительность
Masse	насыпной
Besuche	посещения
Fähigkeiten	возможности
Empfehlung	рекомендация
Sünde	грех
organisiert	организованная
ba	ба
para	пункт
Annahme	принятие
Verbesserung	улучшение
teuer	дорогая
Büffel	буйвол
Organisationen	организации
Ebene	самолет
Programme	программы
Mechanismus	механизм
ee	й
markiert	отмеченный
Gefahren	управляемый
Flasche	бутылка
innovativ	инновационный
Massage	массаж
Fazit	вывод
Schließen	закрытие
tausend	тысяча
Legende	легенда
Villa	вилла
Knochen	кость
Säulen	столбцы
Störungen	расстройства
Zusammenarbeit	сотрудничество
Entdeckung	обнаружение
innere	внутренний
Formation	образование
med	мед
Ingenieure	инженеры
Entität	организация
Kreuzfahrten	круизы
Tor	Ворота
römisch	Римский
Aufgaben	обязанности
erotisch	эротический
Ton	тон
Ethik	этика
Drachen	Дракон
beschäftigt	занятый
Kapitän	капитан
bringt	приносит
Heizung	обогрев
Bein	ножка
Hals	шея
Flügel	крыло
Skripte	скрипты
ABC	азбука
ernannt	назначенный
Behandlung	дело
verpflichten	совершить
Schiene	рельс
Reisen	поездки
Spalt	разрыв
Seiten	стороны
Tube	трубка
dazugehörigen	соответствующий
Beschreibungen	описания
Gürtel	ремень
Jacke	куртка
Animation	анимация
Orakel	оракул
er	эр
Produktionen	производства
Luftfahrt	авиация
stolz	гордый
Katastrophe	катастрофа
Konsole	консоль
Befehle	команды
jr	младший
Telekommunikation	связь
Lehrer	инструктор
Riese	гигант
erreicht	достигнутый
Verletzungen	травмы
Ansätze	подходы
gewöhnlich	обычный
Briefmarken	Марки
Winkel	угол
rauben	грабить
Designer	дизайнеры
Freiheit	свобода
Epoche	эпоха
Konvertieren	конвертировать
Möglichkeit	возможность
Analytiker	аналитик
gefährlich	опасно
Zuverlässigkeit	надежность
beziehungsweise	соответственно
Freiwillige	добровольцы
abgeleiteten	полученный
Vergnügen	удовольствие
Ehre	честь
orientiert	ориентированного
Adler	орел
Gebet	молитва
Workshops	мастерские
Hurrikan	ураган
ruhig	тихо
Hersteller	режиссер
repräsentiert	представленный
Verantwortlichkeiten	обязанности
Käse	сыр
vorsichtig	внимательно
Produktivität	производительность
Krone	корона
Par	паритет
Diagnose	диагностика
Hersteller	производитель
Riss	трещина
Prinzip	принцип
Picks	кирки
Gang	банда
Fetisch	фетиш
Aussehen	появление
Rauch	дым
Filter	фильтры
inkorporiert	включенный
Kunst	ремесло
Gefährte	человек
blind	слепой
Salon	гостиная
wütend	Сумасшедший
Algorithmus	алгоритм
stark	сильно
Cafe	кафе
ken	кругозор
Proteine	белки
su	су
familiär	знакомые
fähig	способный
Eintritt	вход
Schuh	башмак
gewählt	избран
Tragen	проведение
Terrorismus	терроризм
Freude	радость
Ausgaben	издания
ethnisch	этнической
Parlament	парламент
Darsteller	актер
Funde	находки
Dichtung	печать
Situationen	ситуации
fünfte	пятый
Bürger	гражданин
vertikal	вертикальный
Korrekturen	поправки
beschreibt	описывает
Behinderungen	инвалидов
Substanz	вещество
verboten	запрещено
Rohr	труба
Soldaten	солдаты
Wächter	опекун
Vorlesung	лекция
Simulation	моделирование
Layout	расположение
Initiativen	инициативы
krank	больной
Konzentration	концентрация
legen	прокладывать
Deutung	интерпретация
dreckig	грязный
unterrichtet	учил
Arbeitnehmer	работник
Optimierung	оптимизация
Tempel	храм
Substanzen	вещества
beweisen	доказывать
entdeckt	обнаруженный
Flügel	крылья
genetisch	генетический
Beschränkungen	ограничения
dünn	тонкий
Ausstellung	выставка
Grat	хребет
Modem	модем
bringen	приведение
krank	больной
bewerten	оценивать
tropisch	тропический
sammeln	собирать
Vektor	вектор
bestimmt	определенно
Drehung	превращение
Existenz	существование
Kommentar	комментарий
Entwicklungen	события
Einwanderung	иммиграция
Reiseziele	направления
gegenseitig	взаимное
Syntax	синтаксис
li	литий
Attribut	атрибут
Gefängnis	тюрьма
Fertigkeit	умение
Stühle	стулья
Umgebung	окружающих
Berge	горы
Popularität	популярность
Anfrage	запрос
geprüft	проверено
Ausstellungsstück	экспонат
werfen	бросать
Trend	тенденция
Katzen	коты
Wüste	пустыня
ya	я
Koordinator	координатор
Quecksilber	Меркурий
Verbrennung	сжигание
Flucht	побег
Empfänger	получатель
progressiv	прогрессирующий
Boote	лодки
Meisterschaft	чемпионат
Arkade	аркада
unmöglich	невозможно
erzählt	говорит
offensichtlich	очевидный
Depression	депрессия
Graph	график
Abdeckung	покрытие
Platin	платина
Beurteilung	суждение
Gespräche	переговоры
Einreichung	подача
fördern	способствовать
ausgezeichnet	награжден
Versuche	испытания
Meister	мастера
Patrone	картридж
Erläuterung	объяснение
org	организация
Betrug	мошенничество
Elektrizität	электричество
Spektrum	спектр
Ankunft	прибытие
Keramik	керамика
Betonung	акцент
genial	здорово
Bestätigt	подтвердил
zählt	счетчики
Absturz	авария
Aufzug	лифт
inter	между
Höhen	высоты
Schatten	тень
Ausgabe	расходы
wagen	предприятие
Klinik	клиника
Heilung	исцеление
Prinzessin	принцесса
Eingeben	входящий
Paket	пакет
Studios	студии
Beteiligung	участие
Papa	папа
Tasten	кнопки
Platzierung	размещение
Beobachtungen	наблюдения
Gewinner	победители
Straßen	дороги
anschließend	последующий
Garten	двор
Bekanntgabe	раскрытие
Einrichtung	создание
Erinnerungen	воспоминания
te	тэ
schafft	создает
Gesichter	лица
Tourist	турист
Mord	убийство
angemessene	адекватный
Senator	сенатор
Präsentationen	презентации
verdauen	дайджест
Staub	пыли
Wiki	вики
ersetzt	заменены
Radar	радиолокационный
Verluste	потери
Kampf	бой
Reduzierung	сокращение
gestoppt	остановился
Besetzung	занятие
eng	тесно
Strahlung	излучение
Könige	короли
Schießen	стрельба
Ohr	ухо
Flaggen	флаги
Bäcker	пекарь
konservativ	консервативный
Schock	шок
Wirksamkeit	эффективность
Krawatte	галстук
Dach	крыша
zeigen	демонстрировать
Atmosphäre	атмосфера
Kuss	поцелуй
Tier	зверь
ra	ра
betrieben	управляемый
Experiment	эксперимент
Ziele	цели
Einkäufe	покупки
Föderation	федерация
Pizza	пицца
eingeladen	приглашенный
Zuordnung	назначение
modern	модификация
Abfragen	запросы
Abwesenheit	отсутствие
Anbieter	поставщики
Yoga	йога
dient	служит
Überraschung	сюрприз
Lampe	лампа
Witze	шутки
Beratung	консультирование
Palast	дворец
zufrieden	доволен
Gewinnt	победы
Warenhaus	склад
soll	предполагаемый
gewöhnliche	обычный
Geist	призрак
Verstoß	нарушение
Boss	босс
Stolz	гордость
Erwartungen	ожидания
Unabhängigkeit	независимость
wissend	знание
Reporter	репортер
Stoffwechsel	метаболизм
Champion	чемпион
persönlich	лично
reichlich	много
Solo	соло
Kehle	горло
Reichtum	богатство
Vakuum	вакуум
Tanzen	танцы
erkenne	признать
schreibt	пишет
Piazza	площадь
Suche	поиск
veröffentlichen	публиковать
Abschirmung	скрининг
trans	транс
Pionier	пионер
Vergessene	забытый
Akrobat	акробат
Platten	тарелки
Aufsätze	эссе
Verhalten	поведение
erzählen	говоря
ziemlich	довольно
intelligent	умный
Modi	режимы
Verpflichtung	обязательство
Hafen	гавань
Reisende	путешественник
Segment	сегмент
Feind	враг
Puzzle	головоломка
Brunnen	углубления
beschränkt	ограниченный
Republikaner	республиканец
Geheimnisse	секреты
Syndrom	синдром
Teilnahme	посещаемость
Elfmeter	штраф
Trommel	барабан
ermöglicht	позволяет
Baumeister	строитель
Aussicht	перспектива
Flut	наводнение
Leichtigkeit	легкость
Argumente	аргументы
Arena	арена
Abenteuer	приключения
Schüler	зрачки
Ankündigung	объявление
Ergebnis	исход
schätzen	ценить
ergänzt	расширенный
gewachsen	взрослый
schön	прекрасный
Zentren	центры
Klausel	пункт
Lächeln	улыбка
Länder	земли
Truppen	войска
bewaffnet	вооруженный
Kiefer	сосна
Kühlung	охлаждение
Golf	залив
LKW	грузовики
Mechanismen	механизмы
Scheidung	развод
Tradition	традиция
Pillen	таблетки
Tiger	тигр
Leute	люди
Sensor	датчик
ausgesetzt	подвергаются
Jagd	охота
Engel	ангелы
Stellvertreter	заместитель
thailändisch	тайский
Emissionen	выбросы
Ärzte	врачи
Beschwerde	жалоба
Szenen	сцены
Experimente	эксперименты
Auftrieb	увеличение
Führung	управление
Mühle	мельница
Gegründet	основанный
chronisch	хронический
Höhle	логово
Finger	Палец
hält	держит
Pfund	фунт
Lokalisieren	разместить
pl	пл
trainiert	обученный
Umsetzung	реализации
Brot	хлеб
Motoren	моторы
zäh	жесткий
Vorfall	инцидент
Dynamik	динамика
Lüge	ложь
Konversation	разговор
verringern	снижение
Anbetung	поклонение
Fähigkeit	возможность
ak	Аляска
Präzision	точность
Schadenersatz	убытки
Reserve	резервы
lösen	решать
Minderheit	меньшинство
vielfältig	разнообразный
Zutaten	ингредиенты
Ah	ах
Töne	тоны
Rehabilitation	реабилитация
Sicht	взгляд
Lehm	глина
schwach	слабый
geteilt	разделенный
Rezeption	прием
weise	мудрый
Chancen	шансы
Seminare	семинары
Folgen	последствия
Entscheidungsträger	производители
Erdkunde	география
Integrität	целостность
Erbe	наследие
zufrieden	довольный
Achtung	Опасность
Vitamin	витамин
verarbeitet	обработанный
Phrase	фраза
erziehen	привлечение
Auswirkungen	последствия
Funktionalität	функциональность
Paradies	рай
hybrid	гибридный
liest	читает
emotional	эмоциональный
Ruhm	слава
ja	JA
geographisch	географический
überschreiten	превышать
Stange	стержень
Seide	шелк
Babys	дети
Bi	би
romantisch	романтик
aufgedeckt	показал
Spezialisten	специалисты
Generator	генератор
Suspension	подвеска
traurig	грустный
Korrektur	коррекция
Wolf	волк
langsam	медленно
Ergänzung	дополнение
Teile	участки
Säugling	младенец
Branchen	секторов
Flüssigkeit	жидкость
Begründung	основания
Mahlzeit	еда
ta	та
Maschinen	машины
Gleichung	уравнение
Körbe	корзины
Wahrscheinlichkeit	вероятность
Abmessungen	измерение
studierte	изучал
Gewinne	доходы
Teufel	дьявол
Gras	трава
illustriert	иллюстрированный
Kirsche	вишня
kontinental	континентальный
Leistung	достижение
Einschränkungen	ограничения
Beerdigung	похороны
Kapitel	главы
Passagier	пассажир
praktisch	удобный
Mars	Марс
Größe	размера
Ei	яйцо
Signale	сигналы
Orientierung	ориентация
Diebstahl	кража
Kindheit	детство
Symbole	символы
lat	Lat
Meta	мета
Analog	аналоговый
Talent	талант
datiert	датированный
Weisheit	мудрость
Grenze	граница
Elite	элита
gi	солдат
glaubt	считает
Gedichte	стихи
Zuständigkeit	юрисдикция
Roboter	робот
Anzeige	отображение
Zeuge	свидетель
ausgestattet	оборудованный
Stufen	этапы
sur	сюр
erworben	приобретенный
beurteilen	оценить
waschen	мыть
Eingang	вход
Erklärung	декларация
verlieren	проигрыш
Versuche	попытки
edel	благородный
Automatisierung	автоматизация
Auswirkungen	воздействие
Umdrehung	оборот
Vorteile	преимущества
Ritter	рыцарь
Ziele	цели
Erweiterungen	расширения
Einsprüche	апелляции
Krankheit	болезнь
ho	эй
Alternativen	альтернативы
Sch	ш
Seife	мыло
Marmelade	варенье
ungewöhnlich	необычный
antwortete	ответил
Zerstörung	разрушение
Migration	миграция
Störung	расстройство
konventionell	обычный
tragen	носить
Achse	ось
gesucht	искать
Gene	гены
Median	медиана
Scanner	сканер
hierin	здесь
lebhaft	мультипликационный
Einstellung	регулировка
Held	герой
Behandlungen	лечение
Haltung	отношение
Teppich	ковер
Linsen	линзы
besucht	участие
Schwierigkeit	трудность
Punk	панк
Koalition	коалиция
Einschreibung	регистрация
Herzog	герцог
Tempo	темп
Produzenten	производители
Bogen	дуга
Schnittstellen	интерфейсы
Atlas	атлас
Überwachung	наблюдение
Folter	пытки
gelöscht	удаленный
Mantel	Пальто
Wiederherstellung	восстановление
Bequemlichkeit	удобство
Rückkehr	возврате
Opposition	оппозиция
Container	контейнер
Beklagte	ответчик
Supervisor	руководитель
Korps	корпус
Schauspieler	актеры
Leber	печень
haftbar	подлежащий
Petition	петиция
Antenne	антенна
gepflückt	выбрал
Glauben	вера
Tötung	убийство
Schulter	плечо
Dekor	оформление
Ion	ион
Durchmesser	диаметр
Podcast	подкаст
Wechselwirkungen	взаимодействия
Sänger	певец
Herold	вестник
Altern	старение
Intervention	вмешательство
Plugin	плагин
Attraktion	Привлечение
Tauchen	дайвинг
Änderung	модификация
annehmen	предполагать
Schilf	тростник
betreffen	включать
mäßig	умеренный
Mäuse	мышей
verstanden	понимать
schnell	быстро
Verbot	запрет
Sicherheit	гарантия
Ereignis	происходит
weit	огромный
Mühlen	мельницы
Gliederung	контур
erhält	получает
Jeans	джинсы
Zusammenstellung	сборник
ungerade	странный
sigma	сигма
GR	гр
attraktiv	привлекательный
Gelegenheit	повод
Aufnahmen	записи
Opfer	жертва
Forderungen	требования
Vorsichtig	осторожный
Strahl	луч
Gartenarbeit	садоводство
Verbindlichkeiten	обязательства
ankommen	прибыть
Orchester	оркестр
Lizenz	лицензия
einstellbar	регулируемый
Zuweisung	распределение
Aufsatz	сочинение
gezeigt	продемонстрировал
Dialog	диалог
Lager	лагеря
erklärt	объявленный
Spur	след
geschlossen	закрыть
Packungen	пакеты
ge	GE
Installation	установка
Schalter	переключатели
freiwillig	добровольный
du	ты
sehr	значительно
ng	нг
häufig	обычно
pe	ре
Fotograf	фотограф
Schrei	плакать
Quant	квант
konstruiert	построенный
Ergänzungen	дополнения
erforderlich	требующий
Pfeil	стрела
Engagement	помолвка
Rau	грубый
seltsam	странный
Löwe	лев
Hochzeiten	свадьбы
Sauerstoff	кислород
Schlucht	каньон
Meter	метры
nur	просто
Kalender	календари
Anordnung	договоренность
Schlussfolgerungen	выводы
Literaturverzeichnis	Библиография
Zeiger	указатель
Kompatibilität	совместимость
strecken	протяжение
Genehmigungen	разрешения
Kooperative	кооператив
Ernährung	кормление
Gemeinde	городок
Ranglisten	рейтинги
Messung	измерения
Gurt	ремень
Menge	толпа
Transfers	переводы
olympisch	олимпийский
Transformation	преобразование
dir	реж
Zoll	обычаи
Administratoren	администраторы
Persönlichkeit	личность
Haken	крюк
Roulette	рулетка
Ablehnen	снижение
Kabel	шнур
Wolke	облако
erleichtern	содействовать
val	вал
erklärt	объясняет
Vorgehen	продолжить
Gefühle	чувства
Messer	нож
adoptieren	принять
verweigert	отказано
Spende	пожертвование
äußere	внешний
Ernte	культура
Flüsse	реки
Knoten	узлы
zitiert	цитируется
Nabe	хаб
gezielt	целевое
erkannte	понял
Gründer	основатель
Dekade	десятилетие
Streit	спор
müde	устала
negativ	неблагоприятный
Auszug	выдержка
entladen	разряд
Getränke	напитки
As	туз
Stimmen	голоса
Kletterei	альпинизм
Tonnen	тонны
Parfüm	духи
gefährlich	опасный
wiederherstellen	восстановить
Stapel	стек
Methodik	методология
Ruf	репутации
Demokraten	демократы
aufhängen	вешать
Kurve	кривая
Schöpfer	создатель
Bernstein	янтарный
Museen	музеи
Verschlüsselung	кодирование
Tracker	трекер
Variation	изменение
Passage	прохождение
übertragen	переданы
Kofferraum	хобот
Foto	фотография
Wellen	волны
Kamel	верблюд
Verteiler	распределитель
chi	чи
Versammlung	сбор
Projektion	проекция
mathematisch	математическая
logisch	логический
Soße	соус
Ruhm	известность
spezialisiert	специализированный
Unternehmen	корпорации
Kritik	критика
Automobil	автомобиль
Jury	судьи
Bemerkungen	замечания
detektiert	обнаруженный
Gemälde	картины
ging	ходил
entstehen	возникающий
Populationen	популяции
ängstlich	боюсь
akustisch	акустическое
Kassette	кассета
Indikator	индикатор
jpg	JPG
Fehler	ошибка
beseitigen	Устранить
Mineral	минеральная
Rubin	Рубин
Perlen	бисер
Vermögen	состояние
Segeltuch	холст
Schwelle	порог
Gemeinde	приход
Bildschirme	экраны
Friedhof	кладбище
Stadion	стадион
Erkundung	исследование
min	мин
Stengel	стебель
Astronomie	астрономия
Wettbewerbe	конкурсы
Grippe	грипп
Kostüm	костюм
Fahrräder	велосипеды
Bischof	епископ
zog	вытащил
Mais	кукуруза
Kompression	компрессия
Festlegung	налаживание
Farmer	фермер
Zinn	банка
Sklave	рабыня
sofort	немедленно
Coaching	тренировка
geprüft	рассмотрел
Codierung	кодирование
Einreichungen	Доводы
Helden	герои
gemalt	окрашенный
Porträt	портрет
Terrorist	террорист
ethisch	этический
Träger	носители
Mobilität	мобильность
Kampf	борьба
Regelungen	схемы
Leiden	страдающий
neutral	нейтральный
Fischer	рыболов
Ratte	крыса
Speere	копья
Beitritt	присоединение
Überschrift	заголовок
künstlich	искусственный
Lager	подшипник
spektakulär	захватывающий
Welten	миры
schuldig	виновный
Aktivierung	активация
Oase	убежище
Tablette	таблетка
Jury	жюри
DOS	DOS
Schwanz	хвост
Charme	очарование
heftig	насильственный
möglicherweise	потенциально
Ranch	ранчо
Einschränkungen	ограничения
Kreuzung	скрещивание
inklusive	включительно
Hütte	коттедж
betrunken	пьяный
beträchtlich	значительный
Verbrechen	преступления
aufgelöst	решены
Byte	байт
Nase	нос
Geäst	ветви
Ausländer	инопланетянин
Prozessoren	процессоры
Pleite	сломал
Komplexität	сложность
ständig	постоянно
Entschlossenheit	разрешить
Gebiete	территории
These	Тезис
Scheiben	диски
häufig	частый
Decke	потолок
Pixel	пикселей
gen	поколения
Diamanten	бриллианты
Flotte	флот
Bündel	гроздь
theoretisch	теоретический
Verweisung	направления
Verlassen	уволиться
Protokolle	протоколы
Lunge	легкое
Ersatz	замена
brillant	блестящий
ti	ти
Gel	гель
gesprochen	разговорный
Omega	омега
bewertet	оценивали
blieb	остались
sieht	видит
Beendigung	прекращение
schaute	смотрели
Haushalte	домохозяйства
einlösen	выкупать
Korn	зерно
Regime	режим
Stier	бык
architektonisch	архитектурный
abweichen	отличаться
Bewegungen	движения
Reparaturen	ремонт
Atem	дыхание
Komfort	услуги
virtuell	фактически
Markt	рынок
Kerze	свеча
hängend	подвешивание
farbig	цветной
Geschichte	рассказ
früher	раньше
Beamer	проектор
gelegen	расположенный
sucht	стремится
streng	строго
psychologisch	психологический
Vitamine	витамины
elegant	элегантный
Gewinne	доходы
Erneuerung	обновление
Genealogie	генеалогия
als	считается
Wertung	счет
Ausgaben	расход
Kritik	критики
Algorithmen	алгоритмы
Hacker	хакер
Salon	салон
Turbo	турбо
heilen	лечение
ni	п
denkt	думает
Vorschlag	предложение
Soldat	солдат
Bombe	бомбить
Schaden	вред
Intervall	интервал
Spiegel	зеркала
untersuchen	исследовать
deine	твой
Platten	панели
wiederholt	повторный
Angriff	нападение
Hirsch	олень
Zunge	язык
Bowling	боулинг
tri	три
Affe	обезьяна
Anteil	доля
Rock	юбка
Analysen	анализы
Zeichnungen	рисунки
Bedeutung	значение
Szenario	сценарий
Ihr	вы
Arabisch	арабский
Spur	калибр
Schutz	защищающий
konfrontiert	сталкиваются
Auflösung	решение
produziert	производит
intensiv	интенсивный
Ketten	цепи
sechste	шестой
engagieren	заниматься
Schaltung	переключение
Korrespondenz	переписка
Importe	импорт
Aufsicht	надзор
Ausgaben	Расходы
Trennung	разделение
Zeugnis	свидетельство
vermuten	подозреваемый
verpflichtend	обязательное
Grenzen	границы
Feier	праздник
Filter	фильтрация
Ehepartner	супруг
exotisch	экзотический
Zuschauer	зритель
reichend	достижения
Lachen	смех
chirurgisch	хирургический
zerstören	уничтожить
Zitat	цитата
yo	Эй
Lokal	предпосылки
bewährt	доказано
beleidigend	наступление
Kaiserliche	имперский
Dutzend	дюжина
Einsatz	развертывание
Stoff	ткань
Lotus	лотос
Lachs	лосось
Ladung	грузовой
Direktive	директива
Kamerad	приятель
Butter	масло
Pfeffer	перец
Waffe	оружие
Belastung	бремя
Bänder	ленты
Zonen	зон
Insel	островной
schlank	стройное
Ahorn	кленовый
Lebensmittelgeschäft	продуктовый
Regierungs	руководящий
Depot	депо
alt	альт
Kuchen	пирог
Mischung	смесь
Emission	излучение
ersichtlich	очевидный
Lehr	учебный
Berechtigungen	разрешений
Toilette	туалет
Platz	занимает
Routen	маршруты
Montage	монтаж
gebunden	связанный
ausgewogen	сбалансированный
verspätet	задерживается
Tal	дол
Berechnung	расчет
Villen	виллы
Gelegenheiten	случаи
Gleichungen	уравнения
Öl	масла
September	сентябре
außergewöhnlich	исключительный
Angst	тревожность
räumlich	пространственный
Befragten	респондентов
Überlegungen	соображения
zahlt	платит
sonnig	солнечно
liefert	обеспечивает
je	JE
Halskette	ожерелье
zusammengesetzt	композитный
lang	языки
Theater	театры
Entwerfen	проектирование
Hoffnungen	надеется
Beurteilungen	оценки
Diagramm	диаграмма
Schuhwerk	обувь
sg	SG
Völker	народов
Sieger	Виктор
Lizenzen	лицензии
Bereiche	диапазоны
Paare	пары
Empfindlichkeit	чувствительность
Erhaltung	сохранение
isoliert	изолированный
Interim	промежуточный
unterstützt	помощь
göttlich	божественный
genehmigen	одобрить
Verbindung	соединение
Intensität	интенсивность
technologisch	технологический
Abtreibung	аборт
Dialog	диалог
Veranstaltungsorte	центры
sprengen	взрыв
Adressierung	адресация
Pole	столб
Schild	щит
Membran	мембрана
verzweifelt	отчаянный
Mütter	матери
Demonstration	демонстрация
Regierungs	правительственный
hergestellt	изготовлен
Kerzen	свечи
Variationen	вариации
Mütter	мамы
heilig	священный
Sucht	зависимость
Chrom	хром
verweigert	отказалась
Bremse	тормоз
Außen	экстерьер
Gruß	приветствие
Ökologie	экология
Tal	лощина
Arbeitslosigkeit	безработица
erzielter	забил
Erweiterung	усиление
Klon	клон
Geschwindigkeit	скорость
Lambda	лямбда
zusammengesetzt	состоящий
Tränen	слезы
Oase	оазис
Taxi	такси
Fa	фа
Gesellschaften	общества
Silizium	кремний
identisch	идентичный
Petroleum	нефть
konkurrieren	конкурировать
ist	IST
Liebhaber	любовник
gehören	принадлежать
Lippen	губы
begleiten	эскорт
Teich	пруд
Fähre	паром
Hase	кролик
Beruf	профессия
Damm	дамба
Physiologie	физиология
Ausfuhr	экспорт
Reifen	шина
Teilnehmer	участник
Elektron	электрон
Ladungen	грузы
Heidekraut	вереск
Motel	мотель
Gewerkschaften	союзы
Fiskus	казначейство
belegt	занятый
Waage	Весы
Belastung	напряжение
verhaftet	арестованный
Untersuchungen	исследования
gewonnen	получили
Wäsche	прачечная
Erteilung	размещение
einstellen	регулировать
bewertet	оценивается
Verschlüsselung	шифрование
Füllung	заполнение
auferlegte	наложенный
Schweigen	тишина
sowjetisch	советский
Besitz	владение
Vertrag	договор
Trainer	тренер
Organ	орган
Zitrone	лимон
Dunkelheit	темнота
Spanne	пролет
Scherz	шутка
Verpackung	упаковка
Satzung	статут
abgelehnt	отвергнуто
Schutz	укрытие
Kapelle	часовня
Herstellung	производство
Lagen	слои
feiern	праздновать
Gerät	прибор
Mischung	смесь
Fahrer	наездник
Radius	радиус
beeindruckend	впечатляющий
Schaf	овца
Architekt	архитектор
Vorlesungen	лекции
Weine	вина
Tassen	чашки
Asche	ясень
Beiträger	авторы
Salat	салат
Verletzungen	нарушения
Temperaturen	температура
Wettbewerbe	соревнования
erhalten	сохранять
Gedicht	стих
bleiben	пребывание
Ostern	Пасха
Theorien	теории
Repository	хранилище
Strom	потоки
Landung	посадка
hingerichtet	выполненный
Verhandlungen	переговоры
realistisch	реалистический
fragt	спрашивает
Zusammenfassung	конспект
Komponist	композитор
Bohne	боб
Schwert	меч
Modifikationen	изменения
Koralle	коралловый
Pixel	пиксель
Wegen	пути
Blase	пузырь
por	Пор
erwerben	приобретать
Gegenteil	вопреки
Tribun	трибуна
Schiff	судно
Säuren	кислоты
Viren	вирусы
Aufkleber	наклейки
Reaktionen	реакции
Glauben	убеждения
Kader	команда
analysieren	анализировать
Divisionen	подразделения
schwimmen	плавать
nano	нано
Konzerte	концерты
Männchen	мужчины
behalten	сохранить
Farben	цвета
ausführen	выполнять
Tunnel	тоннель
Genre	жанры
Patente	патенты
Weizen	пшеница
Chroniken	летописи
Beschaffung	получение
Biber	бобр
Lesungen	чтения
Erweiterung	укрупнение
Adler	орлов
Basen	основы
Angeklagte	обвиняемый
Kampagnen	кампании
Einheit	единство
definiert	определяет
Instanzen	экземпляры
einheimisch	местный
begonnen	начатый
Pakete	пакеты
Anker	якорь
Socken	носки
auslösen	вызывать
Cholesterin	холестерин
Differential	дифференциал
Oberflächen	поверхности
furchtbar	ужасный
Router	маршрутизаторы
Uhren	часы
Arthritis	артрит
BIOS	BIOS
Weibchen	женщины
spiegelt	отражает
Besteuerung	налогообложение
Fieber	лихорадка
Küche	кухня
sicherlich	конечно
Praktiker	практики
Satz	теорема
Inflation	инфляция
dich	тебя
Verbindungen	соединений
Schlagzeug	барабаны
vernünftig	разумно
blank	голый
Radikale	радикал
empfiehlt	рекомендует
Regelung	управление
Schatz	сокровище
Flamme	пламя
Grube	яма
Mono	моно
Partikel	частицы
schwimmend	плавающий
Koordinate	координировать
ausschließlich	исключительно
Einschränkung	ограничение
geschlagen	пораженный
Illustration	иллюстрация
Warnungen	предупреждения
bauen	сооружать
Apps	Программы
Anfragen	запросы
annektieren	приложение
Inspiration	вдохновение
Fracht	грузовой
Finsternis	затмение
wirkt	влияет
Prognosen	прогнозы
entdecken	обнаружить
aktiv	активно
kompliziert	сложно
verletzt	пострадавший
Ausdrücke	выражения
Tonne	тонна
Kurier	курьер
Hinweise	Рекомендации
gif	GIF
Konflikte	конфликты
Getränk	напиток
Tribut	дань
immun	иммунный
Forstwirtschaft	лесоводство
Barrieren	барьеры
kippen	косяк
selten	редко
Angebote	предложения
Barriere	барьер
Fahrrad	велосипед
Einrichtung	обстановка
entstehen	возникать
keltisch	кельтская
Partikel	частица
Feuchtigkeit	влажность
Flaschen	бутылки
dm	дм
Renaissance	Ренессанс
Verordnung	постановление
Fotografen	фотографы
Infektionen	инфекции
Schach	шахматы
arbeitet	работает
Feste	фестивали
Möglichkeiten	возможности
Ente	утка
Kanal	канал
Beitrag	способствуя
Kuh	корова
analytisch	аналитический
Kostüme	костюмы
streng	строгий
Verkehr	циркуляция
Delikt	преступление
Annahme	предположение
Hobby	хобби
Versuche	пытается
Erfindung	изобретение
Techniker	техник
Führungskräfte	руководство
Anfragen	запросы
kognitiv	познавательный
erforschen	исследование
Trick	трюк
Anfrage	запрос
Schließung	закрытие
Bauholz	лесоматериалы
Volt	вольт
heftig	интенсивный
Unterstützer	сторонников
Satzung	статуты
eingeschrieben	зачислен
Sensoren	датчиков
Schraube	винт
Minister	министры
öffentlich	публично
litt	пострадали
Aufnahme	потребление
Schmetterling	бабочка
Mechanik	механика
Header	заголовки
Fehler	ошибки
numerisch	численный
definieren	определяющий
Zählen	подсчет
Betrachtung	отражение
Einladung	приглашение
Natrium	натрий
Hormon	гормон
Kinder	детская
Backstein	кирпич
Griff	рукоятка
mittelalterlich	средневековый
Porzellan	фарфор
gefangen	захваченный
anständig	порядочный
Guss	Кастинг
übersetzt	переведенный
Donna	Донна
Krieger	воин
Kabine	кабина
Scannen	сканирование
Polo	поло
Kopieren	копирование
Horn	рог
Journalismus	журналистика
Frosch	лягушка
Grammatik	грамматика
Absicht	намерение
Reifen	шины
unternommen	проведены
Gefahr	опасность
Folgen	эпизоды
kreisförmig	круговой
Zorn	гнев
Abbildungen	иллюстрации
Chancen	шансы
Glück	счастье
bizarr	эксцентричный
ur	ур
Früchte	фрукты
Kennzeichnung	идентификатор
Band	лента
Berechnungen	вычисления
jpeg	JPEG
Anfang	запускать
praktisch	удобный
Wechsel	замена
befreit	освобожденный
Pflanzen	культуры
reduziert	уменьшает
durchgeführt	осуществляется
Geometrie	геометрия
Eindruck	впечатление
Gilde	гильдия
Korrelation	корреляция
sim	сим
nervös	нервное
Duft	аромат
Replik	копия
Stamm	племя
Trades	сделки
hervorragend	превосходный
loswerden	избавиться
Dreieinigkeit	Троица
abgewickelt	обрабатываются
Legenden	легенды
Boom	бум
Ruhe	спокойный
Meister	чемпионы
Etagen	этажей
Auswahlen	выборы
Vergleichen	Сравнение
spricht	говорит
beruflich	профессиональное
Apotheken	аптеки
ln	пер
Rolle	ролик
Stapel	партия
organisieren	организовать
geschätzt	оценили
ändern	изменять
Kanten	края
Vermischung	смешивание
Griffe	ручки
Harmonie	гармония
vornehm	выдающийся
Asthma	астма
Annahmen	допущения
geregelt	регулируется
Dreieck	треугольник
ändern	изменить
erwartet	ожидаемый
orientalisch	восточный
Belohnung	награда
Wasserstoff	водород
vergleichbar	сравнимый
befürworten	адвокат
Verwechslung	путаница
Eingänge	входные
Garantien	гарантии
Genom	геном
Medaille	медаль
Trainer	тренеры
Schiffe	суд
Hafen	гавань
Öko	эко
verletzlich	уязвимый
ordnen	организовать
künstlerisch	художественный
Ehrungen	почести
reflektiert	отраженный
einheitlich	унифицированный
Rasse	разводить
Detektor	детектор
ignoriert	игнорируются
präzise	точный
Auswertung	оценки
Lippe	губа
versammeln	собирать
Bildung	формирование
Journalisten	журналисты
leicht	незначительный
indirekt	косвенный
unter	среди
Stiftungen	устои
Horizont	горизонт
nu	ню
tief	глубоко
Verbindlichkeiten	обязательства
Preise	призы
verringert	снизилась
beschreiben	описывающее
Optik	оптика
verfolgen	преследовать
Blitz	молния
ou	ОУ
Zitate	цитаты
Inspektor	инспектор
Schlange	змея
Erinnerung	напоминание
gesucht	поиск
Flachland	равнины
Einblicke	понимание
Fähigkeiten	способности
initiiert	начатый
Karaoke	караоке
Falle	ловушка
einsam	Одинокий
ve	ве
beobachten	наблюдать
Behälter	контейнеры
Einstellungen	отношения
Beere	ягода
Halsband	воротник
integrieren	интегрировать
Soziologie	социология
Exponate	экспонаты
stirbt	умирает
Terrasse	терраса
Bakterien	бактерии
sollen	должен
köstlich	вкусно
Traditionen	традиции
endlich	конечный
sendet	посылает
dauerhaft	прочный
verbündet	союзный
Feuchtigkeit	влажность
verwandeln	преобразование
Timer	таймер
Tablets	таблетки
bekommen	полученный
Erzieher	воспитатели
Gemüse	овощной
Vers	стих
unabhängig	независимо
Konkurrenz	конкуренты
Rakete	ракета
Ja	да
Kugel	пуля
Türme	башни
Sichtweite	видимость
Breite	широта
Bewusstsein	сознание
Tumor	опухоль
hässlich	уродливый
Einlagen	депозиты
Herrin	госпожа
Begegnung	столкновение
Watt	Вт
vierzig	сорок
Röhren	трубы
versucht	попытка
Priester	священник
Analysten	аналитики
Hammer	молоток
Invasion	вторжение
Läufer	бегун
Reihen	строки
verabreicht	вводить
Begriff	понятие
Rechtschreibung	написание
Arktis	Арктический
Belohnt	награды
unter	под
stärken	укреплять
verteidigen	защищать
infrarot	инфракрасный
siebte	седьмой
Bauch	живот
aggressiv	агрессивный
Anzeigen	объявления
Quartier	помещение
gestohlen	похищенный
bestimmt	определяет
Skulptur	скульптура
Poly	поли
Ohren	уши
Faust	кулак
Neo	нео
Motivation	мотивация
Passagiere	пассажиров
konsequent	последовательно
Überschuss	избыток
graben	копать
Taxi	такси
Anerkennung	признательность
om	ом
Beschränkung	ограничение
Gitarren	гитары
Wesen	сущность
mächtig	могущественный
Menschheit	человечество
Transkription	транскрипция
Komplikationen	осложнения
Wissenschaftler	ученые
Galaxis	галактика
Pflege	заботливая
Testament	завещание
Dominant	доминирующий
Bauch	желудок
teilweise	частично
minimieren	минимизировать
Reihen	ряды
Debüt	дебют
Generationen	поколения
Turniere	турниры
verweigern	Отрицать
Anatomie	анатомия
Kopfhörer	наушники
Fraktion	доля
Trio	трио
Vorgehen	судопроизводство
Würfel	куб
Defekte	дефекты
Unsicherheit	неопределенность
Nervenzusammenbruch	сломать
geregelt	решен
Impfstoff	вакцина
Schicksal	судьба
Buchungen	бронирование
Republikaner	республиканцы
Dschungel	джунгли
Zen	Дзэн
dis	дис
Prognose	прогнозирование
ökologisch	экологический
Oval	овальный
impliziert	подразумевает
ser	сер
Bewertung	оценка
Aussicht	перспектива
geographisch	географический
Spender	донор
Spannung	напряженность
Müll	мусор
Formen	формы
Stufe	ярус
Graf	граф
Heimat	Родина
Meisterschaft	чемпионаты
Rassen	породы
Disko	дискотека
aus	AUS
Veredelung	отделка
Emotionen	эмоции
ewig	вечный
Drehung	вращение
nam	Нама
produktiv	продуктивный
Boulevard	бульвар
Schwein	свинья
metrisch	метрический
Strafen	штрафы
abwechslungsreicher	разнообразный
grande	Гранди
Darstellerin	актриса
zuordnen	назначать
unterbringen	вмещать
Tiger	тигры
Dörfer	деревни
Schatten	тень
Chor	хор
Rhythmus	ритм
Ziffer	цифра
Symphonie	симфония
plötzlich	внезапно
Annehmen	принимающий
Schwimmbäder	бассейны
lyrisch	лирический
Isolierung	изоляция
Geschwindigkeiten	скорость
nachhaltig	устойчивый
abgestimmt	соответствие
ungefähr	приближенный
Seil	веревка
rational	рациональный
Programmierer	программист
Kämpfer	боевики
vererbt	унаследованный
unvollständig	неполный
Gesang	вокал
Brunnen	фонтан
legitim	законный
Biographien	биографии
Ermittler	следователь
Kläger	истец
sanft	нежный
würdig	достойный
Architekten	архитекторы
Heilige	святые
Unternehmer	предприниматель
trägt	осуществляет
Duo	дуэт
überhöht	чрезмерное
spart	экономит
angesehen	рассматривать
Bewertung	оценка
unerwartet	неожиданный
Nebel	туман
charakteristisch	характеристика
Empfangshalle	лобби
skizzierte	изложены
enorm	огромный
Karma	карма
bestehen	состоять
Königinnen	Квинс
Wissenschaftler	ученые
Stämme	племена
Unterscheidung	различие
Gefahren	опасность
Befreiung	освобождение
Mieter	арендатор
Nachhaltigkeit	устойчивость
Tätowierung	тату
Algebra	алгебра
Schatten	тени
dumm	глупый
frei	свободно
mild	мягкий
Pelz	мех
leicht	легко
Zugehörigkeit	присоединение
Zaun	забор
unendlich	бесконечный
Clan	клан
Revolutionär	революционер
Armbänder	браслеты
Abhilfe	средство
Atmung	дыхание
kurz	кратко
Dicke	толщина
grafische	графический
Genius	гениальность
Diskussion	обсуждение
Kämpfer	истребитель
sinnvoll	значимым
adaptiert	адаптированный
Ländereien	усадеб
Teppich	коврик
Demokrat	демократ
Bezirk	район
hält	поддерживает
ka	ка
beibehalten	сохраняется
Marmor	мрамор
DM	дем
Meditation	медитация
Mikrofon	микрофон
Vereinigung	объединение
Riesen	гиганты
organisieren	организация
Memo	меморандум
Schinken	ветчина
gelöst	решена
Tide	волна
Trennwand	раздел
unsichtbar	невидимый
Konsolen	консоли
Magnet	магнит
Übersetzungen	переводы
Jaguar	ягуар
Ware	товар
Kilometer	километров
Garantien	гарантии
gotisch	готика
Zylinder	цилиндр
Hexe	ведьма
Bock	доллар
Feinde	враги
Beratung	консультирование
genießen	наслаждаясь
patrouillieren	патруль
Geruch	запах
Karneval	карнавал
grob	грубо
Aufkleber	наклейка
Versprechen	обещания
Riff	риф
Teilen	делить
aufeinanderfolgenden	последовательный
bon	бон
Vorstellungen	представления
chan	чан
Melodien	мелодии
mas	Рождество
Sätze	фразы
kai	кай
Halbinsel	полуостров
langweilig	скучный
dom	дом
Reden	речи
erreicht	достигает
Schema	схема
Kataloge	каталоги
Ministerien	министерства
parlamentarisch	парламентский
Präfix	префикс
Savanne	саванна
Fass	бочка
Nerv	нерв
dans	данс
Planeten	планеты
Defizit	дефицит
erneuern	возобновлять
gekoppelt	соединенный
Schaltungen	схемы
Textur	текстура
bestätigen	признавать
Zelt	палатка
identifiziert	определяет
Qualifikation	квалификация
Schlösser	замки
Miniatur	миниатюрный
Euro	евро
Piraten	пираты
Antenne	антенна
Falke	ястреб
Folge	следствие
systematisch	систематическая
wahrgenommen	воспринимается
Ursprünge	происхождения
gemietet	наемный
bilden	составить
ui	щ
Gewichte	веса
geologisch	геологический
dauerhaft	прочный
böse	злой
einleitet	вводит
geschoben	толкнул
ro	ро
Steigung	скат
Dichter	поэт
Verschwörung	заговор
Theologie	теология
Nägel	ногти
offensichtlich	очевидный
Fahrten	аттракционы
Epos	эпический
Veranstalter	организатор
Allergie	аллергия
Sake	ради
Kombinationen	комбинации
vorangestellt	предшествующий
verdienen	заслуга
Enzym	фермент
Flugzeuge	самолеты
Scheiben	диски
Verstärker	усилитель
willkürlich	произвольный
prominent	видный
sans	без
baut	строит
kontaktiert	связаться
Welle	вал
lehnen	опираться
gelegentlich	случайный
Innovationen	инновации
Überprüfung	рассмотрение
Panik	паника
Staatsbürgerschaft	гражданство
Ausrede	оправдание
Reformen	реформы
Zwiebel	лук
Sandwich	сэндвич
Alt	альт
Hierarchie	иерархия
verlassen	заброшенный
Kreise	круги
Beats	биения
fröhlich	веселый
Kult	культ
Strich	тир
passiv	пассивный
geschätzt	ценный
Käfig	клетка
Mut	мужество
Elevation	высота
Runde	круг
Nutzung	использование
Getränke	напитки
Klingeln	пинг
unterhaltsam	развлекательный
Voraussetzung	предпосылка
Grenze	граница
Flüchtlinge	беженцы
Ritter	рыцари
Hypothese	гипотеза
Medikamente	медикаменты
geändert	изменено
Lehre	учение
szenisch	сценический
Erweiterungen	улучшения
Überschneidung	пересечение
Nähen	шитье
Sammler	коллекторы
anerkannt	признанное
Rage	ярость
prix	Приза
Astrologie	астрология
Berater	консультанты
Pavillon	павильон
Taktik	тактика
Zusatz	дополнительный
talentiert	талантливый
Kissen	подушка
Verbreitung	распространение
Provinzen	провинция
stehlen	украсть
Paket	пакет
Vorfall	падение
Ängste	боится
vorhersagen	прогнозировать
Geschmack	аромат
hungrig	голодный
metallisch	металлический
Interferenz	интерференция
Krieger	воины
atmosphärisch	атмосферный
Heiligenschein	гало
Eltern	родительский
verwiesen	ссылка
Streiks	забастовки
Ameise	муравей
Vorschlag	предложение
geeignet	склонный
behandelt	дело
Händler	трейдер
geworfen	выброшены
Kriterium	критерий
Abzeichen	значок
Zivilisation	цивилизация
Heide	вереск
enorm	огромный
führt	выполняет
Reich	область
korrigiert	исправленный
Helm	шлем
angetroffen	встречается
Tsunami	цунами
Gelehrte	ученый
umgeben	окруженный
Geologie	геология
Kreaturen	существа
gelöscht	очищается
erreichen	выполнять
Ecken	углы
Vegetarier	вегетарианец
Hefe	дрожжи
pas	па
sucht	исследовалась
Botschafter	посол
beschichtete	покрытый
Untergang	гибель
Routinen	подпрограммы
Wesen	существа
Vertrauen	опора
Mythos	миф
Bach	ручей
fu	марихуана
Phänomen	явление
Ensemble	ансамбль
versicherte	уверенный
bewusst	сознательный
Akzent	акцент
Ehefrauen	жены
nutzen	использовать
Versprechen	залог
Vampir	вампир
Dock	док
organisiert	организованная
Musiker	музыкант
Begrenzung	ограничения
restauriert	восстановлен
Hinweis	намек
Rüstung	броня
Anmerkung	замечание
Dutzende	множество
variiert	меняется
Argumentation	рассуждения
Wächter	гвардия
Öffnungen	отверстия
Ersetzung	замена
Forscher	Исследователь
Räte	советы
Berufe	профессий
anerkannt	признанный
Schweinefleisch	свинина
zu	цу
Gleichgewicht	равновесие
Rohre	трубы
Hütten	коттеджи
verschmelzen	сливаться
Privileg	привилегия
entwickelt	развивается
Chassis	шасси
Einschätzung	оценка
Scheune	сарай
Frost	мороз
Institute	институты
Schimmel	плесень
Freifrau	дама
Yacht	яхта
bevorzugt	предпочитает
Bohrung	бурение
Kraut	трава
Bruch	нарушение
Wal	кит
Reisende	путешественник
Mittel	ассигнования
vermutlich	подозреваемый
Tomaten	помидоры
Lehrer	инструкторы
Schwung	импульс
Flosse	плавник
Pastor	пастор
Schlamm	грязи
Smaragd	изумруд
wächst	растет
Traktat	тракт
ul	уль
Ballett	балет
Journalist	журналист
Religionen	религии
Knoblauch	чеснок
scheinen	блеск
Explosion	взрыв
Slip	трусы
Unterschriften	подписи
Ozon	озон
Disziplinen	дисциплины
casa	Каса
Gespräche	разговоры
Radios	радио
Tarif	тариф
vereinfachte	упрощенный
Muskeln	мышцы
schnell	быстрый
Vagina	влагалище
Champagner	шампанское
Abweichung	отклонение
Samba	самба
beschäftigen	использовать
Pinguin	пингвин
magisch	волшебный
Einflüsse	влияет
Inspektionen	инспекции
Bewässerung	орошение
Wunder	чудо
hydraulisch	гидравлический
Penetration	проникновение
Wunde	рана
Schöne	красавица
rosa	Роза
Überzeugung	убеждение
faul	ленивый
Qualitäten	качества
Väter	отцы
Lade	зарядка
wichtig	важно
zierlich	маленькая
Gerät	устройство
Terrain	местность
Erläuterung	объясняя
Streifen	полоски
Nominierung	назначение
empirisch	эмпирический
Wurm	червь
Abhängigkeit	зависимость
diskret	дискретный
Anfänger	начинающий
Deckel	крышка
Sexualität	сексуальность
Saphir	сапфир
Privilegien	привилегии
spezialisiert	специализация
Markierung	маркировка
Sheriff	шериф
abgelehnt	отказался
Spion	шпионы
Motorräder	мотоциклы
wählen	избранные
Autobahnen	шоссе
konzentrieren	концентрат
intim	интимный
Moleküle	молекулы
Runde	туры
Kühlschrank	холодильник
Intervalle	интервалы
Sätze	предложения
Holocaust	истребление
Flieger	листовка
Erbsen	горох
Dosierung	дозировка
Unterschied	дисперсия
Navigator	навигатор
Nadel	игла
Bad	баня
Bremsen	тормоза
og	ог
ko	ко
besitzt	владеет
Schicksal	судьба
Landschaften	пейзажи
Berechnung	вычисление
Heu	сено
Heil	спасение
Vorhersagen	прогнозы
Lern	учащихся
Zeichen	знак
Zink	цинк
Opfern	жертва
Sucher	искатели
Guru	гуру
geeignet	подходящий
numerisch	числовой
Anthropologie	антропология
Kaiser	император
grad	град
Gürtel	ремни
Schwarze	негры
gebildet	образованный
stolz	гордо
Notwendigkeit	необходимость
Kurven	кривые
Touren	туризм
Scheitel	вершина
Tomate	помидор
Reisen	путешествия
blass	бледный
Funktion	функционирование
Wirtschaft	экономики
unternehmen	предпринимать
erklären	объявлять
Ventile	клапаны
Lücken	пробелы
Erfolge	достижения
reißen	слеза
lehrt	учит
Null	ноль
Fremder	незнакомец
Nest	гнездо
Gericht	суд
ausgeschlossen	правил
Pensionen	пенсии
Gebete	молитвы
Polizist	полицейский
Jugendliche	подросток
Nominierungen	номинации
Banane	банан
einleitend	вводный
Reservoir	резервуар
Auftreten	вхождение
Idol	идол
blutig	кровавый
erinnern	напоминать
reizend	обаятельный
Zahn	зуб
respektierte	уважаемый
Aufenthalte	остается
Affäre	дело
beschränken	ограничивать
Minen	мины
Porträts	портреты
interpretiert	интерпретированы
Auswertungen	оценки
Beseitigung	устранение
Meter	метры
hypothetisch	гипотетический
Hubschrauber	вертолет
Bleistift	карандаш
Künstler	исполнитель
Provisionen	комиссии
Kugel	сфера
Moos	мох
Verhältnisse	коэффициенты
Eintracht	созвучие
graduierte	закончил
unterstützt	одобрил
überraschend	удивительный
Lanze	копье
Leiter	лестница
Kork	пробка
Senatoren	сенаторы
Blutung	кровотечение
Charakterisierung	характеристика
Wahrscheinlichkeit	вероятность
Bahnen	полосы
Grundlage	основы
Kontamination	загрязнение
Kuppel	купол
segnen	благословить
Verhandlung	Переговоры
Kamm	гребень
Gegner	соперники
Triumph	триумф
nominiert	номинирована
Schweißen	сварка
Orgasmus	оргазм
Legierung	сплав
Stellplätze	участки
sanft	осторожно
Sperrung	блокировка
umstritten	спорный
Unentschieden	рисует
Kühlschrank	холодильник
Klingen	лезвия
Schlaufen	петли
Schwall	волна
Trauma	травма
Inserat	объявление
Defensive	оборонительный
verboten	запрещено
Vanille	ваниль
Programmierer	программисты
überwacht	контролируемый
Installationen	сооружения
Seelen	души
motiviert	мотивировано
Dumm	тупой
hohl	полый
Gewölbe	свод
Rille	паз
Offenbarung	откровение
Verfolgung	преследование
Delegation	делегация
Drähte	провода
Wörterbücher	словари
Transparenz	прозрачность
Orbit	орбита
Währungen	валюты
Niger	Нигер
Positionierung	позиционирование
Kolonie	колония
Kanone	пушка
Zirkus	цирк
gefördert	способствовало
Forelle	форель
Leistung	подвиг
vorübergehend	временно
gekocht	приготовленный
übertragen	передавать
Frequenzen	частоты
Reflexionen	размышления
Hunger	голод
Gemeinde	муниципалитет
Detektiv	детектив
Zement	цемент
erleben	испытывают
Kamin	камин
Billigung	поддержка
Textilien	текстиль
Rakete	ракета
Psychiatrie	психиатрия
Assists	помогает
Rechnungsprüfer	аудитор
Geige	скрипка
Prophet	пророк
Oxid	окись
ausgezeichnet	великолепный
sofort	быстро
Anpassung	приспособление
schädlich	вредный
sexuell	сексуально
Gehege	ограда
Glucose	глюкоза
Norm	норма
Wiedergabe	воспроизведение
Schildkröte	черепаха
Entfernungen	расстояния
Absorption	поглощение
Schätze	сокровища
Fossil	ископаемое
schlecht	плохо
Kommunist	коммунист
Unternehmer	предприниматели
Roboter	роботы
Foul	фол
Biodiversität	биоразнообразия
Aufregung	волнение
verbal	словесный
Meere	моря
mysteriös	загадочный
Neuheit	новинка
Fliesen	плитка
Bibliothekar	библиотекарь
schaltet	переключился
ru	RU
Pose	поза
Gramm	граммов
Therapeut	Терапевт
Budget	бюджеты
Ziege	козел
machen	оказывать
Segel	паруса
Kommissare	комиссары
dicht	плотный
mutig	Храбрый
Spedition	пересылка
furchtbar	ужасный
Flugzeug	самолет
Organismen	микроорганизмы
Fernrohr	телескоп
Asbest	асбест
Förderung	продвижение
Weide	ива
Bewerbungen	резюме
existierte	существовавший
Generatoren	генераторы
erzeugt	генерирует
Kartoffeln	картофель
gründlich	тщательный
Rezeptoren	рецепторы
Optimum	оптимальный
Kreatur	существо
einsam	одинокий
subtil	тонкий
Streifen	полосы
Firmware	прошивка
Schäfer	пасти
Wiege	колыбель
Kanzler	канцлер
Mehl	мука
Kontroverse	полемика
legendär	легендарный
Chor	хор
Vermeidung	избегая
schön	красиво
erwartet	надеется
Springen	прыжки
Stoffe	ткань
Polymer	полимер
Hygiene	гигиена
Tugend	добродетель
Chirurgen	хирурги
Mandat	мандат
Korpus	тело
Terminologie	терминология
Gentleman	джентльмен
verurteilt	осужденный
Jet	струи
Indizes	индексы
qui	Квай
bedrohlich	угрожающий
Aktivisten	активисты
Häftling	заключенный
ermutigt	призывает
gebaut	собранный
Terminals	терминалы
roh	сырой
Untersucht	осматривает
Wikinger	викинг
Aufräumen	уборка
bedingt	условный
angegriffen	атакован
kommt	прибывает
Übersetzer	переводчик
Automobil	автомобили
Traktor	трактор
Kontinent	континент
Tarife	тарифы
Längengrad	долгота
hoffte	надеялся
Einfügung	вставка
Zwang	ограничение
Stärkung	укрепление
wünschen	желающих
Isolierung	изоляция
Verletzung	нарушение
gebogen	изогнутый
subjektiv	субъективный
Monster	монстры
Asyl	убежище
Anteil	доля
Cocktail	коктейль
Sorten	сорта
Gift	яд
dominiert	доминировал
teuer	дорогостоящий
Derivate	производные
verhindert	предотвращает
Gewehr	винтовка
Rassismus	расизм
interpretieren	интерпретировать
Übereinstimmung	согласие
bescheiden	скромный
Spieler	геймеров
Sortierung	сортировка
Liaison	связь
Glühbirnen	луковицы
Touristen	туристы
Verhaltensweisen	поведения
klären	прояснить
Taille	Талия
zugeschrieben	приписаны
Eule	сова
Kristalle	кристаллы
überschreitet	превышает
komplementär	дополнительный
Kämpfe	сражения
bitter	горький
Memorandum	меморандум
Drachen	драконы
Lärm	шум
unglaublich	невероятно
Delegierte	делегаты
psychiatrisch	психиатрический
Jugendliche	подростков
Hof	двор
Präsidenten	президенты
abfahren	отходить
ausdrücklich	специально
Lilie	Лили
Aufsicht	надзор
Harz	смола
Alliierte	союзники
konserviert	сохраняется
gekreuzt	пересекла
aufsteigend	Восходящий
nominal	номинальный
zerfallen	распад
Quarz	кварц
Register	регистры
achte	восьмой
autorisiert	уполномоченный
verbessert	улучшает
Befürworter	адвокаты
Phänomene	явления
Neigung	наклон
Granit	гранит
Volk	массы
Athlet	спортсмен
Franc	франк
Ähnlichkeit	сходство
Leck	утечка
Berater	консультант
Broschüre	буклет
erwartet	ожидая
Umsatz	оборот
Urin	моча
Handtuch	полотенце
Ingwer	имбирь
Chromosom	хромосома
als	ALS
Fliegen	летит
Kompetenz	компетентность
Weinen	плач
Amateure	любители
Kran	кран
Untersuchung	расследование
faul	гнилой
Gewohnheit	привычка
Ehre	честь
schützt	защищает
Iris	Ирис
verwaltet	управляет
Erosion	эрозия
Zimmermann	столяр
Khan	хан
unzureichend	недостаточное
Formulierung	формулировка
klug	умная
Herren	лорды
angenehm	приятный
Halbmond	полумесяц
sechzig	шестьдесят
konzentriert	концентрированный
unterscheiden	выделить
ei	й
Projektionen	прогнозы
Funke	искра
Sicherung	обеспечение
Weg	путь
Detektoren	детекторы
Spitze	колос
Zutat	ингредиент
Vorhang	занавес
offenbart	раскрытый
taktisch	тактический
Piloten	пилоты
Expedition	экспедиция
operativ	оперативный
Humor	юмор
mol	моль
Impressum	отпечаток
Unterstützung	содействие
Defekt	дефект
schlecht	плохо
Göttin	богиня
Beobachter	наблюдателей
Magneten	магниты
Formeln	формулы
geräumig	просторный
argumentiert	утверждает
Böden	почвы
Organe	органы
det	йе
Loyalität	лояльность
treu	верный
Delikt	преступление
Lithium	литий
Sprung	прыжок
Gründung	учредительный
Schwan	лебедь
Pflanzung	насаждение
Bündnis	завет
Archäologie	археология
Matrose	матрос
Sorgen	заботы
Heiligtum	святилище
Statue	статуя
Zitat	цитата
Majors	майоров
Manipulation	манипуляция
Glocken	колокольчики
Toxizität	токсичность
Sender	передатчик
Nachbarschaften	окрестности
Trophäe	трофей
Emotion	эмоция
Sehenswürdigkeiten	Достопримечательности
Uniformen	униформа
verwundet	раненый
Derivat	производное
Belegung	размещение
Dosen	дозы
erziehen	воспитывать
Vorurteil	предубеждение
Techniker	техники
wahrscheinlich	вероятный
Ausgabe	выдача
Dekoration	украшение
Angehörige	граждане
Trojaner	троянский
Assistenten	ассистенты
Berater	консультант
erlassen	принятый
instabil	неустойчивый
gedrängt	настоятельно
reflektierenden	отражающий
Gewinnung	получение
endgültig	окончательный
gereist	путешествовал
anpassen	адаптироваться
Beitritt	присоединение
Regler	регулятор
Brennstoffe	топливо
Soja	соя
ordentlich	аккуратный
Benennung	именование
Stern	кормовой
gearbeitete	проработаны
Dummkopf	идиот
besteht	состоит
Aliens	инопланетяне
Änderungen	правки
Rabe	вороной
Wohnung	жилье
symbolisch	символический
Winkel	углы
Drücke	давление
Venus	Венера
Flammen	огонь
Primitive	примитивный
Strumpf	чулок
Ökosystem	экосистема
Hallen	залы
Einfachheit	простота
Dämon	демон
begrüßt	приветствовал
Notation	обозначение
Tante	тетка
Krähe	ворона
semantisch	семантический
abgesetzt	прекращено
entscheidet	решает
Globalisierung	глобализация
Esel	ослы
Kompass	компас
gewachsen	эволюционировали
Infanterie	пехота
berühmt	прославленный
Gang	коридор
philosophisch	философский
Rechtfertigung	обоснование
unbesetzt	вакантный
Festsetzung	фиксация
Gramm	грамм
versteckt	прячется
Farbstoff	краситель
Alphabet	алфавит
gereinigt	очищенный
geehrt	заслуженный
optisch	оптический
Telefone	телефоны
Tagebücher	дневников
Trauer	горе
Schweiß	пот
Delphin	дельфин
Wunder	чудеса
Belüftung	вентиляция
Masken	маски
Büste	бюст
Gasse	аллея
Bahnen	путей
Telegraph	телеграф
Monument	памятник
formal	формально
Tau	роса
zurückgezogen	отозваны
Debatten	дебаты
Identitäten	тождества
Mangel	дефицит
Sattel	седло
Malaria	малярия
treu	верный
Tendenz	тенденция
verwendet	используется
ein	Эйн
Fernglas	бинокль
einleiten	инициировать
rein	чисто
lebendig	яркий
Behauptungen	утверждения
entspricht	соответствует
Daemon	демон
gefeiert	знаменитый
Jäger	охотники
handelten	действовал
Koeffizient	коэффициент
Schädel	череп
Fortsetzung	продолжение
Diener	служащий
Falke	сокол
gemeinsam	совместно
vermieden	избегать
Erklärungen	объяснения
erneuert	обновленный
Kritiker	критик
Sediment	отстой
Quadrate	квадраты
Lieferwagen	фургоны
Kegel	конус
überlebt	переживший
Häufigkeit	распространенность
Fragment	фрагмент
verpflichtet	совершает
Kobra	кобра
warf	бросил
hoc	специальная
Darsteller	исполнители
Dessert	Десерт
Dissertation	диссертация
neunte	девятый
Begeisterung	энтузиазм
Feierlichkeiten	празднования
Gouverneure	губернаторы
Atome	атомы
Gewebe	тканей
Rampe	скат
schön	мило
della	делла
Vorherrschaft	доминирование
Akkorde	аккорды
Beeinträchtigung	нарушение
Molekül	молекула
