of	de
to	à
in	dans
for	pour
is	est
on	sur
that	cette
by	par
this	ce
with	avec
i	je
you	toi
it	il
or	ou
be	être
are	sont
at	à
all	tout
have	avoir
new	Nouveau
we	nous
will	volonté
home	maison
us	nous
about	sur
if	si
page	page
my	mon
has	a
search	chercher
free	gratuit
but	mais
our	notre
one	un
other	autre
do	faire
information	information
time	temps
he	il
which	lequel
their	leur
news	nouvelles
use	utilisation
there	Là
see	voir
so	alors
who	qui
web	toile
also	aussi
get	obtenir
pm	pm
view	vue
c	c
e	e
first	premier
been	été
would	aurait
were	étaient
s	s
like	comme
x	X
than	que
find	trouver
price	prix
back	arrière
top	Haut
people	gens
had	avait
list	liste
name	prénom
just	juste
year	an
day	journée
into	dans
two	deux
health	santé
n	n
re	ré
used	utilisé
go	aller
b	b
last	dernier
make	faire
them	leur
should	devrait
product	produit
system	système
post	poster
her	sa
city	ville
t	t
policy	politique
number	nombre
support	soutien
message	message
after	après
then	puis
jan	jan
good	bien
d	ré
where	où
info	Info
rights	droits
books	livres
high	haute
school	école
m	m
each	chaque
links	liens
she	elle
years	années
order	commande
very	très
book	livre
items	articles
company	compagnie
r	r
read	lis
group	groupe
sex	sexe
many	beaucoup
user	utilisateur
de	de
set	ensemble
general	général
research	recherche
university	Université
january	janvier
mail	courrier
full	plein
reviews	avis
program	programme
know	connaître
games	Jeux
way	façon
days	journées
p	p
part	partie
could	pourrait
great	génial
united	uni
real	réal
f	F
international	international
center	centre
travel	Voyage
comments	commentaires
made	fabriqué
development	développement
report	rapport
member	membre
details	détails
line	ligne
terms	termes
before	avant
hotels	hôtels
did	fait
send	envoyer
right	droite
type	type
local	local
those	ceux
results	résultats
office	Bureau
national	nationale
car	voiture
design	conception
take	prendre
posted	posté
address	adresse
community	communauté
within	dans
states	États
want	vouloir
phone	téléphone
dvd	DVD
subject	assujettir
between	entre
forum	forum
family	famille
l	l
long	longue
w	w
show	montrer
o	o
even	même
black	noir
special	spécial
index	indice
being	étant
women	femmes
much	beaucoup
sign	signe
file	fichier
link	lien
open	ouvrir
south	Sud
case	Cas
project	projet
pages	pages
version	version
section	section
own	posséder
house	maison
security	Sécurité
g	g
county	comté
american	américain
photo	photo
game	Jeu
members	membres
power	Puissance
network	réseau
computer	ordinateur
systems	systèmes
three	Trois
place	endroit
end	fin
h	h
him	lui
per	par
access	accès
think	pense
north	Nord
resources	Ressources
current	actuel
big	gros
media	médias
law	loi
control	contrôle
water	eau
history	histoire
size	Taille
personal	personnel
guide	guider
shop	boutique
directory	annuaire
change	changement
white	blanc
text	texte
small	petit
rating	évaluation
rate	taux
government	gouvernement
children	enfants
return	revenir
students	élèves
v	v
account	Compte
times	fois
level	niveau
digital	numérique
profile	profil
previous	précédent
form	forme
events	événements
love	amour
old	vieux
john	John
main	principale
call	appel
image	image
department	département
title	Titre
non	non
k	k
y	y
insurance	Assurance
shall	doit
property	propriété
class	classe
cd	CD
quality	qualité
every	chaque
listing	inscription
content	contenu
country	pays
little	peu
tools	outils
low	faible
reply	répondre
customer	client
december	décembre
compare	comparer
movies	films
college	Université
value	valeur
article	article
man	homme
jobs	emplois
j	j
food	aliments
author	auteur
different	différent
u	u
learn	apprendre
sale	vente
print	impression
course	cours
job	emploi
room	chambre
stock	Stock
training	entraînement
too	aussi
credit	crédit
point	point
science	science
men	Hommes
categories	catégories
west	Ouest
look	Regardez
english	Anglais
team	équipe
estate	biens
box	boîte
conditions	conditions
photos	Photos
gay	gai
thread	fil
category	Catégorie
note	Remarque
live	vivre
large	grand
gallery	Galerie
table	table
however	toutefois
june	juin
october	octobre
november	novembre
market	marché
library	bibliothèque
action	action
start	début
series	séries
features	fonctionnalités
air	air
industry	industrie
plan	plan
human	Humain
yes	Oui
second	seconde
hot	chaud
cost	Coût
movie	film
forums	forums
march	Mars
la	la
september	septembre
say	dire
going	Aller
medical	médical
friend	ami
dec	déc
server	serveur
application	application
staff	Personnel
play	jouer
issues	problèmes
april	avril
users	utilisateurs
street	rue
topic	sujet
against	contre
got	eu
blog	Blog
party	fête
payment	Paiement
equipment	équipement
let	laisser
programs	programmes
legal	légal
recent	récent
park	parc
act	acte
problem	problème
red	rouge
give	donner
memory	Mémoire
performance	performance
social	social
q	q
story	récit
sell	vendre
options	Options
experience	expérience
key	clé
body	corps
young	Jeune
important	important
field	champ
few	peu
east	est
single	unique
ii	ii
age	âge
club	club
example	Exemple
girls	filles
z	z
road	route
gift	cadeau
question	question
ca	Californie
hard	difficile
pay	Payer
four	quatre
poker	poker
issue	problème
range	gamme
building	bâtiment
seller	vendeur
court	tribunal
february	février
result	résultat
light	lumière
write	écrire
war	guerre
offer	offre
blue	bleu
groups	groupes
al	Al
easy	facile
given	donné
request	demande
fax	fax
china	Chine
making	fabrication
picture	image
needs	Besoins
possible	possible
month	mois
major	Majeur
star	étoile
future	avenir
space	espace
committee	Comité
hand	main
sun	Soleil
cards	cartes
london	Londres
meeting	réunion
become	devenir
child	enfant
keep	garder
porn	porno
share	partager
similar	similaire
garden	jardin
schools	écoles
million	million
added	ajoutée
reference	référence
companies	entreprises
baby	bébé
learning	apprentissage
energy	énergie
run	courir
delivery	livraison
popular	populaire
term	terme
film	film
stories	histoires
put	mettre
journal	journal
reports	rapports
co	co
try	essayer
images	images
notice	remarquer
god	Dieu
original	original
head	tête
radio	radio
cell	cellule
council	conseil
includes	comprend
track	Piste
discussion	discussion
archive	archiver
others	autres
agreement	accord
format	format
society	société
months	mois
safety	sécurité
friends	copains
sure	sûr
edition	édition
messages	messages
marketing	commercialisation
tell	dire
association	association
provides	fournit
fun	amusement
already	déjà
green	vert
studies	études
close	Fermer
common	commun
specific	spécifique
several	nombreuses
living	vivant
collection	collection
called	appelé
short	court
arts	lettres
lot	lot
ask	demander
limited	limité
solutions	solutions
director	réalisateur
beach	plage
past	passé
natural	Naturel
electronics	électronique
upon	sur
period	période
planning	Planification
says	dit
official	officiel
mar	mar
done	terminé
technical	technique
window	fenêtre
pro	pro
region	Région
island	île
record	record
direct	direct
conference	conférence
records	archives
st	st
district	district
calendar	calendrier
costs	frais
style	style
statement	déclaration
miles	miles
resource	Ressource
applications	applications
document	document
word	mot
works	travaux
material	Matériel
bill	facture
written	écrit
rules	règles
final	final
thing	chose
centre	centre
requirements	exigences
TRUE	VRAI
minutes	minutes
else	autre
mark	marque
rock	Roche
bad	mal
individual	individuel
plus	plus
auto	auto
cover	couverture
edit	modifier
together	ensemble
videos	vidéos
fast	vite
function	fonction
fact	fait
getting	obtention
global	global
tech	technologie
meet	rencontrer
far	loin
economic	économique
en	en
player	joueur
projects	projets
amount	montant
watch	regarder
included	inclus
feel	ressentir
bank	banque
risk	risque
deals	offres
various	divers
words	mots
production	production
commercial	commercial
weight	poids
heart	cœur
treatment	traitement
points	points
knowledge	connaissance
magazine	magazine
error	Erreur
camera	caméra
girl	fille
construction	construction
toys	jouets
registered	inscrit
domain	domaine
methods	méthodes
chapter	chapitre
protection	protection
policies	politiques
wide	large
beauty	beauté
manager	directeur
india	Inde
position	position
taken	pris
sort	Trier
listings	annonces
known	connu
half	moitié
cases	cas
step	étape
engineering	ingénierie
simple	simple
quick	rapide
license	Licence
lake	Lac
whole	entier
annual	annuel
published	publié
church	église
method	méthode
active	actif
response	réponse
figure	figure
materials	matériaux
enough	assez
designed	conçu
among	parmi
death	décès
loss	perte
face	visage
brand	marque
discount	remise
effects	effets
created	créé
standards	normes
bit	bit
political	politique
kingdom	Royaume
base	base
doing	Faire
loans	prêts
shoes	chaussures
entry	entrée
stay	rester
orders	ordres
availability	disponibilité
summary	résumé
turn	tour
growth	croissance
agency	agence
king	Roi
european	européen
activity	activité
copy	copie
western	occidental
force	Obliger
employment	emploi
bay	baie
river	rivière
commission	commission
package	paquet
seen	vu
players	joueurs
engine	moteur
port	Port
album	album
regional	régional
stop	Arrêtez
started	commencé
administration	administration
bar	bar
institute	institut
views	vues
double	double
dog	chien
soon	bientôt
lines	lignes
electronic	électronique
benefits	avantages
needed	nécessaire
printer	imprimante
condition	condition
effective	efficace
believe	croyez
organization	organisation
effect	effet
mind	esprit
selection	sélection
casino	casino
pdf	pdf
tour	tour
cross	traverser
hope	espérer
corporation	société
wish	souhait
solution	Solution
mature	mature
role	rôle
weeks	semaines
certain	certain
lower	inférieur
necessary	nécessaire
union	syndicat
mon	lun
com	com
particular	particulier
fine	bien
hour	heure
gas	gaz
skills	compétences
six	six
bush	buisson
islands	îles
advice	Conseil
career	carrière
decision	décision
leave	laisser
pre	pré
huge	énorme
woman	femme
facilities	installations
bid	offre
middle	milieu
cable	câble
opportunities	Opportunités
taking	prise
values	valeurs
division	division
coming	arrivant
object	objet
lesbian	lesbienne
appropriate	approprié
machine	machine
logo	logo
length	longueur
nice	agréable
score	But
statistics	statistiques
client	client
sample	échantillon
investment	investissement
sent	envoyé
shown	montré
christmas	Noël
culture	Culture
flash	flash
ms	Mme
choice	choix
courses	cours
consumer	consommateur
hi	salut
foreign	étranger
artist	artiste
furniture	meubles
channel	canal
letter	lettre
mode	mode
phones	Téléphones
ideas	idées
structure	structure
degree	degré
contract	Contrat
super	super
male	mâle
matter	matière
almost	presque
located	situé
multiple	plusieurs
distribution	Distribution
editor	éditeur
inn	auberge
industrial	industriel
potential	potentiel
song	chanson
los	los
fall	tomber
idea	idée
rooms	pièces
communications	communications
win	gagner
primary	primaire
cancer	cancer
numbers	Nombres
reason	raison
tool	outil
spring	printemps
foundation	fondation
answer	répondre
voice	voix
schedule	programme
documents	documents
purpose	objectif
feature	fonctionnalité
bed	lit
comes	vient
police	police
independent	indépendant
approach	approche
brown	marron
physical	physique
hill	colline
maps	Plans
hold	tenir
ratings	évaluations
happy	content
smith	forgeron
developed	développé
thank	remercier
safe	sûr
unique	unique
survey	enquête
prior	avant
telephone	Téléphone
sport	sport
ready	prêt
animal	animal
sources	sources
population	population
pa	Pennsylvanie
regular	ordinaire
secure	garantir
operations	opérations
simply	simplement
evidence	preuve
station	gare
understand	comprendre
option	option
valley	vallée
probably	Probablement
sea	mer
publications	publications
improve	améliorer
connection	connexion
publisher	éditeur
hall	salle
anti	anti
networks	réseaux
earth	Terre
parents	Parents
impact	impact
transfer	transfert
introduction	introduction
kitchen	cuisine
strong	fort
wedding	mariage
properties	Propriétés
hospital	hôpital
ground	sol
ship	navire
accommodation	hébergement
disease	maladie
excellent	excellent
perfect	parfait
hair	cheveux
opportunity	opportunité
kit	trousse
classic	classique
basis	base
command	commander
cities	villes
express	Express
award	prix
distance	distance
tree	arbre
assessment	évaluation
wall	mur
involved	impliqué
el	el
extra	supplémentaire
especially	notamment
budget	budget
guides	guides
success	Succès
maximum	maximum
ma	mère
operation	opération
existing	existant
quite	assez
selected	choisi
boy	garçon
restaurants	Restaurants
beautiful	beau
warning	Attention
locations	Emplacements
horse	cheval
vote	vote
flowers	fleurs
stars	étoiles
lists	listes
owner	propriétaire
animals	animaux
ways	façons
son	fils
providing	fournir
rule	règle
housing	logement
takes	prend
bring	apporter
catalog	catalogue
max	max
mother	mère
authority	autorité
told	Raconté
programme	programme
joined	relié
input	contribution
strategy	stratégie
feet	pieds
agent	agent
valid	valide
modern	moderne
senior	Sénior
sexy	sexy
teaching	enseignement
door	porte
grand	grandiose
trial	procès
units	unités
cool	cool
normal	Ordinaire
enterprise	entreprise
ships	navires
entire	tout
positive	positif
fitness	aptitude
chinese	chinois
opinion	opinion
football	Football
abstract	abstrait
output	sortie
funds	fonds
mr	M
likely	probable
develop	développer
artists	artistes
alternative	alternative
responsibility	responsabilité
java	Java
guest	client
publication	publication
pass	passer
relations	rapports
trust	confiance
van	van
contains	contient
multi	multi
republic	république
fees	honoraires
components	Composants
vacation	vacances
century	siècle
academic	académique
assistance	assistance
completed	terminé
skin	peau
graphics	graphique
indian	Indien
ring	bague
grade	qualité
mountain	Montagne
organizations	organisations
filter	filtre
panel	panneau
floor	sol
buying	achat
match	rencontre
proposed	proposé
require	exiger
boys	garçons
morning	Matin
allows	permet
protein	protéine
plant	plante
reported	signalé
hit	frappé
mm	mm
pool	bassin
mini	mini
politics	politique
partner	partenaire
authors	auteurs
boards	planches
fish	poisson
membership	adhésion
mission	mission
eye	œil
string	chaîne
sense	sens
modified	modifié
released	libéré
stage	étape
internal	interne
born	née
detailed	détaillé
japanese	Japonais
race	course
approved	approuvé
target	cible
except	sauf
character	personnage
maintenance	entretien
ability	aptitude
ed	ed
rape	râpé
battery	batterie
youth	jeunesse
pressure	pression
submitted	soumis
debt	dette
medium	moyen
television	télévision
interested	intéressé
core	coeur
break	Pause
purposes	fins
sets	ensembles
dance	Danse
wood	bois
defined	défini
papers	papiers
awards	prix
fee	frais
studio	studio
reader	lecteur
device	dispositif
established	établi
answers	réponses
rent	location
las	Las
dark	foncé
external	externe
apple	Pomme
le	le
instructions	instructions
min	min
offered	offert
theory	théorie
remove	retirer
aid	aide
visual	visuel
host	hôte
variety	variété
teachers	enseignants
manual	Manuel
block	bloc
subjects	sujets
agents	agents
repair	réparation
fair	juste
steel	acier
understanding	compréhension
songs	Chansons
fixed	fixé
wrong	faux
beginning	début
hands	mains
az	az
paris	Paris
gets	obtient
sector	secteur
capacity	capacité
un	ONU
fat	graisse
father	père
electric	électrique
saw	vu
instruments	instruments
officer	officier
driver	chauffeur
businesses	entreprises
dead	mort
unknown	inconnu
restaurant	restaurant
mike	Mike
trip	voyage
mi	mi
poor	pauvre
relationship	relation
workers	ouvriers
peace	paix
traditional	traditionnel
showing	projection
creative	Créatif
coast	côte
benefit	avantage
funding	financement
devices	dispositifs
lord	Seigneur
grant	subvention
sub	sous
fiction	fiction
watches	montres
careers	carrières
goes	va
led	LED
museum	musée
fan	ventilateur
transport	transport
interesting	intéressant
blogs	blogs
evaluation	évaluation
former	ancien
zone	zone
complex	complexe
th	e
cat	chat
die	mourir
presented	présenté
flat	appartement
flow	couler
agencies	agences
literature	Littérature
parent	parent
setting	réglage
dr	dr
scale	échelle
economy	économie
helpful	utile
monthly	mensuel
critical	critique
frame	Cadre
musical	musical
definition	définition
secretary	secrétaire
path	chemin
chief	chef
gives	donne
packages	paquets
detail	détail
laws	lois
changed	modifié
begin	commencer
royal	Royal
clean	nettoyer
guy	gars
titles	titres
relevant	pertinent
justice	Justice
connect	relier
cup	Coupe
basket	panier
applied	appliqué
weekly	hebdomadaire
vol	vol
installation	installation
pp	pp
attention	attention
advance	avance
skip	sauter
diet	régime
army	armée
gear	équipement
difference	différence
allowed	permis
correct	correct
nation	nation
selling	vente
lots	beaucoup
piece	pièce
sheet	drap
firm	raffermir
seven	Sept
elements	éléments
species	espèce
jump	saut
cells	cellules
module	module
resort	recours
certificate	certificat
minister	ministre
motion	mouvement
fashion	mode
directions	directions
visitors	visiteurs
documentation	Documentation
trading	commerce
forest	forêt
calls	appels
coverage	couverture
couple	couple
giving	donnant
chance	chance
vision	vision
ball	ballon
ending	fin
clients	clients
actions	actes
discuss	discuter
goal	objectif
successful	réussi
sold	vendu
wind	vent
communities	communautés
clinical	clinique
situation	situation
markets	marchés
publishing	édition
appear	apparaître
developing	développement
lives	vies
determine	déterminer
temperature	Température
announcements	annonces
patient	patient
actual	réel
historical	historique
stone	pierre
bob	bob
commerce	Commerce
persons	personnes
difficult	difficile
scientific	scientifique
satellite	Satellite
tests	essais
village	village
accounts	comptes
amateur	amateur
ex	ex
met	rencontré
pain	douleur
factors	facteurs
coffee	café
buyer	acheteur
poster	affiche
edge	bord
functional	fonctionnel
root	racine
fi	Fi
closed	fermé
holidays	vacances
pink	rose
balance	équilibre
monitoring	surveillance
replies	réponses
shot	coup
initial	initiale
label	étiquette
sec	seconde
canon	canon
league	ligue
waste	déchets
minute	minute
bus	autobus
provider	fournisseur
dictionary	dictionnaire
accounting	comptabilité
manufacturing	fabrication
sections	sections
chair	chaise
effort	effort
phase	phase
fantasy	fantaisie
po	po
va	Virginie
professor	professeur
install	installer
shirt	chemise
apparel	vêtements
foot	pied
breast	Sein
techniques	techniques
dollars	dollars
religion	religion
permission	autorisation
wild	sauvage
generation	génération
miss	manquer
chemical	chimique
doctor	docteur
task	tâche
reduce	réduire
brought	apporté
exercise	exercice
bug	punaise
guarantee	garantie
leader	chef
se	se
processes	processus
soft	doux
meetings	réunions
seconds	secondes
flight	vol
congress	congrès
fuel	carburant
walk	marche
produced	produit
saint	Saint
argument	argument
competition	compétition
drugs	drogues
joint	mixte
premium	prime
fresh	Frais
characters	personnages
attorney	avocat
di	di
factor	facteur
thousands	milliers
km	km
stream	courant
apartments	appartements
pick	choisir
hearing	audition
eastern	est
therapy	thérapie
entries	entrées
signed	signé
administrative	administratif
serious	sérieux
limit	limite
steps	pas
shops	magasins
bondage	esclavage
del	del
efforts	efforts
informed	informé
ga	Géorgie
thoughts	pensées
creek	ruisseau
ft	ft
quantity	quantité
essential	essentiel
tours	Tours
load	charge
immediately	immédiatement
machines	Machines
designated	désigné
heavy	lourd
covered	couvert
recovery	récupération
integrated	intégré
configuration	configuration
cock	coq
merchant	marchande
comprehensive	complet
expert	expert
protect	protéger
solid	solide
presentation	présentation
became	devenu
orange	Orange
compliance	conformité
theme	thème
rich	riches
campaign	campagne
vs	contre
guitar	guitare
finding	découverte
examples	exemples
spirit	esprit
ar	ar
claims	réclamations
acceptance	acceptation
strategies	stratégies
mo	mo
affairs	affaires
intended	prévu
sa	sa
goals	buts
hire	louer
election	élection
suggest	suggérer
branch	branche
serve	servir
affiliates	affiliés
mount	monter
latin	Latin
multimedia	multimédia
manage	gérer
corner	coin
rank	rang
element	élément
birth	naissance
virus	virus
interactive	interactif
requests	demandes
separate	séparé
quarter	trimestre
procedure	procédure
leadership	direction
define	définir
religious	religieux
facts	faits
breakfast	déjeuner
column	colonne
faith	Foi
chain	chaîne
identify	identifier
avenue	rue
missing	disparu
recommendations	recommandations
moved	déplacé
reach	atteindre
comparison	Comparaison
moment	moment
extended	élargi
sequence	séquence
inch	pouce
attack	attaque
centers	centres
opening	ouverture
lab	laboratoire
reserve	réserve
gamma	gamma
produce	produire
truth	vérité
counter	compteur
failure	échec
follows	suit
dollar	dollar
camp	camp
des	des
films	films
bridge	pont
fill	remplir
movement	mouvement
printing	impression
draft	Brouillon
chart	graphique
played	joué
contacts	Contacts
readers	lecteurs
clubs	clubs
wa	Washington
adventure	aventure
offering	offre
profit	profit
leaders	dirigeants
posters	affiches
institutions	institutions
assistant	assistant
variable	variable
dj	dj
parking	parking
yesterday	hier
determined	déterminé
workshop	atelier
gone	disparu
codes	codes
kinds	types
extension	extension
statements	déclarations
completely	complètement
teams	équipes
fort	fort
cm	cm
senate	sénat
funny	drôle
gene	gène
turned	tourné
disc	disque
pattern	modèle
boat	bateau
theatre	théâtre
manufacturers	fabricants
sponsor	parrainer
classical	classique
icon	icône
warranty	garantie
dedicated	dévoué
direction	direction
basketball	basketball
objects	objets
delete	effacer
evening	soir
assembly	Assemblée
nuclear	nucléaire
mouse	Souris
signal	signal
criminal	criminel
issued	Publié
powerful	puissant
dream	rêver
FALSE	FAUX
da	da
cast	jeter
flower	fleur
personnel	personnel
passed	passé
supplied	fourni
falls	chutes
soul	âme
promote	promouvoir
stated	déclaré
stats	Statistiques
professionals	professionnels
appears	apparaît
carry	porter
flag	drapeau
covers	couvertures
em	em
advantage	avantage
hello	Bonjour
designs	dessins
maintain	maintenir
tourism	tourisme
priority	priorité
adults	adultes
graphic	graphique
atom	atome
payments	Paiements
binding	contraignant
brief	bref
ended	terminé
winning	gagnant
anonymous	anonyme
script	scénario
served	servi
wants	veut
prepared	préparé
void	vide
tag	marque
interview	entretien
mix	mélanger
framework	cadre
disk	disque
installed	installée
queen	reine
credits	crédits
clearly	clairement
fix	réparer
handle	manipuler
sweet	doux
criteria	Critères
associate	associer
ne	ne
behavior	comportement
enlarge	agrandir
ray	rayon
revenue	revenu
measure	mesure
votes	votes
du	du
duty	devoir
discussions	discussions
bear	ours
gain	Gain
festival	Festival
laboratory	laboratoire
ocean	océan
flights	vols
experts	experts
signs	signes
depth	profondeur
train	train
dry	sec
explore	explorer
spa	spa
concept	concept
nearly	presque
handling	manipulation
origin	origine
billion	milliard
intelligence	intelligence
bought	acheté
con	escroquerie
nations	nations
route	route
broken	cassé
battle	bataille
speak	parler
protocol	protocole
query	question
partnership	Partenariat
expression	expression
es	es
speech	discours
wire	câble
suggestions	suggestions
replacement	remplacement
tape	ruban
strategic	stratégique
judge	juge
acid	acide
bytes	octets
cent	cent
forced	forcé
compatible	compatible
apartment	appartement
null	nul
zero	zéro
speaker	orateur
consulting	consultant
designer	designer
pr	pr
marriage	mariage
roll	rouleau
banks	banques
fr	fr
participants	participants
secret	secret
negative	négatif
favorites	favoris
theater	théâtre
springs	ressorts
var	var
perform	effectuer
translation	Traduction
estimates	estimations
injury	blessure
ministry	ministère
drivers	conducteurs
lawyer	avocat
figures	chiffres
protected	protégé
proposal	proposition
sharing	partage
portal	portail
beta	bêta
gratis	gratuitement
toward	vers
slightly	légèrement
assist	aider
conduct	conduite
contained	contenu
legislation	législation
calling	appel
parameters	paramètres
profiles	profils
matters	questions
houses	Maisons
controls	contrôles
combined	combiné
ultimate	ultime
representative	représentant
minor	mineur
departments	départements
residents	résidents
displayed	affiché
mom	maman
reduced	réduit
rare	rare
performed	réalisée
extreme	extrême
samples	échantillons
bars	barres
forecast	prévoir
removed	supprimé
cycle	cycle
contain	contenir
accuracy	précision
sleep	dormir
mg	mg
bird	oiseau
pharmacy	pharmacie
creation	création
static	statique
hunter	chasseur
addresses	adresses
lady	Dame
crystal	cristal
famous	célèbre
writer	écrivain
chairman	président
drink	boisson
academy	académie
dynamic	dynamique
eat	manger
permanent	permanent
cleaning	nettoyage
constitutes	constitue
portfolio	portefeuille
practical	pratique
delivered	livré
infrastructure	Infrastructure
colour	Couleur
vendor	vendeur
philosophy	philosophie
regulation	règlement
officers	officiers
aim	objectif
bids	offres
nutrition	nutrition
recording	enregistrement
junior	junior
les	les
cape	cap
rings	anneaux
tip	pointe
wonderful	formidable
ticket	billet
announced	annoncé
guess	deviner
whom	qui
soccer	football
math	math
import	importer
posting	affectation
presence	présence
automatic	automatique
viewing	visualisation
maintained	entretenu
ch	ch
dan	dan
dogs	chiens
directors	directeurs
aspects	aspects
ahead	devant
moon	lune
participation	participation
scheme	schème
fly	mouche
manner	manière
matrix	matrice
combination	combinaison
amendment	amendement
strength	force
turkey	dinde
libraries	bibliothèques
proper	correct
degrees	degrés
enterprises	entreprises
delta	delta
fear	peur
seeking	recherche
inches	pouces
convention	convention
shares	actions
principal	principal
comfort	confort
colors	couleurs
wars	guerres
ordering	commande
kept	conservé
alpha	alpha
appeal	charme
cruise	croisière
bonus	prime
hey	Hey
buildings	bâtiments
specials	promos
beat	battre
batteries	batteries
becomes	devient
drives	disques
arms	bras
tea	thé
improved	amélioré
achieve	atteindre
positions	positions
dress	robe
subscription	abonnement
dealer	Marchand
contemporary	contemporain
sky	ciel
rom	ROM
carried	porté
exposure	exposition
hide	cacher
signature	Signature
miller	meunier
provision	disposition
clothes	vêtements
frames	cadres
certainly	certainement
newspaper	journal
toy	jouet
layer	couche
printed	imprimé
slow	lent
removal	suppression
liability	responsabilité
printers	imprimantes
adding	ajouter
spot	place
spend	dépenser
factory	usine
interior	intérieur
grow	croître
optical	optique
promotion	promotion
relative	relatif
amazing	incroyable
dot	point
identity	identité
conversion	conversion
feeling	sentiment
hidden	caché
reasonable	raisonnable
revision	révision
influence	influence
ratio	rapport
importance	importance
rain	pluie
planet	planète
copies	copies
permit	permis
seeing	voyant
proof	preuve
bass	basse
prescription	ordonnance
empty	vide
instance	exemple
hole	trou
ride	balade
bureau	bureau
conservation	préservation
pair	paire
ideal	idéal
specs	spécification
recorded	enregistré
don	Don
pieces	pièces
finished	fini
parks	parcs
lawyers	avocats
stress	stress
cream	crème
ss	ss
runs	fonctionne
discover	découvrir
ap	ap
patterns	modèles
hills	collines
nm	nm
advisor	conseiller
aware	conscient
shape	forme
evolution	évolution
certificates	certificats
objectives	objectifs
stations	stations
suggested	suggéré
op	op
remains	restes
firms	entreprises
euro	euro
operator	opérateur
structures	structures
generic	générique
encyclopedia	encyclopédie
usage	usage
ink	encre
mixed	mixte
census	recensement
wheel	roue
suppliers	Fournisseurs
compact	compact
poetry	poésie
lights	lumières
tracking	suivi
angel	ange
preparation	préparation
attempt	tentative
receiving	recevoir
matches	allumettes
accordance	conformité
width	largeur
engines	moteurs
forget	oublier
array	tableau
discussed	discuté
accurate	précis
climate	climat
greek	grec
instruction	instruction
managing	gérant
raw	brut
differences	différences
explain	Explique
establish	établir
expressed	exprimé
extent	ampleur
sharp	tranchant
ben	ben
paragraph	paragraphe
kill	tuer
mathematics	mathématiques
compensation	compensation
export	exportation
managers	gestionnaires
modules	modules
conducted	menée
versions	versions
knows	sait
describe	décrire
citizens	citoyens
heritage	patrimoine
trouble	difficulté
coach	entraîneur
agricultural	agricole
expand	développer
audience	public
assigned	attribué
collections	collections
ages	âge
specialist	spécialiste
cook	cuisinier
affect	affecter
virgin	vierge
experienced	expérimenté
investigation	enquête
raised	relevé
hat	chapeau
institution	institution
directed	dirigée
affected	affecté
bike	bicyclette
totally	totalement
plate	assiette
expenses	frais
indicate	indiquer
blonde	blond
proceedings	procédure
favourite	préféré
characteristics	caractéristiques
der	der
lose	perdre
organic	biologique
seek	chercher
experiences	expériences
albums	albums
contracts	contrats
guests	invités
hosted	hébergé
diseases	maladies
concerning	concernant
equivalent	équivalent
chemistry	chimie
kits	kits
logic	logique
prince	prince
circle	cercle
soil	sol
psychology	psychologie
wet	humide
circumstances	conditions
investor	investisseur
elementary	élémentaire
sponsors	sponsors
fox	Renard
unlimited	illimité
respond	répondre
sizes	tailles
plain	plaine
exit	Sortie
arm	bras
keys	clés
wave	vague
holy	saint
acts	actes
guidance	orientation
trail	Piste
symbol	symbole
highway	Autoroute
observed	observé
dean	doyen
setup	installer
poll	sondage
styles	modes
filled	rempli
bond	liaison
channels	filières
appendix	annexe
chocolate	Chocolat
portion	portion
scope	portée
supplier	fournisseur
cables	câbles
cotton	coton
requirement	exigence
killed	tué
border	frontière
ancient	ancien
debate	débat
representatives	représentants
starts	départs
pregnancy	grossesse
attractions	attractions
learned	appris
transactions	transactions
explorer	explorateur
historic	historique
husband	mari
authorized	autorisé
crazy	fou
upcoming	prochain
concert	concert
scores	scores
efficiency	Efficacité
comedy	comédie
adopted	adopté
efficient	efficace
linear	linéaire
commitment	engagement
specialty	spécialité
bears	ours
hop	saut
carrier	transporteur
constant	constant
visa	visa
mouth	bouche
meter	mètre
linked	lié
interviews	interviews
concepts	concepts
gun	pistolet
reflect	réfléchir
pure	pur
hell	enfer
fruit	fruit
begins	commence
qualified	qualifié
reform	réforme
lens	lentille
treated	traités
discovery	Découverte
draw	dessiner
classified	classifié
assume	assumer
alliance	Alliance
confirm	confirmer
engineer	ingénieur
consistent	cohérent
replace	remplacer
clearance	dégagement
converter	convertisseur
organisation	organisation
babe	bébé
checks	chèques
reached	atteint
becoming	devenir
objective	objectif
indicated	indiqué
sugar	sucre
crew	équipage
legs	jambes
stick	bâton
relation	relation
enabled	activée
genre	genre
volunteer	bénévole
rear	arrière
democratic	démocratique
enhance	améliorer
exact	exact
bound	lié
parameter	paramètre
processor	processeur
node	nœud
formal	formel
storm	orage
micro	micro
colleges	collèges
mile	mile
challenges	défis
editors	éditeurs
supreme	suprême
brothers	frères
recognition	reconnaissance
ref	ref
estimate	estimation
kid	enfant
inspection	inspection
consumers	consommateurs
limits	limites
territory	territoire
weapons	armes
delay	retard
pilot	pilote
contributions	contributions
continuous	continu
initiative	initiative
novel	roman
execution	exécution
disability	invalidité
ultra	ultra
winner	gagnant
episode	épisode
potter	potier
dish	plat
plays	pièces
bulletin	bulletin
ia	ia
modify	modifier
truly	vraiment
universe	univers
candidate	candidat
slot	fente
outstanding	exceptionnel
ha	Ha
planned	prévu
lodge	loge
mirror	miroir
tournament	tournoi
consideration	considération
sessions	sessions
kernel	noyau
buyers	acheteurs
journals	revues
gray	gris
catalogue	catalogue
charged	accusé
broad	vaste
und	und
chosen	choisi
demo	demo
hate	haine
terminal	Terminal
publishers	éditeurs
nights	nuits
liquid	liquide
rice	riz
reservation	réservation
foods	nourriture
guard	garde
saving	économie
empire	Empire
newly	nouvellement
raise	élever
illegal	illégal
expansion	expansion
premier	premier
tomorrow	demain
milk	Lait
drama	drame
visiting	visite
contest	concours
collected	collectées
bands	bandes
suitable	adapté
absolutely	absolument
audit	vérification
chamber	chambre
guinea	Guinée
findings	résultats
iso	iso
typical	typique
sum	somme
chicken	poulet
temporary	temporaire
attend	assister
shower	douche
sending	envoi
sufficient	suffisant
shell	coquille
province	Province
catholic	catholique
governor	gouverneur
beer	Bière
contribution	contribution
formula	formule
constitution	Constitution
packaging	emballage
reliable	fiable
doubt	doute
earn	gagner
periods	périodes
attacks	attaques
merchandise	marchandise
symptoms	symptômes
memorial	Mémorial
twin	double
insert	insérer
gateway	passerelle
drawing	dessin
candidates	candidats
ordered	commandé
biological	biologique
fighting	combat
transition	transition
preferences	préférences
spy	espion
romance	romance
instrument	instrument
split	Divisé
themes	thèmes
powers	pouvoirs
heaven	paradis
bits	morceaux
pregnant	Enceinte
classification	classification
focused	concentré
physician	médecin
asking	demander
blocks	blocs
lo	lo
spiritual	spirituel
diabetes	Diabète
ml	ml
shift	décalage
sit	asseoir
bodies	corps
photographs	photographies
cutting	Coupe
writers	écrivains
flexible	flexible
loved	aimé
favourites	favoris
mapping	cartographie
numerous	nombreux
relatively	relativement
represents	représente
superior	supérieur
preferred	préféré
saved	enregistré
intellectual	intellectuel
granted	accordé
carbon	carbone
comfortable	confortable
magnetic	magnétique
interaction	interaction
listening	écoute
crisis	crise
outlook	perspective
massive	massif
bright	brillant
formed	formé
piano	piano
echo	écho
revolution	révolution
displays	affiche
plasma	plasma
earnings	gains
mystery	mystère
landscape	paysage
mechanical	mécanique
journey	périple
banner	bannière
fig	figue
counties	comtés
acquisition	acquisition
recognized	reconnu
dreams	rêves
notification	notification
kg	kg
teach	apprendre
rapid	rapide
pull	tirer
ut	Utah
seminar	séminaire
investments	investissements
wheels	roues
specify	spécifier
sensitive	sensible
templates	modèles
formats	formats
holds	détient
router	routeur
concrete	béton
si	si
folder	dossier
completion	achèvement
pulse	impulsion
technique	technique
voting	vote
courts	tribunaux
converted	converti
metro	métro
anniversary	anniversaire
improvements	améliorations
strip	bande
specification	spécification
accident	accident
nick	entaille
accessible	accessible
resident	résident
plot	terrain
typically	typiquement
representation	représentation
pump	pompe
exists	existe
arrangements	arrangements
conferences	conférences
consumption	consommation
narrow	étroit
threat	menace
surveys	enquêtes
sitting	séance
consultant	consultant
controller	manette
committees	comités
penis	pénis
castle	Château
gardens	jardins
labels	Étiquettes
willing	prêt
bio	bio
acting	agissant
heads	têtes
exam	examen
residence	résidence
density	densité
hundred	cent
strange	étrange
sustainable	durable
statistical	statistique
mention	mention
innovation	innovation
grey	gris
parallel	parallèle
operate	fonctionner
bills	factures
stable	stable
definitions	définitions
von	von
doctors	médecins
lesson	leçon
cinema	cinéma
elections	élections
reaction	réaction
blank	blanc
enhanced	renforcée
entitled	intitulé
severe	sévère
generate	produire
newspapers	journaux
hospitals	hôpitaux
vi	vi
humor	humour
aged	vieilli
monitors	moniteurs
exception	exception
duration	durée
bulk	masse
visits	visites
capabilities	capacités
recommendation	recommandation
sin	péché
organized	organisé
ba	ba
para	para
adoption	adoption
improving	améliorer
expensive	coûteux
buffalo	buffle
organisations	organisations
plane	avion
programmes	programmes
mechanism	mécanisme
ee	ee
marked	marqué
driven	poussé
bottle	bouteille
innovative	innovant
massage	massage
conclusion	conclusion
closing	fermeture
thousand	mille
legend	Légende
villa	villa
bone	OS
columns	colonnes
disorders	troubles
collaboration	collaboration
detection	détection
inner	interne
formation	formation
med	med
engineers	ingénieurs
entity	entité
cruises	Croisières
gate	porte
roman	romain
duties	fonctions
erotic	érotique
tone	Ton
ethics	éthique
dragon	dragon
busy	occupé
captain	capitaine
brings	apporte
heating	chauffage
leg	jambe
neck	cou
wing	aile
scripts	scripts
abc	abc
appointed	nommé
dealing	transaction
commit	commettre
rail	rail
trips	voyages
gap	écart
sides	côtés
tube	tube
corresponding	correspondant
descriptions	descriptions
belt	ceinture
jacket	veste
animation	animation
oracle	oracle
er	er
productions	productions
aviation	aviation
proud	fier
disaster	catastrophe
console	console
commands	commandes
jr	jr
telecommunications	télécommunications
instructor	instructeur
giant	géant
achieved	réalisé
injuries	blessures
approaches	approches
usual	habituel
stamps	timbres
angle	angle
rob	Rob
designers	concepteurs
liberty	liberté
era	ère
convert	convertir
possibility	possibilité
analyst	analyste
dangerous	dangereux
reliability	fiabilité
respectively	respectivement
volunteers	bénévoles
derived	dérivé
pleasure	plaisir
honor	honneur
oriented	orienté
eagle	Aigle
prayer	prière
workshops	ateliers
hurricane	ouragan
quiet	silencieux
producer	producteur
represented	représentée
responsibilities	responsabilités
cheese	fromage
carefully	soigneusement
productivity	productivité
crown	couronne
par	par
diagnosis	diagnostic
maker	fabricant
crack	fissure
principle	principe
picks	choix
gang	gang
fetish	fétiche
appearance	apparence
smoke	fumée
filters	filtres
incorporated	incorporé
craft	artisanat
fellow	compagnon
blind	aveugle
lounge	salon
mad	furieux
algorithm	algorithme
strongly	fortement
cafe	café
ken	ken
proteins	protéines
su	su
familiar	familier
capable	capable
admission	admission
shoe	chaussure
elected	élu
carrying	portant
terrorism	terrorisme
joy	joie
editions	éditions
ethnic	ethnique
parliament	parlement
actor	acteur
finds	découvertes
seal	joint
situations	situations
fifth	cinquième
citizen	citoyen
vertical	verticale
corrections	corrections
describes	décrit
disabilities	handicapées
substance	substance
prohibited	interdit
pipe	tuyau
soldiers	soldats
guardian	Gardien
lecture	conférence
simulation	simulation
layout	disposition
initiatives	initiatives
ill	mauvais
concentration	concentration
lay	allonger
interpretation	interprétation
dirty	sale
taught	enseigné
worker	ouvrier
optimization	optimisation
temple	temple
substances	substances
prove	prouver
discovered	découvert
wings	ailes
genetic	génétique
restrictions	restrictions
thin	mince
exhibition	exposition
ridge	crête
modem	modem
bringing	apportant
sick	malade
evaluate	évaluer
tropical	tropical
collect	collecte
vector	vecteur
definitely	absolument
turning	tournant
existence	existence
commentary	commentaire
developments	développements
immigration	immigration
destinations	destinations
mutual	mutuel
syntax	syntaxe
li	li
attribute	attribut
prison	prison
skill	compétence
chairs	chaises
surrounding	alentours
mountains	montagnes
popularity	popularité
inquiry	enquête
checked	vérifié
exhibit	exposition
throw	jeter
trend	tendance
cats	chats
desert	désert
ya	ya
coordinator	coordinateur
mercury	Mercure
burning	brûlant
escape	échapper
receiver	destinataire
progressive	progressive
boats	bateaux
championship	championnat
arcade	arcade
impossible	impossible
tells	dit
obvious	évident
depression	dépression
graph	graphique
covering	couvrant
platinum	platine
judgment	jugement
talks	pourparlers
filing	dépôt
foster	favoriser
awarded	décerné
trials	essais
masters	maîtrise
cartridge	cartouche
explanation	explication
org	org
fraud	fraude
electricity	électricité
spectrum	spectre
arrival	arrivée
pottery	poterie
emphasis	accentuation
awesome	impressionnant
confirmed	confirmé
counts	compte
crash	crash
lift	ascenseur
inter	entre
heights	hauteurs
shadow	ombre
expense	frais
venture	entreprise
clinic	clinique
healing	guérison
princess	Princesse
entering	entrer
packet	paquet
studios	studios
involvement	participation
dad	papa
buttons	boutons
placement	placement
observations	observations
winners	gagnants
roads	routes
subsequent	subséquent
yard	Cour
disclosure	divulgation
establishment	établissement
memories	souvenirs
te	te
creates	crée
faces	visages
tourist	touristique
murder	meurtre
adequate	adéquat
senator	sénateur
presentations	présentations
digest	digérer
dust	poussière
wiki	wiki
replaced	remplacé
radar	radar
losses	pertes
combat	combat
reducing	réduire
stopped	arrêté
occupation	Occupation
closely	étroitement
radiation	radiation
kings	rois
shooting	tournage
ear	oreille
flags	drapeaux
baker	boulanger
conservative	conservateur
shock	choc
effectiveness	efficacité
tie	attacher
roof	toit
demonstrate	démontrer
atmosphere	atmosphère
kiss	baiser
beast	bête
ra	ra
operated	exploité
experiment	expérience
targets	cibles
purchases	achats
federation	fédération
pizza	Pizza
invited	invité
assignment	affectation
mod	mod
queries	requêtes
absence	absence
vendors	vendeurs
yoga	yoga
serves	sert
surprise	surprise
lamp	lampe
jokes	blagues
counseling	conseils
palace	palais
satisfied	satisfait
wins	victoires
warehouse	entrepôt
supposed	supposé
ordinary	ordinaire
ghost	fantôme
violation	violation
boss	patron
pride	fierté
expectations	attentes
independence	indépendance
knowing	connaissance
reporter	journaliste
metabolism	métabolisme
champion	champion
personally	personnellement
plenty	beaucoup
solo	solo
throat	gorge
wealth	richesse
vacuum	vide
dancing	dansant
recognize	reconnaître
writes	écrit
plaza	place
quest	quête
publish	publier
screening	dépistage
trans	trans
pioneer	pionnier
forgotten	oublié
acrobat	acrobate
plates	plaques
essays	essais
behaviour	comportement
telling	récit
fairly	équitablement
intelligent	intelligent
modes	modes
obligation	obligation
harbor	port
traveler	voyageur
segment	segment
enemy	ennemi
puzzle	puzzle
wells	puits
restricted	limité
republican	républicain
secrets	secrets
syndrome	syndrome
attendance	présence
penalty	peine
drum	tambour
enables	permet
builder	constructeur
vista	vue
flood	inonder
ease	facilité
arguments	arguments
arena	arène
adventures	aventures
pupils	élèves
announcement	annonce
outcome	résultat
appreciate	apprécier
expanded	étendu
grown	mûr
lovely	charmant
centres	centres
clause	clause
smile	sourire
lands	terres
troops	troupes
armed	armé
pine	pin
cooling	refroidissement
gulf	golfe
trucks	camions
mechanisms	mécanismes
divorce	divorce
tradition	tradition
pills	pilules
tiger	tigre
folks	gens
sensor	capteur
exposed	exposé
hunt	chasse
angels	anges
deputy	adjoint
thai	thaïlandais
emissions	émissions
physicians	médecins
complaint	plainte
scenes	scènes
experiments	expériences
boost	renforcer
governance	gouvernance
mill	moulin
founded	fondé
chronic	chronique
den	tanière
finger	doigt
keeps	garde
pound	livre
locate	Localiser
pl	PL
trained	qualifié
implementing	exécution
bread	pain
motors	moteurs
tough	dure
incident	incident
dynamics	dynamique
lie	mensonge
conversation	conversation
decrease	diminution
worship	culte
capability	aptitude
ak	Alaska
precision	précision
damages	dégâts
reserves	réserves
solve	résoudre
minority	minorité
diverse	diverse
ingredients	Ingrédients
ah	ah
tones	tons
rehabilitation	réhabilitation
sight	vue
clay	argile
weak	faible
divided	divisé
reception	accueil
wise	sage
odds	chances
seminars	séminaires
consequences	conséquences
makers	décideurs
geography	géographie
integrity	intégrité
legacy	héritage
pleased	heureux
danger	danger
vitamin	vitamine
processed	traité
phrase	phrase
raising	élevage
implications	implications
functionality	fonctionnalité
paradise	paradis
hybrid	hybride
reads	lit
emotional	émotif
glory	gloire
ja	ja
geographic	géographique
exceed	dépasser
rod	barre
silk	soie
babies	bébés
bi	bi
romantic	romantique
revealed	révélé
specialists	spécialistes
generator	Générateur
suspension	suspension
sad	triste
correction	correction
wolf	Loup
slowly	lentement
supplement	supplément
portions	portions
infant	bébé
sectors	secteurs
fluid	fluide
grounds	terrains
meal	repas
ta	ta
machinery	machinerie
equation	équation
baskets	paniers
probability	probabilité
dimension	dimension
studied	étudié
profits	bénéfices
devil	diable
grass	herbe
illustrated	illustré
cherry	Cerise
continental	continental
achievement	réussite
limitations	limites
funeral	funérailles
chapters	chapitres
passenger	passager
convenient	pratique
mars	Mars
sized	taille
egg	Oeuf
signals	signaux
orientation	orientation
theft	vol
childhood	enfance
symbols	symboles
lat	lat
meta	méta
analog	analogique
talent	Talent
dated	daté
wisdom	sagesse
boundary	frontière
elite	élite
gi	gi
believes	croit
poems	poèmes
jurisdiction	juridiction
robot	robot
displaying	visualisation
witness	témoin
equipped	équipé
stages	étapes
sur	sur
acquired	acquis
assess	évaluer
wash	lavage
entrance	entrée
declaration	déclaration
losing	perdant
attempts	tentatives
noble	noble
automation	automatisation
impacts	impacts
rev	tour
advantages	avantages
knight	Chevalier
aims	objectifs
extensions	extensions
appeals	appels
illness	maladie
ho	ho
alternatives	alternatives
sh	sh
soap	savon
jam	confiture
unusual	inhabituel
answered	répondu
destruction	destruction
migration	migration
disorder	désordre
conventional	conventionnel
wearing	portant
axis	axe
sought	recherché
genes	gènes
median	médian
scanner	scanner
herein	ici
animated	Animé
adjustment	ajustement
hero	héros
treatments	traitements
attitude	attitude
carpet	tapis
lenses	lentilles
attended	assisté
difficulty	difficulté
punk	punk
coalition	coalition
enrollment	inscription
duke	Duc
pace	rythme
producers	producteurs
arc	arc
interfaces	interfaces
atlas	atlas
observation	observation
torture	torture
deleted	supprimé
coat	manteau
restoration	restauration
convenience	commodité
returning	retour
opposition	opposition
container	récipient
defendant	défendeur
supervisor	superviseur
corps	corps
actors	acteurs
liver	foie
liable	assujetti
petition	pétition
antenna	antenne
picked	choisi
belief	croyance
killing	meurtre
shoulder	épaule
decor	décor
ion	ion
diameter	diamètre
podcast	Podcast
interactions	interactions
singer	chanteur
herald	héraut
aging	vieillissement
intervention	intervention
plugin	brancher
attraction	attraction
diving	plongée
modification	modification
suppose	supposer
reed	roseau
involve	impliquer
moderate	modérer
mice	souris
understood	compris
rapidly	rapidement
ban	interdire
assurance	assurance
happening	événement
vast	vaste
mills	moulins
outline	contour
receives	reçoit
jeans	jeans
compilation	compilation
odd	impair
sigma	Sigma
gr	gr
attractive	attrayant
occasion	occasion
recordings	enregistrements
victim	victime
demands	demandes
careful	prudent
beam	faisceau
gardening	jardinage
obligations	obligations
arrive	arrivée
orchestra	orchestre
licence	Licence
adjustable	Ajustable
allocation	allocation
essay	essai
demonstrated	démontré
dialogue	dialogue
camps	camps
declared	déclaré
trace	trace
shut	fermer
packs	paquets
ge	ge
installing	pose
switches	interrupteurs
voluntary	volontaire
thou	tu
greatly	très
ng	ng
commonly	communément
pe	pe
photographer	photographe
cry	cri
quantum	quantum
constructed	construit
additions	additions
requiring	exigeant
arrow	flèche
engagement	engagement
rough	rugueux
weird	bizarre
lion	Lion
weddings	mariages
oxygen	oxygène
canyon	canyon
meters	mètres
merely	seulement
calendars	calendriers
arrangement	arrangement
conclusions	conclusions
bibliography	bibliographie
pointer	aiguille
compatibility	compatibilité
stretch	étendue
permits	permis
cooperative	coopérative
feeding	alimentation
township	canton
rankings	classements
measuring	mesure
strap	sangle
crowd	foule
transfers	transferts
olympic	olympique
transformation	transformation
dir	dir
customs	douane
administrators	administrateurs
personality	personnalité
hook	crochet
roulette	roulette
decline	déclin
cord	corde
cloud	nuage
facilitate	faciliter
val	val
explains	explique
proceed	procéder
feelings	sentiments
knife	couteau
adopt	adopter
denied	dénié
donation	don
outer	extérieur
crop	surgir
rivers	rivières
nodes	nœuds
cited	cité
hub	centre
targeted	ciblée
realized	réalisé
founder	fondateur
decade	décennie
dispute	contestation
tired	fatigué
adverse	négatif
excerpt	extrait
discharge	décharge
drinks	boissons
ace	as
voices	voix
climbing	escalade
tons	tonnes
perfume	parfum
hazardous	dangereux
restore	restaurer
stack	empiler
methodology	méthodologie
reputation	réputation
democrats	démocrates
hang	pendre
curve	courbe
creator	créateur
amber	ambre
museums	musées
coding	codage
tracker	traqueur
variation	variation
passage	passage
transferred	transféré
trunk	tronc
photograph	photographier
waves	vagues
camel	chameau
distributor	distributeur
chi	chi
gathering	rassemblement
projection	projection
mathematical	mathématique
logical	logique
sauce	sauce
fame	célébrité
specialized	spécialisé
corporations	sociétés
criticism	critique
automobile	voiture
judges	juges
remarks	remarques
detected	détecté
paintings	peintures
walked	marché
arising	découlant
populations	populations
afraid	peur
acoustic	acoustique
cassette	cassette
indicator	indicateur
jpg	jpg
mistake	erreur
eliminate	éliminer
mineral	minéral
ruby	rubis
beads	perles
fortune	fortune
canvas	Toile
threshold	seuil
parish	paroisse
screens	écrans
cemetery	cimetière
stadium	stade
exploration	exploration
mins	minutes
stem	tige
astronomy	astronomie
contests	concours
flu	grippe
costume	costume
bikes	vélos
bishop	évêque
pulled	tiré
corn	blé
compression	compression
establishing	établissement
farmer	agriculteur
tin	étain
slave	esclave
instantly	immédiatement
coaching	encadrement
examined	examiné
encoding	codage
submissions	soumissions
heroes	héros
painted	peint
portrait	portrait
terrorist	terroriste
ethical	éthique
carriers	transporteurs
mobility	mobilité
struggle	lutte
schemes	régimes
suffering	Souffrance
neutral	neutre
fisher	pêcheur
rat	rat
spears	lances
joining	joindre
heading	titre
artificial	artificiel
bearing	palier
spectacular	spectaculaire
worlds	mondes
guilty	coupable
activation	Activation
haven	havre
tablet	tablette
jury	jury
dos	dos
tail	queue
charm	charme
violent	violent
potentially	potentiellement
ranch	ranch
constraints	contraintes
crossing	traversée
inclusive	compris
cottage	chalet
drunk	ivre
considerable	considérable
crimes	crimes
resolved	résolu
byte	octet
nose	nez
branches	branches
alien	extraterrestre
processors	processeurs
broke	cassé
complexity	complexité
constantly	constamment
resolve	résoudre
territories	territoires
thesis	thèse
discs	disques
frequent	fréquent
ceiling	plafond
pixels	pixels
gen	gen
diamonds	diamants
fleet	flotte
bunch	bouquet
theoretical	théorique
referral	référence
quit	quitter
protocols	protocoles
lung	poumon
substitute	remplacer
brilliant	brillant
ti	ti
gel	gel
spoken	parlé
omega	oméga
evaluated	évalué
stayed	séjourné
sees	voit
termination	Résiliation
watched	regardé
households	ménages
redeem	racheter
grain	grain
regime	régime
bull	taureau
architectural	architectural
differ	différer
movements	mouvements
repairs	réparations
breath	souffle
amenities	équipements
virtually	virtuellement
mart	marché
candle	bougie
hanging	pendaison
colored	coloré
tale	conte
formerly	anciennement
projector	projecteur
situated	situé
seeks	cherche
strictly	strictement
psychological	psychologique
vitamins	vitamines
elegant	élégant
gains	gains
renewal	renouvellement
genealogy	généalogie
deemed	réputée
scoring	points
expenditure	dépense
critics	critiques
algorithms	algorithmes
hacker	pirate
salon	salon
turbo	turbo
cure	guérir
ni	ni
thinks	pense
suggestion	suggestion
soldier	soldat
bomb	bombe
harm	nuire
interval	intervalle
mirrors	miroirs
investigate	enquêter
thy	tes
panels	panneaux
repeated	répété
assault	agression
deer	cerf
tongue	langue
bowling	bowling
tri	tri
monkey	singe
proportion	proportion
skirt	jupe
analyses	analyses
drawings	dessins
significance	importance
scenario	scénario
ye	vous
arabic	arabe
gauge	jauge
protecting	protéger
faced	face
solving	résolution
produces	produit
intensive	intensif
chains	Chaînes
sixth	sixième
engage	engager
switching	commutation
correspondence	correspondance
imports	importations
supervision	surveillance
expenditures	dépenses
separation	séparation
testimony	témoignage
suspect	suspect
mandatory	obligatoire
boundaries	limites
celebration	fête
filtering	filtration
spouse	époux
exotic	exotique
viewer	téléspectateur
reaching	atteindre
laugh	rire
surgical	chirurgical
destroy	détruire
citation	citation
yo	yo
premises	locaux
proved	prouvé
offensive	offensive
imperial	impérial
dozen	douzaine
deployment	déploiement
cloth	tissu
lotus	lotus
salmon	Saumon
cargo	cargaison
directive	directif
mate	camarade
butter	beurre
pepper	poivre
weapon	arme
burden	charge
tapes	bandes
zones	zones
isle	île
slim	svelte
maple	érable
grocery	épicerie
governing	gouvernant
depot	dépôt
alt	alt
pie	tarte
blend	mélange
emission	émission
apparent	apparent
instructional	éducatif
permissions	autorisations
toilet	toilette
ranked	classé
routes	routes
mounting	montage
tied	lié
balanced	équilibré
delayed	différé
dale	vallée
calculation	calcul
villas	villas
occasions	occasions
equations	équations
oils	huiles
sept	septembre
exceptional	exceptionnel
anxiety	anxiété
spatial	spatial
respondents	répondants
considerations	considérations
pays	paie
sunny	ensoleillé
delivers	livre
je	je
necklace	Collier
composite	composite
lang	lang
theaters	théâtres
designing	conception
hopes	espoirs
assessments	évaluations
diagram	diagramme
footwear	chaussure
sg	sg
peoples	peuples
victor	Victor
licenses	licences
ranges	gammes
pairs	paires
sensitivity	sensibilité
preservation	préservation
isolated	isolé
interim	intérimaire
assisted	assisté
divine	Divin
approve	approuver
compound	composé
intensity	intensité
technological	technologique
abortion	Avortement
dialog	dialogue
venues	lieux
blast	explosion
addressing	adressage
pole	pôle
shield	bouclier
membrane	membrane
desperate	désespéré
mothers	mères
demonstration	manifestation
governmental	gouvernemental
manufactured	fabriqué
candles	bougies
variations	variations
moms	mamans
sacred	sacré
addiction	dépendance
chrome	chrome
refused	refusé
brake	frein
exterior	extérieur
greeting	salutation
ecology	écologie
glen	glen
unemployment	chômage
scored	marqué
enhancement	renforcement
clone	cloner
velocity	rapidité
lambda	lambda
composed	composé
tears	larmes
oasis	oasis
cab	taxi
fa	FA
societies	sociétés
silicon	silicium
identical	identique
petroleum	pétrole
compete	rivaliser
ist	ist
lover	amoureux
belong	appartenir
lips	lèvres
escort	escorte
pond	étang
ferry	traversier
rabbit	lapin
profession	métier
dam	barrage
physiology	physiologie
exports	exportations
tire	pneu
participant	participant
electron	électron
loads	charges
heather	bruyère
motel	motel
unions	syndicats
treasury	Trésorerie
occupied	occupé
scales	Balance
strain	souche
arrested	arrêté
investigations	enquêtes
gained	gagné
laundry	blanchisserie
placing	placement
adjust	régler
assessed	évalués
encryption	chiffrement
filling	remplissage
imposed	imposé
silence	silence
soviet	soviétique
possession	possession
treaty	traité
trainer	entraîneur
organ	organe
lemon	citron
darkness	obscurité
span	envergure
joke	blague
packing	emballage
statute	loi
rejected	rejeté
shelter	abri
chapel	chapelle
manufacture	fabrication
layers	couches
celebrate	célébrer
appliance	appareil
mixture	mélange
rider	cavalier
radius	rayon
impressive	impressionnant
sheep	mouton
architect	architecte
lectures	conférences
wines	vins
cups	tasses
ash	cendre
contributors	contributeurs
salad	salade
violations	violations
temperatures	températures
competitions	compétitions
preserve	préserver
poem	poème
staying	rester
easter	Pâques
theories	théories
repository	dépôt
streams	ruisseaux
landing	atterrissage
executed	réalisé
negotiations	négociations
realistic	réaliste
asks	demande
synopsis	synopsis
composer	compositeur
bean	haricot
sword	épée
modifications	modifications
coral	corail
pixel	pixel
paths	chemins
bubble	bulle
por	por
acquire	acquérir
contrary	contraire
tribune	tribune
vessel	navire
acids	acides
viruses	virus
stickers	autocollants
reactions	réactions
beliefs	croyances
squad	équipe
analyze	analyser
divisions	divisions
swim	nager
nano	nano
concerts	concerts
males	mâles
retain	conserver
colours	couleurs
execute	exécuter
tunnel	tunnel
genres	genres
patents	brevets
wheat	blé
chronicles	chroniques
obtaining	obtention
beaver	castor
readings	lectures
enlargement	élargissement
eagles	aigles
bases	bases
accused	accusé
campaigns	campagnes
unity	unité
defines	définit
instances	instances
indigenous	indigène
begun	commencé
packets	paquets
anchor	ancre
socks	chaussettes
trigger	déclencheur
cholesterol	cholestérol
differential	différentiel
surfaces	surfaces
terrible	terrible
routers	routeurs
clocks	horloges
arthritis	arthrite
bios	bios
females	femelles
reflects	reflète
taxation	Imposition
fever	fièvre
cuisine	cuisine
surely	sûrement
practitioners	praticiens
theorem	théorème
inflation	inflation
thee	te
compounds	composés
drums	tambours
reasonably	raisonnablement
bare	nu
radical	radical
recommends	recommande
controlling	commander
treasure	Trésor
flame	flamme
pit	fosse
mono	mono
particles	particules
floating	flottant
coordinate	coordonner
exclusively	exclusivement
limitation	limitation
struck	frappé
illustration	illustration
warnings	avertissements
construct	construction
apps	applications
inquiries	enquêtes
annex	annexe
inspiration	inspiration
freight	fret
eclipse	éclipse
affects	affecte
forecasts	prévisions
detect	détecter
actively	activement
complicated	compliqué
injured	blessé
expressions	expressions
ton	tonne
courier	courrier
hints	astuces
gif	gif
conflicts	conflits
beverage	boisson
tribute	hommage
immune	immunitaire
forestry	sylviculture
barriers	barrières
cant	pente
rarely	rarement
offerings	offres
barrier	barrière
bicycle	vélo
furnishings	mobilier
arise	survenir
celtic	celtique
particle	particule
humidity	humidité
bottles	bouteilles
dm	dm
renaissance	Renaissance
ordinance	ordonnance
photographers	photographes
infections	infections
chess	échecs
operates	fonctionne
festivals	festivals
possibilities	possibilités
duck	canard
canal	canal
contributing	contribuant
cow	vache
analytical	analytique
costumes	costumes
strict	strict
circulation	circulation
offense	infraction
assumption	supposition
hobby	loisir
tries	essais
invention	invention
technician	technicien
executives	cadres
enquiries	enquêtes
cognitive	cognitif
exploring	explorant
trick	tour
enquiry	enquête
closure	fermeture
timber	bois
volt	volt
intense	intense
supporters	partisans
statutes	statuts
enrolled	inscrits
sensors	capteurs
screw	vis
ministers	ministres
publicly	publiquement
suffered	souffert
intake	admission
butterfly	papillon
mechanics	mécanique
headers	têtes
mistakes	erreurs
numerical	numérique
defining	définissant
counting	compte
reflection	réflexion
invitation	invitation
sodium	sodium
hormone	hormone
childrens	enfants
brick	brique
grip	poignée
medieval	médiéval
porcelain	porcelaine
captured	capturé
decent	décent
casting	fonderie
translated	traduit
donna	dona
warrior	guerrier
cabin	cabine
scanning	balayage
polo	polo
copying	copier
horn	klaxon
journalism	journalisme
frog	grenouille
grammar	grammaire
intention	intention
tires	pneus
undertaken	entreprise
hazard	danger
episodes	épisodes
circular	circulaire
anger	colère
illustrations	illustrations
chances	chances
happiness	bonheur
bizarre	bizarre
ur	ur
fruits	fruits
identifier	identificateur
ribbon	ruban
calculations	calculs
jpeg	jpeg
startup	Commencez
handy	pratique
swap	échanger
exempt	exempter
crops	cultures
reduces	réduit
accomplished	accompli
geometry	géométrie
impression	impression
guild	guilde
correlation	corrélation
sim	sim
nervous	nerveux
fragrance	fragrance
replica	réplique
tribe	tribu
trades	métiers
superb	superbe
rid	débarrasser
trinity	trinité
handled	manipulés
legends	légendes
boom	boom
calm	calme
champions	champions
floors	étages
selections	sélections
comparing	comparant
speaks	parle
vocational	professionnel
pharmacies	pharmacies
ln	Dans
roller	rouleau
batch	lot
organize	organiser
appreciated	apprécié
alter	modifier
edges	bords
mixing	mélange
handles	poignées
harmony	harmonie
distinguished	distingué
asthma	asthme
assumptions	hypothèses
regulated	réglementé
triangle	Triangle
amend	modifier
anticipated	anticipé
oriental	Oriental
reward	récompense
hydrogen	hydrogène
comparable	comparable
advocate	avocat
confusion	confusion
inputs	contributions
warranties	garanties
genome	génome
medal	médaille
coaches	entraîneurs
vessels	navires
harbour	port
eco	eco
vulnerable	vulnérable
arrange	organiser
artistic	artistique
honors	honneurs
reflected	reflété
unified	unifié
breed	race
detector	détecteur
ignored	ignoré
precise	précis
evaluating	évaluer
lip	lèvre
gather	recueillir
forming	formant
journalists	journalistes
slight	mince
indirect	indirect
amongst	parmi
foundations	fondations
horizon	horizon
nu	nu
deeply	profondément
liabilities	passif
prizes	prix
decreased	diminué
describing	décrivant
optics	optique
pursue	poursuivre
lightning	foudre
ou	OU
quotations	citations
inspector	inspecteur
snake	serpent
reminder	rappel
searched	cherché
plains	plaines
insights	idées
abilities	capacités
initiated	initié
karaoke	karaoké
trap	piège
lonely	solitaire
ve	ve
observe	observer
containers	conteneurs
attitudes	attitudes
berry	baie
collar	collier
integrate	intégrer
sociology	sociologie
exhibits	expositions
dies	meurt
terrace	terrasse
bacteria	bactéries
ought	devrait
delicious	délicieux
traditions	traditions
finite	fini
sends	envoie
durable	durable
allied	allié
moisture	humidité
transform	transformer
timer	minuteur
tablets	comprimés
gotten	obtenu
educators	éducateurs
vegetable	légume
verse	verset
independently	indépendamment
competitors	concurrents
rocket	fusée
aye	toujours
bullet	balle
towers	tours
visibility	visibilité
latitude	latitude
consciousness	conscience
tumor	tumeur
ugly	laid
deposits	dépôts
mistress	maîtresse
encounter	rencontre
watts	watts
forty	quarante
tubes	tubes
attempted	tentative
priest	prêtre
analysts	analystes
hammer	marteau
invasion	invasion
runner	coureur
rows	lignes
administered	administré
notion	notion
spelling	orthographe
arctic	Arctique
rewards	récompenses
beneath	sous
strengthen	renforcer
defend	défendre
infrared	infrarouge
seventh	septième
belly	ventre
aggressive	agressif
advertisements	annonces
quarters	quarts
stolen	volé
determines	détermine
sculpture	sculpture
poly	poly
ears	oreilles
fist	poing
neo	néo
motivation	motivation
passengers	passagers
consistently	régulièrement
surplus	surplus
dig	creuser
taxi	Taxi
appreciation	appréciation
om	om
restriction	restriction
guitars	guitares
essence	essence
mighty	puissant
humanity	humanité
transcription	transcription
complications	complications
scholars	savants
galaxy	galaxie
caring	soins
testament	testament
dominant	dominant
stomach	estomac
partially	partiellement
minimize	minimiser
ranks	rangs
debut	début
generations	générations
tournaments	tournois
deny	Nier
anatomy	anatomie
headphones	écouteurs
fraction	fraction
trio	trio
proceeding	instance
cube	cube
defects	défauts
uncertainty	incertitude
breakdown	panne
settled	colonisé
vaccine	vaccin
fate	sort
bookings	réservations
republicans	républicains
jungle	jungle
zen	Zen
dis	dis
prediction	prédiction
ecological	écologique
oval	ovale
implies	implique
ser	ser
appraisal	évaluation
prospect	perspective
geographical	géographique
donor	donneur
tension	tension
trash	poubelle
shapes	formes
tier	étage
earl	comte
homeland	patrie
championships	championnats
breeds	races
disco	disco
aus	aus
finishing	finition
emotions	émotions
eternal	éternel
rotation	rotation
nam	nam
productive	productif
boulevard	boulevard
pig	porc
metric	métrique
penalties	pénalités
varied	varié
grande	grande
actress	actrice
assign	attribuer
accommodate	accommoder
tigers	tigres
villages	villages
shade	ombre
chorus	Refrain
rhythm	rythme
digit	chiffre
symphony	symphonie
sudden	soudain
accepting	acceptant
pools	piscines
lyric	lyrique
isolation	isolement
speeds	vitesses
sustained	soutenu
matched	appariés
approximate	approximatif
rope	corde
rational	rationnel
programmer	programmeur
fighters	combattants
inherited	hérité
incomplete	incomplet
vocals	voix
fountain	Fontaine
legitimate	légitime
biographies	Biographies
investigator	enquêteur
plaintiff	demandeur
gentle	doux
worthy	digne
architects	architectes
saints	saints
entrepreneur	entrepreneur
carries	porte
duo	duo
excessive	excessif
saves	sauve
regarded	considéré
valuation	évaluation
unexpected	inattendu
fog	brouillard
characteristic	caractéristiques
lobby	hall
outlined	décrit
enormous	énorme
karma	karma
consist	consister
queens	reines
academics	universitaires
tribes	tribus
distinction	distinction
hazards	dangers
exemption	exemption
tenant	locataire
sustainability	durabilité
tattoo	tatouage
algebra	algèbre
shadows	ombres
silly	idiot
freely	librement
mild	doux
fur	fourrure
readily	facilement
affiliation	affiliation
fence	clôture
infinite	infini
clan	clan
revolutionary	révolutionnaire
bracelets	bracelets
remedy	remède
breathing	respiration
briefly	brièvement
thickness	épaisseur
graphical	graphique
genius	génie
discussing	discuter
fighter	combattant
meaningful	significatif
adapted	adapté
estates	domaines
rug	couverture
democrat	démocrate
borough	arrondissement
maintains	maintient
ka	ka
retained	retenu
marble	marbre
dem	dem
meditation	méditation
microphone	microphone
combining	combinant
giants	géants
organizing	organisation
memo	note
ham	jambon
solved	résolu
tide	marée
partition	cloison
invisible	invisible
consoles	consoles
magnet	aimant
translations	traductions
jaguar	jaguar
commodity	marchandise
kilometers	kilomètres
guarantees	garanties
gothic	gothique
cylinder	cylindre
witch	sorcière
buck	mâle
enemies	ennemis
consultancy	Conseil
enjoying	profiter
patrol	patrouille
smell	odeur
carnival	carnaval
roughly	grossièrement
sticker	autocollant
promises	promesses
reef	récif
divide	diviser
consecutive	consécutif
bon	bon
representations	représentations
chan	chan
tunes	airs
mas	mas
phrases	phrases
kai	kai
peninsula	péninsule
boring	ennuyeuse
dom	dom
speeches	discours
reaches	atteint
schema	schéma
catalogs	catalogues
ministries	ministères
parliamentary	parlementaire
prefix	préfixe
savannah	savane
barrel	baril
nerve	nerf
dans	Dans
planets	planètes
deficit	déficit
renew	renouveler
coupled	accouplé
circuits	circuits
texture	texture
acknowledge	reconnaître
tent	tente
identifies	identifie
qualification	qualification
locks	serrures
miniature	miniature
euros	euros
pirates	pirates
aerial	aérien
hawk	faucon
consequence	conséquence
systematic	systématique
perceived	perçue
origins	origines
hired	embauché
makeup	maquillage
ui	ui
weights	poids
geological	géologique
lasting	durable
wicked	méchant
introduces	introduit
pushed	pressé
ro	ro
slope	pente
poet	poète
conspiracy	conspiration
theology	théologie
nails	ongles
evident	évident
rides	manèges
epic	épique
organizer	organisateur
allergy	allergie
sake	Saké
combinations	combinaisons
preceding	précédent
merit	mérite
enzyme	enzyme
planes	Avions
disks	disques
amplifier	amplificateur
arbitrary	arbitraire
prominent	important
sans	sans
builds	construit
contacted	contacté
shaft	arbre
lean	maigre
occasional	occasionnel
innovations	innovations
reviewing	révision
panic	panique
citizenship	citoyenneté
excuse	excuse
reforms	réformes
onion	oignon
sandwich	sandwich
alto	alto
hierarchy	hiérarchie
abandoned	abandonné
circles	cercles
beats	Beats
merry	joyeux
cult	culte
dash	tiret
passive	passif
valued	estimé
cage	cage
courage	courage
elevation	élévation
lap	tour
utilization	utilisation
beverages	boissons
ping	ping
entertaining	divertissant
prerequisite	prérequis
frontier	frontière
refugees	réfugiés
knights	chevaliers
hypothesis	hypothèse
medicines	médicaments
altered	modifié
doctrine	doctrine
scenic	scénique
enhancements	améliorations
intersection	intersection
sewing	couture
collectors	collectionneurs
recognised	reconnu
rage	rage
prix	prix
astrology	astrologie
advisors	conseillers
pavilion	pavillon
tactics	tactique
supplemental	additionnel
talented	talentueux
pillow	oreiller
spreading	diffusion
provinces	provinces
steal	voler
parcel	parcelle
incidence	incidence
fears	craintes
predict	prédire
flavor	saveur
hungry	affamé
metallic	métallique
interference	ingérence
warriors	guerriers
atmospheric	atmosphérique
halo	Halo
parental	parental
referenced	référencé
strikes	grèves
ant	fourmi
proposition	proposition
apt	apte
dealt	traité
trader	Commerçant
thrown	jeté
criterion	critère
badge	badge
civilization	civilisation
heath	bruyère
tremendous	énorme
performs	exécute
realm	domaine
corrected	corrigée
helmet	casque
encountered	rencontré
tsunami	tsunami
scholar	savant
surrounded	entouré
geology	géologie
creatures	créatures
cleared	dégagé
accomplish	accomplir
corners	coins
vegetarian	végétarien
yeast	Levure
pas	pas
investigated	enquête
ambassador	ambassadeur
coated	recouvert
doom	condamner
routines	routines
beings	êtres
reliance	dépendance
myth	mythe
brook	ruisseau
fu	fu
phenomenon	phénomène
ensemble	ensemble
assured	assuré
conscious	conscient
accent	accent
wives	épouses
utilize	utiliser
pledge	gage
vampire	vampire
dock	Dock
organised	organisé
musician	musicien
limiting	limitant
restored	restauré
hint	allusion
armor	armure
remark	remarque
dozens	douzaines
varies	varie
reasoning	raisonnement
guards	gardes
openings	ouvertures
replacing	remplaçant
researcher	chercheur
councils	conseils
occupations	professions
acknowledged	reconnu
pork	porc
zu	zu
equilibrium	équilibre
pipes	pipes
cottages	chalets
merge	fusionner
privilege	privilège
develops	développe
chassis	châssis
estimation	estimation
barn	Grange
frost	gel
institutes	instituts
mold	moule
dame	dame
yacht	yacht
prefers	préfère
drilling	forage
herb	herbe
breach	violation
whale	baleine
traveller	voyageur
appropriations	crédits
suspected	soupçonné
tomatoes	tomates
instructors	instructeurs
momentum	élan
fin	ailette
pastor	pasteur
mud	boue
emerald	émeraude
grows	pousse
tract	tract
ul	ul
ballet	ballet
journalist	journaliste
religions	religions
garlic	Ail
shine	éclat
explosion	explosion
briefs	slips
signatures	signatures
ozone	ozone
disciplines	disciplines
casa	casa
conversations	conversations
radios	radios
tariff	tarif
simplified	simplifié
muscles	muscles
swift	rapide
vagina	vagin
champagne	Champagne
deviation	déviation
samba	samba
employ	employer
penguin	manchot
magical	magique
influences	influences
inspections	inspections
irrigation	irrigation
miracle	miracle
hydraulic	hydraulique
penetration	pénétration
wound	blessure
belle	belle
rosa	rosa
conviction	conviction
lazy	paresseux
qualities	qualités
fathers	ancêtres
charging	charge
importantly	important
petite	menue
apparatus	appareil
terrain	terrain
explaining	expliquant
strips	bandes
nomination	nomination
empirical	empirique
worm	ver
dependence	dépendance
discrete	discret
beginner	débutant
lid	couvercle
sexuality	sexualité
sapphire	saphir
privileges	privilèges
specializing	spécialisation
marking	marquage
sheriff	shérif
declined	diminué
spies	espions
motorcycles	motocyclettes
elect	élire
highways	autoroutes
concentrate	concentrer
intimate	intime
molecules	molécules
rounds	tours
refrigerator	réfrigérateur
intervals	intervalles
sentences	Phrases
holocaust	holocauste
flyer	prospectus
peas	pois
dosage	dosage
variance	variance
navigator	navigateur
needle	aiguille
baths	thermes
brakes	freins
og	og
ko	ko
owns	propriétaire
destiny	destin
landscapes	paysages
computation	calcul
hay	foins
salvation	salut
predictions	prévisions
learners	apprenants
token	jeton
zinc	zinc
sacrifice	sacrifice
seekers	demandeurs
guru	gourou
suited	adapté
numeric	numérique
anthropology	anthropologie
emperor	empereur
grad	grad
belts	ceintures
blacks	noirs
educated	cultivé
proudly	fièrement
necessity	nécessité
curves	courbes
touring	tournée
vertex	sommet
tomato	tomate
travels	voyages
pale	pâle
functioning	fonctionnement
economies	économies
undertake	entreprendre
declare	déclarer
valves	vannes
gaps	lacunes
achievements	réalisations
tear	larme
teaches	enseigne
nil	néant
stranger	étranger
nest	nid
tribunal	tribunal
ruled	gouverné
pensions	pensions
prayers	prières
cop	flic
adolescent	adolescent
nominations	nominations
banana	banane
introductory	préliminaire
reservoir	réservoir
occurrence	occurrence
idol	idole
bloody	sanglant
remind	rappeler
charming	charmant
tooth	dent
respected	respecté
stays	séjours
affair	affaire
restrict	restreindre
mines	mines
portraits	portraits
interpreted	interprété
evaluations	évaluations
elimination	élimination
metres	mètres
hypothetical	hypothétique
helicopter	hélicoptère
pencil	crayon
performer	interprète
commissions	commissions
sphere	sphère
moss	mousse
ratios	rapports
concord	concorde
graduated	graduée
endorsed	approuvé
surprising	surprenant
lance	lance
ladder	échelle
cork	Liège
senators	sénateurs
bleeding	saignement
characterization	caractérisation
likelihood	probabilité
lanes	voies
fundamentals	fondamentaux
contamination	contamination
dome	dôme
bless	bénir
negotiation	négociation
crest	crête
opponents	adversaires
triumph	triomphe
nominated	nommé
welding	soudage
orgasm	orgasme
alloy	alliage
plots	parcelles
gently	doucement
locking	verrouillage
controversial	controversé
draws	dessine
fridge	frigo
blades	lames
loops	boucles
surge	poussée
trauma	traumatisme
advert	publicité
defensive	défensive
forbidden	interdit
vanilla	vanille
programmers	programmeurs
monitored	suivi
installations	installations
souls	âmes
motivated	motivé
dumb	stupide
hollow	creux
vault	voûte
groove	rainure
revelation	révélation
pursuit	poursuite
delegation	délégation
wires	fils
dictionaries	dictionnaires
transparency	transparence
orbit	orbite
currencies	devises
niger	Niger
positioning	placement
colony	colonie
cannon	canon
circus	cirque
promoted	promu
trout	truite
feat	exploit
temporarily	temporairement
cooked	cuit
transmit	transmettre
frequencies	fréquences
reflections	réflexions
hunger	faim
municipality	municipalité
detective	détective
cement	ciment
experiencing	expérience
fireplace	cheminée
endorsement	approbation
textiles	textiles
missile	missile
psychiatry	psychiatrie
assists	aide
auditor	Auditeur
violin	violon
prophet	prophète
oxide	oxyde
magnificent	magnifique
promptly	rapidement
adaptation	adaptation
harmful	nocif
sexually	sexuellement
enclosure	enceinte
glucose	glucose
norm	norme
playback	lecture
turtle	tortue
distances	distances
absorption	absorption
treasures	trésors
fossil	fossile
badly	mal
communist	communiste
entrepreneurs	entrepreneurs
robots	robots
foul	faute
biodiversity	biodiversité
excitement	excitation
verbal	verbal
seas	mers
mysterious	mystérieux
novelty	nouveauté
tiles	carrelage
librarian	bibliothécaire
switched	commuté
ru	ru
pose	pose
grams	grammes
therapist	thérapeute
budgets	budgets
goat	chèvre
render	rendre
sail	voile
commissioners	commissaires
dense	dense
brave	courageux
forwarding	expéditeur
awful	terrible
airplane	avion
organisms	organismes
telescope	télescope
asbestos	amiante
advancement	avancement
willow	saule
resumes	CV
existed	existait
generators	générateurs
generates	génère
potatoes	patates
thorough	approfondi
receptors	récepteurs
optimum	optimum
creature	créature
lone	seul
subtle	subtil
stripes	rayures
firmware	firmware
shepherd	berger
cradle	berceau
chancellor	chancelier
flour	farine
controversy	controverse
legendary	légendaire
choir	chorale
avoiding	évitant
beautifully	magnifiquement
expects	attend
jumping	sauteur
fabrics	textile
polymer	polymère
hygiene	hygiène
virtue	vertu
surgeons	chirurgiens
mandate	mandat
corpus	corpus
terminology	terminologie
gentleman	gentilhomme
convicted	condamné
jets	jets
indices	indices
qui	Qui
threatening	menaçant
activists	militants
prisoner	prisonnier
encourages	encourage
assembled	assemblé
terminals	terminaux
crude	brut
examines	examine
viking	viking
cleanup	nettoyer
conditional	conditionnel
attacked	attaqué
arrives	arrive
translator	traducteur
automobiles	automobiles
tractor	tracteur
continent	continent
fares	tarifs
longitude	longitude
hoped	espéré
insertion	insertion
constraint	contrainte
strengthening	renforcement
wishing	souhaitant
insulation	isolation
infringement	infraction
bent	courbé
subjective	subjectif
monsters	monstres
asylum	asile
stake	pieu
cocktail	cocktail
varieties	variétés
poison	poison
dominated	dominé
costly	cher
derivatives	dérivés
prevents	prévient
rifle	fusil
racism	racisme
interpret	interpréter
accord	accord
modest	modeste
gamers	joueurs
sorting	tri
liaison	liaison
bulbs	bulbes
tourists	touristes
behaviors	comportements
clarify	clarifier
waist	taille
attributed	attribué
owl	hibou
crystals	cristaux
exceeds	dépasse
complementary	complémentaire
battles	batailles
bitter	amer
memorandum	mémorandum
dragons	dragons
din	vacarme
incredibly	incroyablement
delegates	délégués
psychiatric	psychiatrique
teenagers	adolescents
courtyard	Cour
presidents	présidents
depart	partir
expressly	expressément
lily	lis
oversight	surveillance
resin	résine
allies	alliés
preserved	conservé
crossed	franchi
ascending	Ascendant
nominal	nominal
decay	pourriture
quartz	quartz
registers	registres
eighth	huitième
authorised	autorisé
improves	améliore
advocates	défenseurs
phenomena	phénomènes
tilt	inclinaison
granite	granit
masses	masses
athlete	athlète
franc	franc
similarity	similarité
leak	fuite
adviser	conseiller
booklet	brochure
expecting	attendant
turnover	rotation
urine	urine
towel	serviette
ginger	gingembre
chromosome	chromosome
als	als
flies	mouches
competence	compétence
crying	pleurs
amateurs	amateurs
crane	grue
investigating	enquête
rotten	pourri
habit	habitude
honour	honneur
protects	protège
iris	iris
manages	gère
erosion	érosion
carpenter	Charpentier
khan	khan
insufficient	insuffisant
formulation	formulation
clever	intelligent
lords	seigneurs
enjoyable	agréable
crescent	croissant
sixty	soixante
concentrated	concentré
distinguish	distinguer
ei	ei
projections	projections
spark	étincelle
securing	fixation
pathway	sentier
detectors	détecteurs
spike	pointe
ingredient	ingrédient
curtain	rideau
disclosed	divulgués
tactical	tactique
pilots	pilotes
expedition	expédition
operative	opératoire
humour	humour
mol	mol
imprint	imprimer
assisting	assistant
defect	défaut
poorly	pauvrement
goddess	déesse
observers	observateurs
magnets	aimants
formulas	formules
spacious	spacieux
argues	soutient
soils	sols
organs	organes
det	det
loyalty	fidélité
faithful	fidèle
offence	infraction
lithium	lithium
leap	saut
founding	fondation
swan	cygne
planting	plantation
covenant	engagement
archaeology	archéologie
sailor	marin
cares	soins
sanctuary	sanctuaire
statue	statue
quotation	citation
majors	majors
manipulation	manipulation
bells	cloches
toxicity	toxicité
transmitter	émetteur
neighborhoods	quartiers
trophy	trophée
emotion	émotion
sights	spectacles
uniforms	uniformes
wounded	blessés
derivative	dérivé
occupancy	occupation
doses	doses
educate	éduquer
prejudice	préjudice
technicians	techniciens
probable	probable
issuance	émission
decoration	décoration
nationals	ressortissants
trojan	troyen
assistants	assistants
counselor	conseiller
enacted	adopté
unstable	instable
urged	pressé
reflecting	reflétant
gaining	gagnant
definitive	définitive
traveled	voyagé
adapt	adapter
accession	accession
regulator	régulateur
fuels	carburants
soy	soja
neat	soigné
naming	appellation
stern	arrière
crafted	conçu
idiot	idiot
comprised	composé
aliens	extraterrestres
edits	modifications
raven	corbeau
dwelling	habitation
symbolic	symbolique
angles	angles
pressures	pressions
venus	Vénus
flames	flammes
primitive	primitif
stocking	stockage
ecosystem	écosystème
halls	salles
simplicity	simplicité
demon	démon
welcomed	accueilli
notation	notation
aunt	tante
crow	corbeau
semantic	sémantique
discontinued	abandonnées
decides	décide
globalization	mondialisation
asses	ânes
compass	boussole
evolved	évolué
infantry	infanterie
renowned	renommé
corridor	couloir
philosophical	philosophique
justification	justification
vacant	vacant
fixing	fixation
gram	gramme
hiding	cache
dye	colorant
alphabet	alphabet
cleaned	nettoyé
honored	honoré
optic	optique
telephones	téléphones
diaries	agendas
grief	douleur
sweat	transpiration
dolphin	dauphin
wonders	merveilles
ventilation	ventilation
masks	masques
bust	buste
alley	ruelle
pathways	voies
telegraph	télégraphe
monument	monument
formally	officiellement
dew	rosée
withdrawn	retiré
debates	débats
identities	identités
deficiency	carence
saddle	selle
malaria	paludisme
loyal	fidèle
tendency	tendance
utilized	utilisé
ein	ein
binoculars	jumelles
initiate	lancer
purely	purement
vivid	vif
allegations	allégations
corresponds	correspond
daemon	démon
celebrated	célèbre
hunters	chasseurs
acted	agi
coefficient	coefficient
skull	crâne
continuation	continuation
servant	serviteur
falcon	faucon
jointly	conjointement
avoided	éviter
explanations	explications
renewed	renouvelé
critic	critique
sediment	sédiment
squares	carrés
vans	fourgonnettes
cone	cône
survived	survécu
prevalence	prévalence
fragment	fragment
commits	engage
cobra	cobra
threw	jeta
hoc	hoc
performers	interprètes
dessert	dessert
dissertation	thèse
ninth	neuvième
enthusiasm	enthousiasme
celebrations	célébrations
governors	gouverneurs
atoms	atomes
tissues	tissus
ramp	rampe
nicely	bien
della	della
domination	domination
chords	accords
impairment	détérioration
molecule	molécule
