de	of
à	to
dans	in
pour	for
est	is
sur	on
cette	that
par	by
ce	this
avec	with
je	i
toi	you
il	it
ou	or
être	be
sont	are
à	at
tout	all
avoir	have
Nouveau	new
nous	we
volonté	will
maison	home
nous	us
sur	about
si	if
page	page
mon	my
a	has
chercher	search
gratuit	free
mais	but
notre	our
un	one
autre	other
faire	do
information	information
temps	time
il	he
lequel	which
leur	their
nouvelles	news
utilisation	use
Là	there
voir	see
alors	so
qui	who
toile	web
aussi	also
obtenir	get
pm	pm
vue	view
c	c
e	e
premier	first
été	been
aurait	would
étaient	were
s	s
comme	like
X	x
que	than
trouver	find
prix	price
arrière	back
Haut	top
gens	people
avait	had
liste	list
prénom	name
juste	just
an	year
journée	day
dans	into
deux	two
santé	health
n	n
ré	re
utilisé	used
aller	go
b	b
dernier	last
faire	make
leur	them
devrait	should
produit	product
système	system
poster	post
sa	her
ville	city
t	t
politique	policy
nombre	number
soutien	support
message	message
après	after
puis	then
jan	jan
bien	good
ré	d
où	where
Info	info
droits	rights
livres	books
haute	high
école	school
m	m
chaque	each
liens	links
elle	she
années	years
commande	order
très	very
livre	book
articles	items
compagnie	company
r	r
lis	read
groupe	group
sexe	sex
beaucoup	many
utilisateur	user
de	de
ensemble	set
général	general
recherche	research
Université	university
janvier	january
courrier	mail
plein	full
avis	reviews
programme	program
connaître	know
Jeux	games
façon	way
journées	days
p	p
partie	part
pourrait	could
génial	great
uni	united
réal	real
F	f
international	international
centre	center
Voyage	travel
commentaires	comments
fabriqué	made
développement	development
rapport	report
membre	member
détails	details
ligne	line
termes	terms
avant	before
hôtels	hotels
fait	did
envoyer	send
droite	right
type	type
local	local
ceux	those
résultats	results
Bureau	office
nationale	national
voiture	car
conception	design
prendre	take
posté	posted
adresse	address
communauté	community
dans	within
États	states
vouloir	want
téléphone	phone
DVD	dvd
assujettir	subject
entre	between
forum	forum
famille	family
l	l
longue	long
w	w
montrer	show
o	o
même	even
noir	black
spécial	special
indice	index
étant	being
femmes	women
beaucoup	much
signe	sign
fichier	file
lien	link
ouvrir	open
Sud	south
Cas	case
projet	project
pages	pages
version	version
section	section
posséder	own
maison	house
Sécurité	security
g	g
comté	county
américain	american
photo	photo
Jeu	game
membres	members
Puissance	power
réseau	network
ordinateur	computer
systèmes	systems
Trois	three
endroit	place
fin	end
h	h
lui	him
par	per
accès	access
pense	think
Nord	north
Ressources	resources
actuel	current
gros	big
médias	media
loi	law
contrôle	control
eau	water
histoire	history
Taille	size
personnel	personal
guider	guide
boutique	shop
annuaire	directory
changement	change
blanc	white
texte	text
petit	small
évaluation	rating
taux	rate
gouvernement	government
enfants	children
revenir	return
élèves	students
v	v
Compte	account
fois	times
niveau	level
numérique	digital
profil	profile
précédent	previous
forme	form
événements	events
amour	love
vieux	old
John	john
principale	main
appel	call
image	image
département	department
Titre	title
non	non
k	k
y	y
Assurance	insurance
doit	shall
propriété	property
classe	class
CD	cd
qualité	quality
chaque	every
inscription	listing
contenu	content
pays	country
peu	little
outils	tools
faible	low
répondre	reply
client	customer
décembre	december
comparer	compare
films	movies
Université	college
valeur	value
article	article
homme	man
emplois	jobs
j	j
aliments	food
auteur	author
différent	different
u	u
apprendre	learn
vente	sale
impression	print
cours	course
emploi	job
chambre	room
Stock	stock
entraînement	training
aussi	too
crédit	credit
point	point
science	science
Hommes	men
catégories	categories
Ouest	west
Regardez	look
Anglais	english
équipe	team
biens	estate
boîte	box
conditions	conditions
Photos	photos
gai	gay
fil	thread
Catégorie	category
Remarque	note
vivre	live
grand	large
Galerie	gallery
table	table
toutefois	however
juin	june
octobre	october
novembre	november
marché	market
bibliothèque	library
action	action
début	start
séries	series
fonctionnalités	features
air	air
industrie	industry
plan	plan
Humain	human
Oui	yes
seconde	second
chaud	hot
Coût	cost
film	movie
forums	forums
Mars	march
la	la
septembre	september
dire	say
Aller	going
médical	medical
ami	friend
déc	dec
serveur	server
application	application
Personnel	staff
jouer	play
problèmes	issues
avril	april
utilisateurs	users
rue	street
sujet	topic
contre	against
eu	got
Blog	blog
fête	party
Paiement	payment
équipement	equipment
laisser	let
programmes	programs
légal	legal
récent	recent
parc	park
acte	act
problème	problem
rouge	red
donner	give
Mémoire	memory
performance	performance
social	social
q	q
récit	story
vendre	sell
Options	options
expérience	experience
clé	key
corps	body
Jeune	young
important	important
champ	field
peu	few
est	east
unique	single
ii	ii
âge	age
club	club
Exemple	example
filles	girls
z	z
route	road
cadeau	gift
question	question
Californie	ca
difficile	hard
Payer	pay
quatre	four
poker	poker
problème	issue
gamme	range
bâtiment	building
vendeur	seller
tribunal	court
février	february
résultat	result
lumière	light
écrire	write
guerre	war
offre	offer
bleu	blue
groupes	groups
Al	al
facile	easy
donné	given
demande	request
fax	fax
Chine	china
fabrication	making
image	picture
Besoins	needs
possible	possible
mois	month
Majeur	major
étoile	star
avenir	future
espace	space
Comité	committee
main	hand
Soleil	sun
cartes	cards
Londres	london
réunion	meeting
devenir	become
enfant	child
garder	keep
porno	porn
partager	share
similaire	similar
jardin	garden
écoles	schools
million	million
ajoutée	added
référence	reference
entreprises	companies
bébé	baby
apprentissage	learning
énergie	energy
courir	run
livraison	delivery
populaire	popular
terme	term
film	film
histoires	stories
mettre	put
journal	journal
rapports	reports
co	co
essayer	try
images	images
remarquer	notice
Dieu	god
original	original
tête	head
radio	radio
cellule	cell
conseil	council
comprend	includes
Piste	track
discussion	discussion
archiver	archive
autres	others
accord	agreement
format	format
société	society
mois	months
sécurité	safety
copains	friends
sûr	sure
édition	edition
messages	messages
commercialisation	marketing
dire	tell
association	association
fournit	provides
amusement	fun
déjà	already
vert	green
études	studies
Fermer	close
commun	common
spécifique	specific
nombreuses	several
vivant	living
collection	collection
appelé	called
court	short
lettres	arts
lot	lot
demander	ask
limité	limited
solutions	solutions
réalisateur	director
plage	beach
passé	past
Naturel	natural
électronique	electronics
sur	upon
période	period
Planification	planning
dit	says
officiel	official
mar	mar
terminé	done
technique	technical
fenêtre	window
pro	pro
Région	region
île	island
record	record
direct	direct
conférence	conference
archives	records
st	st
district	district
calendrier	calendar
frais	costs
style	style
déclaration	statement
miles	miles
Ressource	resource
applications	applications
document	document
mot	word
travaux	works
Matériel	material
facture	bill
écrit	written
règles	rules
final	final
chose	thing
centre	centre
exigences	requirements
VRAI	TRUE
minutes	minutes
autre	else
marque	mark
Roche	rock
mal	bad
individuel	individual
plus	plus
auto	auto
couverture	cover
modifier	edit
ensemble	together
vidéos	videos
vite	fast
fonction	function
fait	fact
obtention	getting
global	global
technologie	tech
rencontrer	meet
loin	far
économique	economic
en	en
joueur	player
projets	projects
montant	amount
regarder	watch
inclus	included
ressentir	feel
banque	bank
risque	risk
offres	deals
divers	various
mots	words
production	production
commercial	commercial
poids	weight
cœur	heart
traitement	treatment
points	points
connaissance	knowledge
magazine	magazine
Erreur	error
caméra	camera
fille	girl
construction	construction
jouets	toys
inscrit	registered
domaine	domain
méthodes	methods
chapitre	chapter
protection	protection
politiques	policies
large	wide
beauté	beauty
directeur	manager
Inde	india
position	position
pris	taken
Trier	sort
annonces	listings
connu	known
moitié	half
cas	cases
étape	step
ingénierie	engineering
simple	simple
rapide	quick
Licence	license
Lac	lake
entier	whole
annuel	annual
publié	published
église	church
méthode	method
actif	active
réponse	response
figure	figure
matériaux	materials
assez	enough
conçu	designed
parmi	among
décès	death
perte	loss
visage	face
marque	brand
remise	discount
effets	effects
créé	created
normes	standards
bit	bit
politique	political
Royaume	kingdom
base	base
Faire	doing
prêts	loans
chaussures	shoes
entrée	entry
rester	stay
ordres	orders
disponibilité	availability
résumé	summary
tour	turn
croissance	growth
agence	agency
Roi	king
européen	european
activité	activity
copie	copy
occidental	western
Obliger	force
emploi	employment
baie	bay
rivière	river
commission	commission
paquet	package
vu	seen
joueurs	players
moteur	engine
Port	port
album	album
régional	regional
Arrêtez	stop
commencé	started
administration	administration
bar	bar
institut	institute
vues	views
double	double
chien	dog
bientôt	soon
lignes	lines
électronique	electronic
avantages	benefits
nécessaire	needed
imprimante	printer
condition	condition
efficace	effective
croyez	believe
organisation	organization
effet	effect
esprit	mind
sélection	selection
casino	casino
pdf	pdf
tour	tour
traverser	cross
espérer	hope
société	corporation
souhait	wish
Solution	solution
mature	mature
rôle	role
semaines	weeks
certain	certain
inférieur	lower
nécessaire	necessary
syndicat	union
lun	mon
com	com
particulier	particular
bien	fine
heure	hour
gaz	gas
compétences	skills
six	six
buisson	bush
îles	islands
Conseil	advice
carrière	career
décision	decision
laisser	leave
pré	pre
énorme	huge
femme	woman
installations	facilities
offre	bid
milieu	middle
câble	cable
Opportunités	opportunities
prise	taking
valeurs	values
division	division
arrivant	coming
objet	object
lesbienne	lesbian
approprié	appropriate
machine	machine
logo	logo
longueur	length
agréable	nice
But	score
statistiques	statistics
client	client
échantillon	sample
investissement	investment
envoyé	sent
montré	shown
Noël	christmas
Culture	culture
flash	flash
Mme	ms
choix	choice
cours	courses
consommateur	consumer
salut	hi
étranger	foreign
artiste	artist
meubles	furniture
canal	channel
lettre	letter
mode	mode
Téléphones	phones
idées	ideas
structure	structure
degré	degree
Contrat	contract
super	super
mâle	male
matière	matter
presque	almost
situé	located
plusieurs	multiple
Distribution	distribution
éditeur	editor
auberge	inn
industriel	industrial
potentiel	potential
chanson	song
los	los
tomber	fall
idée	idea
pièces	rooms
communications	communications
gagner	win
primaire	primary
cancer	cancer
Nombres	numbers
raison	reason
outil	tool
printemps	spring
fondation	foundation
répondre	answer
voix	voice
programme	schedule
documents	documents
objectif	purpose
fonctionnalité	feature
lit	bed
vient	comes
police	police
indépendant	independent
approche	approach
marron	brown
physique	physical
colline	hill
Plans	maps
tenir	hold
évaluations	ratings
content	happy
forgeron	smith
développé	developed
remercier	thank
sûr	safe
unique	unique
enquête	survey
avant	prior
Téléphone	telephone
sport	sport
prêt	ready
animal	animal
sources	sources
population	population
Pennsylvanie	pa
ordinaire	regular
garantir	secure
opérations	operations
simplement	simply
preuve	evidence
gare	station
comprendre	understand
option	option
vallée	valley
Probablement	probably
mer	sea
publications	publications
améliorer	improve
connexion	connection
éditeur	publisher
salle	hall
anti	anti
réseaux	networks
Terre	earth
Parents	parents
impact	impact
transfert	transfer
introduction	introduction
cuisine	kitchen
fort	strong
mariage	wedding
Propriétés	properties
hôpital	hospital
sol	ground
navire	ship
hébergement	accommodation
maladie	disease
excellent	excellent
parfait	perfect
cheveux	hair
opportunité	opportunity
trousse	kit
classique	classic
base	basis
commander	command
villes	cities
Express	express
prix	award
distance	distance
arbre	tree
évaluation	assessment
mur	wall
impliqué	involved
el	el
supplémentaire	extra
notamment	especially
budget	budget
guides	guides
Succès	success
maximum	maximum
mère	ma
opération	operation
existant	existing
assez	quite
choisi	selected
garçon	boy
Restaurants	restaurants
beau	beautiful
Attention	warning
Emplacements	locations
cheval	horse
vote	vote
fleurs	flowers
étoiles	stars
listes	lists
propriétaire	owner
animaux	animals
façons	ways
fils	son
fournir	providing
règle	rule
logement	housing
prend	takes
apporter	bring
catalogue	catalog
max	max
mère	mother
autorité	authority
Raconté	told
programme	programme
relié	joined
contribution	input
stratégie	strategy
pieds	feet
agent	agent
valide	valid
moderne	modern
Sénior	senior
sexy	sexy
enseignement	teaching
porte	door
grandiose	grand
procès	trial
unités	units
cool	cool
Ordinaire	normal
entreprise	enterprise
navires	ships
tout	entire
positif	positive
aptitude	fitness
chinois	chinese
opinion	opinion
Football	football
abstrait	abstract
sortie	output
fonds	funds
M	mr
probable	likely
développer	develop
artistes	artists
alternative	alternative
responsabilité	responsibility
Java	java
client	guest
publication	publication
passer	pass
rapports	relations
confiance	trust
van	van
contient	contains
multi	multi
république	republic
honoraires	fees
Composants	components
vacances	vacation
siècle	century
académique	academic
assistance	assistance
terminé	completed
peau	skin
graphique	graphics
Indien	indian
bague	ring
qualité	grade
Montagne	mountain
organisations	organizations
filtre	filter
panneau	panel
sol	floor
achat	buying
rencontre	match
proposé	proposed
exiger	require
garçons	boys
Matin	morning
permet	allows
protéine	protein
plante	plant
signalé	reported
frappé	hit
mm	mm
bassin	pool
mini	mini
politique	politics
partenaire	partner
auteurs	authors
planches	boards
poisson	fish
adhésion	membership
mission	mission
œil	eye
chaîne	string
sens	sense
modifié	modified
libéré	released
étape	stage
interne	internal
née	born
détaillé	detailed
Japonais	japanese
course	race
approuvé	approved
cible	target
sauf	except
personnage	character
entretien	maintenance
aptitude	ability
ed	ed
râpé	rape
batterie	battery
jeunesse	youth
pression	pressure
soumis	submitted
dette	debt
moyen	medium
télévision	television
intéressé	interested
coeur	core
Pause	break
fins	purposes
ensembles	sets
Danse	dance
bois	wood
défini	defined
papiers	papers
prix	awards
frais	fee
studio	studio
lecteur	reader
dispositif	device
établi	established
réponses	answers
location	rent
Las	las
foncé	dark
externe	external
Pomme	apple
le	le
instructions	instructions
min	min
offert	offered
théorie	theory
retirer	remove
aide	aid
visuel	visual
hôte	host
variété	variety
enseignants	teachers
Manuel	manual
bloc	block
sujets	subjects
agents	agents
réparation	repair
juste	fair
acier	steel
compréhension	understanding
Chansons	songs
fixé	fixed
faux	wrong
début	beginning
mains	hands
az	az
Paris	paris
obtient	gets
secteur	sector
capacité	capacity
ONU	un
graisse	fat
père	father
électrique	electric
vu	saw
instruments	instruments
officier	officer
chauffeur	driver
entreprises	businesses
mort	dead
inconnu	unknown
restaurant	restaurant
Mike	mike
voyage	trip
mi	mi
pauvre	poor
relation	relationship
ouvriers	workers
paix	peace
traditionnel	traditional
projection	showing
Créatif	creative
côte	coast
avantage	benefit
financement	funding
dispositifs	devices
Seigneur	lord
subvention	grant
sous	sub
fiction	fiction
montres	watches
carrières	careers
va	goes
LED	led
musée	museum
ventilateur	fan
transport	transport
intéressant	interesting
blogs	blogs
évaluation	evaluation
ancien	former
zone	zone
complexe	complex
e	th
chat	cat
mourir	die
présenté	presented
appartement	flat
couler	flow
agences	agencies
Littérature	literature
parent	parent
réglage	setting
dr	dr
échelle	scale
économie	economy
utile	helpful
mensuel	monthly
critique	critical
Cadre	frame
musical	musical
définition	definition
secrétaire	secretary
chemin	path
chef	chief
donne	gives
paquets	packages
détail	detail
lois	laws
modifié	changed
commencer	begin
Royal	royal
nettoyer	clean
gars	guy
titres	titles
pertinent	relevant
Justice	justice
relier	connect
Coupe	cup
panier	basket
appliqué	applied
hebdomadaire	weekly
vol	vol
installation	installation
pp	pp
attention	attention
avance	advance
sauter	skip
régime	diet
armée	army
équipement	gear
différence	difference
permis	allowed
correct	correct
nation	nation
vente	selling
beaucoup	lots
pièce	piece
drap	sheet
raffermir	firm
Sept	seven
éléments	elements
espèce	species
saut	jump
cellules	cells
module	module
recours	resort
certificat	certificate
ministre	minister
mouvement	motion
mode	fashion
directions	directions
visiteurs	visitors
Documentation	documentation
commerce	trading
forêt	forest
appels	calls
couverture	coverage
couple	couple
donnant	giving
chance	chance
vision	vision
ballon	ball
fin	ending
clients	clients
actes	actions
discuter	discuss
objectif	goal
réussi	successful
vendu	sold
vent	wind
communautés	communities
clinique	clinical
situation	situation
marchés	markets
édition	publishing
apparaître	appear
développement	developing
vies	lives
déterminer	determine
Température	temperature
annonces	announcements
patient	patient
réel	actual
historique	historical
pierre	stone
bob	bob
Commerce	commerce
personnes	persons
difficile	difficult
scientifique	scientific
Satellite	satellite
essais	tests
village	village
comptes	accounts
amateur	amateur
ex	ex
rencontré	met
douleur	pain
facteurs	factors
café	coffee
acheteur	buyer
affiche	poster
bord	edge
fonctionnel	functional
racine	root
Fi	fi
fermé	closed
vacances	holidays
rose	pink
équilibre	balance
surveillance	monitoring
réponses	replies
coup	shot
initiale	initial
étiquette	label
seconde	sec
canon	canon
ligue	league
déchets	waste
minute	minute
autobus	bus
fournisseur	provider
dictionnaire	dictionary
comptabilité	accounting
fabrication	manufacturing
sections	sections
chaise	chair
effort	effort
phase	phase
fantaisie	fantasy
po	po
Virginie	va
professeur	professor
installer	install
chemise	shirt
vêtements	apparel
pied	foot
Sein	breast
techniques	techniques
dollars	dollars
religion	religion
autorisation	permission
sauvage	wild
génération	generation
manquer	miss
chimique	chemical
docteur	doctor
tâche	task
réduire	reduce
apporté	brought
exercice	exercise
punaise	bug
garantie	guarantee
chef	leader
se	se
processus	processes
doux	soft
réunions	meetings
secondes	seconds
vol	flight
congrès	congress
carburant	fuel
marche	walk
produit	produced
Saint	saint
argument	argument
compétition	competition
drogues	drugs
mixte	joint
prime	premium
Frais	fresh
personnages	characters
avocat	attorney
di	di
facteur	factor
milliers	thousands
km	km
courant	stream
appartements	apartments
choisir	pick
audition	hearing
est	eastern
thérapie	therapy
entrées	entries
signé	signed
administratif	administrative
sérieux	serious
limite	limit
pas	steps
magasins	shops
esclavage	bondage
del	del
efforts	efforts
informé	informed
Géorgie	ga
pensées	thoughts
ruisseau	creek
ft	ft
quantité	quantity
essentiel	essential
Tours	tours
charge	load
immédiatement	immediately
Machines	machines
désigné	designated
lourd	heavy
couvert	covered
récupération	recovery
intégré	integrated
configuration	configuration
coq	cock
marchande	merchant
complet	comprehensive
expert	expert
protéger	protect
solide	solid
présentation	presentation
devenu	became
Orange	orange
conformité	compliance
thème	theme
riches	rich
campagne	campaign
contre	vs
guitare	guitar
découverte	finding
exemples	examples
esprit	spirit
ar	ar
réclamations	claims
acceptation	acceptance
stratégies	strategies
mo	mo
affaires	affairs
prévu	intended
sa	sa
buts	goals
louer	hire
élection	election
suggérer	suggest
branche	branch
servir	serve
affiliés	affiliates
monter	mount
Latin	latin
multimédia	multimedia
gérer	manage
coin	corner
rang	rank
élément	element
naissance	birth
virus	virus
interactif	interactive
demandes	requests
séparé	separate
trimestre	quarter
procédure	procedure
direction	leadership
définir	define
religieux	religious
faits	facts
déjeuner	breakfast
colonne	column
Foi	faith
chaîne	chain
identifier	identify
rue	avenue
disparu	missing
recommandations	recommendations
déplacé	moved
atteindre	reach
Comparaison	comparison
moment	moment
élargi	extended
séquence	sequence
pouce	inch
attaque	attack
centres	centers
ouverture	opening
laboratoire	lab
réserve	reserve
gamma	gamma
produire	produce
vérité	truth
compteur	counter
échec	failure
suit	follows
dollar	dollar
camp	camp
des	des
films	films
pont	bridge
remplir	fill
mouvement	movement
impression	printing
Brouillon	draft
graphique	chart
joué	played
Contacts	contacts
lecteurs	readers
clubs	clubs
Washington	wa
aventure	adventure
offre	offering
profit	profit
dirigeants	leaders
affiches	posters
institutions	institutions
assistant	assistant
variable	variable
dj	dj
parking	parking
hier	yesterday
déterminé	determined
atelier	workshop
disparu	gone
codes	codes
types	kinds
extension	extension
déclarations	statements
complètement	completely
équipes	teams
fort	fort
cm	cm
sénat	senate
drôle	funny
gène	gene
tourné	turned
disque	disc
modèle	pattern
bateau	boat
théâtre	theatre
fabricants	manufacturers
parrainer	sponsor
classique	classical
icône	icon
garantie	warranty
dévoué	dedicated
direction	direction
basketball	basketball
objets	objects
effacer	delete
soir	evening
Assemblée	assembly
nucléaire	nuclear
Souris	mouse
signal	signal
criminel	criminal
Publié	issued
puissant	powerful
rêver	dream
FAUX	FALSE
da	da
jeter	cast
fleur	flower
personnel	personnel
passé	passed
fourni	supplied
chutes	falls
âme	soul
promouvoir	promote
déclaré	stated
Statistiques	stats
professionnels	professionals
apparaît	appears
porter	carry
drapeau	flag
couvertures	covers
em	em
avantage	advantage
Bonjour	hello
dessins	designs
maintenir	maintain
tourisme	tourism
priorité	priority
adultes	adults
graphique	graphic
atome	atom
Paiements	payments
contraignant	binding
bref	brief
terminé	ended
gagnant	winning
anonyme	anonymous
scénario	script
servi	served
veut	wants
préparé	prepared
vide	void
marque	tag
entretien	interview
mélanger	mix
cadre	framework
disque	disk
installée	installed
reine	queen
crédits	credits
clairement	clearly
réparer	fix
manipuler	handle
doux	sweet
Critères	criteria
associer	associate
ne	ne
comportement	behavior
agrandir	enlarge
rayon	ray
revenu	revenue
mesure	measure
votes	votes
du	du
devoir	duty
discussions	discussions
ours	bear
Gain	gain
Festival	festival
laboratoire	laboratory
océan	ocean
vols	flights
experts	experts
signes	signs
profondeur	depth
train	train
sec	dry
explorer	explore
spa	spa
concept	concept
presque	nearly
manipulation	handling
origine	origin
milliard	billion
intelligence	intelligence
acheté	bought
escroquerie	con
nations	nations
route	route
cassé	broken
bataille	battle
parler	speak
protocole	protocol
question	query
Partenariat	partnership
expression	expression
es	es
discours	speech
câble	wire
suggestions	suggestions
remplacement	replacement
ruban	tape
stratégique	strategic
juge	judge
acide	acid
octets	bytes
cent	cent
forcé	forced
compatible	compatible
appartement	apartment
nul	null
zéro	zero
orateur	speaker
consultant	consulting
designer	designer
pr	pr
mariage	marriage
rouleau	roll
banques	banks
fr	fr
participants	participants
secret	secret
négatif	negative
favoris	favorites
théâtre	theater
ressorts	springs
var	var
effectuer	perform
Traduction	translation
estimations	estimates
blessure	injury
ministère	ministry
conducteurs	drivers
avocat	lawyer
chiffres	figures
protégé	protected
proposition	proposal
partage	sharing
portail	portal
bêta	beta
gratuitement	gratis
vers	toward
légèrement	slightly
aider	assist
conduite	conduct
contenu	contained
législation	legislation
appel	calling
paramètres	parameters
profils	profiles
questions	matters
Maisons	houses
contrôles	controls
combiné	combined
ultime	ultimate
représentant	representative
mineur	minor
départements	departments
résidents	residents
affiché	displayed
maman	mom
réduit	reduced
rare	rare
réalisée	performed
extrême	extreme
échantillons	samples
barres	bars
prévoir	forecast
supprimé	removed
cycle	cycle
contenir	contain
précision	accuracy
dormir	sleep
mg	mg
oiseau	bird
pharmacie	pharmacy
création	creation
statique	static
chasseur	hunter
adresses	addresses
Dame	lady
cristal	crystal
célèbre	famous
écrivain	writer
président	chairman
boisson	drink
académie	academy
dynamique	dynamic
manger	eat
permanent	permanent
nettoyage	cleaning
constitue	constitutes
portefeuille	portfolio
pratique	practical
livré	delivered
Infrastructure	infrastructure
Couleur	colour
vendeur	vendor
philosophie	philosophy
règlement	regulation
officiers	officers
objectif	aim
offres	bids
nutrition	nutrition
enregistrement	recording
junior	junior
les	les
cap	cape
anneaux	rings
pointe	tip
formidable	wonderful
billet	ticket
annoncé	announced
deviner	guess
qui	whom
football	soccer
math	math
importer	import
affectation	posting
présence	presence
automatique	automatic
visualisation	viewing
entretenu	maintained
ch	ch
dan	dan
chiens	dogs
directeurs	directors
aspects	aspects
devant	ahead
lune	moon
participation	participation
schème	scheme
mouche	fly
manière	manner
matrice	matrix
combinaison	combination
amendement	amendment
force	strength
dinde	turkey
bibliothèques	libraries
correct	proper
degrés	degrees
entreprises	enterprises
delta	delta
peur	fear
recherche	seeking
pouces	inches
convention	convention
actions	shares
principal	principal
confort	comfort
couleurs	colors
guerres	wars
commande	ordering
conservé	kept
alpha	alpha
charme	appeal
croisière	cruise
prime	bonus
Hey	hey
bâtiments	buildings
promos	specials
battre	beat
batteries	batteries
devient	becomes
disques	drives
bras	arms
thé	tea
amélioré	improved
atteindre	achieve
positions	positions
robe	dress
abonnement	subscription
Marchand	dealer
contemporain	contemporary
ciel	sky
ROM	rom
porté	carried
exposition	exposure
cacher	hide
Signature	signature
meunier	miller
disposition	provision
vêtements	clothes
cadres	frames
certainement	certainly
journal	newspaper
jouet	toy
couche	layer
imprimé	printed
lent	slow
suppression	removal
responsabilité	liability
imprimantes	printers
ajouter	adding
place	spot
dépenser	spend
usine	factory
intérieur	interior
croître	grow
optique	optical
promotion	promotion
relatif	relative
incroyable	amazing
point	dot
identité	identity
conversion	conversion
sentiment	feeling
caché	hidden
raisonnable	reasonable
révision	revision
influence	influence
rapport	ratio
importance	importance
pluie	rain
planète	planet
copies	copies
permis	permit
voyant	seeing
preuve	proof
basse	bass
ordonnance	prescription
vide	empty
exemple	instance
trou	hole
balade	ride
bureau	bureau
préservation	conservation
paire	pair
idéal	ideal
spécification	specs
enregistré	recorded
Don	don
pièces	pieces
fini	finished
parcs	parks
avocats	lawyers
stress	stress
crème	cream
ss	ss
fonctionne	runs
découvrir	discover
ap	ap
modèles	patterns
collines	hills
nm	nm
conseiller	advisor
conscient	aware
forme	shape
évolution	evolution
certificats	certificates
objectifs	objectives
stations	stations
suggéré	suggested
op	op
restes	remains
entreprises	firms
euro	euro
opérateur	operator
structures	structures
générique	generic
encyclopédie	encyclopedia
usage	usage
encre	ink
mixte	mixed
recensement	census
roue	wheel
Fournisseurs	suppliers
compact	compact
poésie	poetry
lumières	lights
suivi	tracking
ange	angel
préparation	preparation
tentative	attempt
recevoir	receiving
allumettes	matches
conformité	accordance
largeur	width
moteurs	engines
oublier	forget
tableau	array
discuté	discussed
précis	accurate
climat	climate
grec	greek
instruction	instruction
gérant	managing
brut	raw
différences	differences
Explique	explain
établir	establish
exprimé	expressed
ampleur	extent
tranchant	sharp
ben	ben
paragraphe	paragraph
tuer	kill
mathématiques	mathematics
compensation	compensation
exportation	export
gestionnaires	managers
modules	modules
menée	conducted
versions	versions
sait	knows
décrire	describe
citoyens	citizens
patrimoine	heritage
difficulté	trouble
entraîneur	coach
agricole	agricultural
développer	expand
public	audience
attribué	assigned
collections	collections
âge	ages
spécialiste	specialist
cuisinier	cook
affecter	affect
vierge	virgin
expérimenté	experienced
enquête	investigation
relevé	raised
chapeau	hat
institution	institution
dirigée	directed
affecté	affected
bicyclette	bike
totalement	totally
assiette	plate
frais	expenses
indiquer	indicate
blond	blonde
procédure	proceedings
préféré	favourite
caractéristiques	characteristics
der	der
perdre	lose
biologique	organic
chercher	seek
expériences	experiences
albums	albums
contrats	contracts
invités	guests
hébergé	hosted
maladies	diseases
concernant	concerning
équivalent	equivalent
chimie	chemistry
kits	kits
logique	logic
prince	prince
cercle	circle
sol	soil
psychologie	psychology
humide	wet
conditions	circumstances
investisseur	investor
élémentaire	elementary
sponsors	sponsors
Renard	fox
illimité	unlimited
répondre	respond
tailles	sizes
plaine	plain
Sortie	exit
bras	arm
clés	keys
vague	wave
saint	holy
actes	acts
orientation	guidance
Piste	trail
symbole	symbol
Autoroute	highway
observé	observed
doyen	dean
installer	setup
sondage	poll
modes	styles
rempli	filled
liaison	bond
filières	channels
annexe	appendix
Chocolat	chocolate
portion	portion
portée	scope
fournisseur	supplier
câbles	cables
coton	cotton
exigence	requirement
tué	killed
frontière	border
ancien	ancient
débat	debate
représentants	representatives
départs	starts
grossesse	pregnancy
attractions	attractions
appris	learned
transactions	transactions
explorateur	explorer
historique	historic
mari	husband
autorisé	authorized
fou	crazy
prochain	upcoming
concert	concert
scores	scores
Efficacité	efficiency
comédie	comedy
adopté	adopted
efficace	efficient
linéaire	linear
engagement	commitment
spécialité	specialty
ours	bears
saut	hop
transporteur	carrier
constant	constant
visa	visa
bouche	mouth
mètre	meter
lié	linked
interviews	interviews
concepts	concepts
pistolet	gun
réfléchir	reflect
pur	pure
enfer	hell
fruit	fruit
commence	begins
qualifié	qualified
réforme	reform
lentille	lens
traités	treated
Découverte	discovery
dessiner	draw
classifié	classified
assumer	assume
Alliance	alliance
confirmer	confirm
ingénieur	engineer
cohérent	consistent
remplacer	replace
dégagement	clearance
convertisseur	converter
organisation	organisation
bébé	babe
chèques	checks
atteint	reached
devenir	becoming
objectif	objective
indiqué	indicated
sucre	sugar
équipage	crew
jambes	legs
bâton	stick
relation	relation
activée	enabled
genre	genre
bénévole	volunteer
arrière	rear
démocratique	democratic
améliorer	enhance
exact	exact
lié	bound
paramètre	parameter
processeur	processor
nœud	node
formel	formal
orage	storm
micro	micro
collèges	colleges
mile	mile
défis	challenges
éditeurs	editors
suprême	supreme
frères	brothers
reconnaissance	recognition
ref	ref
estimation	estimate
enfant	kid
inspection	inspection
consommateurs	consumers
limites	limits
territoire	territory
armes	weapons
retard	delay
pilote	pilot
contributions	contributions
continu	continuous
initiative	initiative
roman	novel
exécution	execution
invalidité	disability
ultra	ultra
gagnant	winner
épisode	episode
potier	potter
plat	dish
pièces	plays
bulletin	bulletin
ia	ia
modifier	modify
vraiment	truly
univers	universe
candidat	candidate
fente	slot
exceptionnel	outstanding
Ha	ha
prévu	planned
loge	lodge
miroir	mirror
tournoi	tournament
considération	consideration
sessions	sessions
noyau	kernel
acheteurs	buyers
revues	journals
gris	gray
catalogue	catalogue
accusé	charged
vaste	broad
und	und
choisi	chosen
demo	demo
haine	hate
Terminal	terminal
éditeurs	publishers
nuits	nights
liquide	liquid
riz	rice
réservation	reservation
nourriture	foods
garde	guard
économie	saving
Empire	empire
nouvellement	newly
élever	raise
illégal	illegal
expansion	expansion
premier	premier
demain	tomorrow
Lait	milk
drame	drama
visite	visiting
concours	contest
collectées	collected
bandes	bands
adapté	suitable
absolument	absolutely
vérification	audit
chambre	chamber
Guinée	guinea
résultats	findings
iso	iso
typique	typical
somme	sum
poulet	chicken
temporaire	temporary
assister	attend
douche	shower
envoi	sending
suffisant	sufficient
coquille	shell
Province	province
catholique	catholic
gouverneur	governor
Bière	beer
contribution	contribution
formule	formula
Constitution	constitution
emballage	packaging
fiable	reliable
doute	doubt
gagner	earn
périodes	periods
attaques	attacks
marchandise	merchandise
symptômes	symptoms
Mémorial	memorial
double	twin
insérer	insert
passerelle	gateway
dessin	drawing
candidats	candidates
commandé	ordered
biologique	biological
combat	fighting
transition	transition
préférences	preferences
espion	spy
romance	romance
instrument	instrument
Divisé	split
thèmes	themes
pouvoirs	powers
paradis	heaven
morceaux	bits
Enceinte	pregnant
classification	classification
concentré	focused
médecin	physician
demander	asking
blocs	blocks
lo	lo
spirituel	spiritual
Diabète	diabetes
ml	ml
décalage	shift
asseoir	sit
corps	bodies
photographies	photographs
Coupe	cutting
écrivains	writers
flexible	flexible
aimé	loved
favoris	favourites
cartographie	mapping
nombreux	numerous
relativement	relatively
représente	represents
supérieur	superior
préféré	preferred
enregistré	saved
intellectuel	intellectual
accordé	granted
carbone	carbon
confortable	comfortable
magnétique	magnetic
interaction	interaction
écoute	listening
crise	crisis
perspective	outlook
massif	massive
brillant	bright
formé	formed
piano	piano
écho	echo
révolution	revolution
affiche	displays
plasma	plasma
gains	earnings
mystère	mystery
paysage	landscape
mécanique	mechanical
périple	journey
bannière	banner
figue	fig
comtés	counties
acquisition	acquisition
reconnu	recognized
rêves	dreams
notification	notification
kg	kg
apprendre	teach
rapide	rapid
tirer	pull
Utah	ut
séminaire	seminar
investissements	investments
roues	wheels
spécifier	specify
sensible	sensitive
modèles	templates
formats	formats
détient	holds
routeur	router
béton	concrete
si	si
dossier	folder
achèvement	completion
impulsion	pulse
technique	technique
vote	voting
tribunaux	courts
converti	converted
métro	metro
anniversaire	anniversary
améliorations	improvements
bande	strip
spécification	specification
accident	accident
entaille	nick
accessible	accessible
résident	resident
terrain	plot
typiquement	typically
représentation	representation
pompe	pump
existe	exists
arrangements	arrangements
conférences	conferences
consommation	consumption
étroit	narrow
menace	threat
enquêtes	surveys
séance	sitting
consultant	consultant
manette	controller
comités	committees
pénis	penis
Château	castle
jardins	gardens
Étiquettes	labels
prêt	willing
bio	bio
agissant	acting
têtes	heads
examen	exam
résidence	residence
densité	density
cent	hundred
étrange	strange
durable	sustainable
statistique	statistical
mention	mention
innovation	innovation
gris	grey
parallèle	parallel
fonctionner	operate
factures	bills
stable	stable
définitions	definitions
von	von
médecins	doctors
leçon	lesson
cinéma	cinema
élections	elections
réaction	reaction
blanc	blank
renforcée	enhanced
intitulé	entitled
sévère	severe
produire	generate
journaux	newspapers
hôpitaux	hospitals
vi	vi
humour	humor
vieilli	aged
moniteurs	monitors
exception	exception
durée	duration
masse	bulk
visites	visits
capacités	capabilities
recommandation	recommendation
péché	sin
organisé	organized
ba	ba
para	para
adoption	adoption
améliorer	improving
coûteux	expensive
buffle	buffalo
organisations	organisations
avion	plane
programmes	programmes
mécanisme	mechanism
ee	ee
marqué	marked
poussé	driven
bouteille	bottle
innovant	innovative
massage	massage
conclusion	conclusion
fermeture	closing
mille	thousand
Légende	legend
villa	villa
OS	bone
colonnes	columns
troubles	disorders
collaboration	collaboration
détection	detection
interne	inner
formation	formation
med	med
ingénieurs	engineers
entité	entity
Croisières	cruises
porte	gate
romain	roman
fonctions	duties
érotique	erotic
Ton	tone
éthique	ethics
dragon	dragon
occupé	busy
capitaine	captain
apporte	brings
chauffage	heating
jambe	leg
cou	neck
aile	wing
scripts	scripts
abc	abc
nommé	appointed
transaction	dealing
commettre	commit
rail	rail
voyages	trips
écart	gap
côtés	sides
tube	tube
correspondant	corresponding
descriptions	descriptions
ceinture	belt
veste	jacket
animation	animation
oracle	oracle
er	er
productions	productions
aviation	aviation
fier	proud
catastrophe	disaster
console	console
commandes	commands
jr	jr
télécommunications	telecommunications
instructeur	instructor
géant	giant
réalisé	achieved
blessures	injuries
approches	approaches
habituel	usual
timbres	stamps
angle	angle
Rob	rob
concepteurs	designers
liberté	liberty
ère	era
convertir	convert
possibilité	possibility
analyste	analyst
dangereux	dangerous
fiabilité	reliability
respectivement	respectively
bénévoles	volunteers
dérivé	derived
plaisir	pleasure
honneur	honor
orienté	oriented
Aigle	eagle
prière	prayer
ateliers	workshops
ouragan	hurricane
silencieux	quiet
producteur	producer
représentée	represented
responsabilités	responsibilities
fromage	cheese
soigneusement	carefully
productivité	productivity
couronne	crown
par	par
diagnostic	diagnosis
fabricant	maker
fissure	crack
principe	principle
choix	picks
gang	gang
fétiche	fetish
apparence	appearance
fumée	smoke
filtres	filters
incorporé	incorporated
artisanat	craft
compagnon	fellow
aveugle	blind
salon	lounge
furieux	mad
algorithme	algorithm
fortement	strongly
café	cafe
ken	ken
protéines	proteins
su	su
familier	familiar
capable	capable
admission	admission
chaussure	shoe
élu	elected
portant	carrying
terrorisme	terrorism
joie	joy
éditions	editions
ethnique	ethnic
parlement	parliament
acteur	actor
découvertes	finds
joint	seal
situations	situations
cinquième	fifth
citoyen	citizen
verticale	vertical
corrections	corrections
décrit	describes
handicapées	disabilities
substance	substance
interdit	prohibited
tuyau	pipe
soldats	soldiers
Gardien	guardian
conférence	lecture
simulation	simulation
disposition	layout
initiatives	initiatives
mauvais	ill
concentration	concentration
allonger	lay
interprétation	interpretation
sale	dirty
enseigné	taught
ouvrier	worker
optimisation	optimization
temple	temple
substances	substances
prouver	prove
découvert	discovered
ailes	wings
génétique	genetic
restrictions	restrictions
mince	thin
exposition	exhibition
crête	ridge
modem	modem
apportant	bringing
malade	sick
évaluer	evaluate
tropical	tropical
collecte	collect
vecteur	vector
absolument	definitely
tournant	turning
existence	existence
commentaire	commentary
développements	developments
immigration	immigration
destinations	destinations
mutuel	mutual
syntaxe	syntax
li	li
attribut	attribute
prison	prison
compétence	skill
chaises	chairs
alentours	surrounding
montagnes	mountains
popularité	popularity
enquête	inquiry
vérifié	checked
exposition	exhibit
jeter	throw
tendance	trend
chats	cats
désert	desert
ya	ya
coordinateur	coordinator
Mercure	mercury
brûlant	burning
échapper	escape
destinataire	receiver
progressive	progressive
bateaux	boats
championnat	championship
arcade	arcade
impossible	impossible
dit	tells
évident	obvious
dépression	depression
graphique	graph
couvrant	covering
platine	platinum
jugement	judgment
pourparlers	talks
dépôt	filing
favoriser	foster
décerné	awarded
essais	trials
maîtrise	masters
cartouche	cartridge
explication	explanation
org	org
fraude	fraud
électricité	electricity
spectre	spectrum
arrivée	arrival
poterie	pottery
accentuation	emphasis
impressionnant	awesome
confirmé	confirmed
compte	counts
crash	crash
ascenseur	lift
entre	inter
hauteurs	heights
ombre	shadow
frais	expense
entreprise	venture
clinique	clinic
guérison	healing
Princesse	princess
entrer	entering
paquet	packet
studios	studios
participation	involvement
papa	dad
boutons	buttons
placement	placement
observations	observations
gagnants	winners
routes	roads
subséquent	subsequent
Cour	yard
divulgation	disclosure
établissement	establishment
souvenirs	memories
te	te
crée	creates
visages	faces
touristique	tourist
meurtre	murder
adéquat	adequate
sénateur	senator
présentations	presentations
digérer	digest
poussière	dust
wiki	wiki
remplacé	replaced
radar	radar
pertes	losses
combat	combat
réduire	reducing
arrêté	stopped
Occupation	occupation
étroitement	closely
radiation	radiation
rois	kings
tournage	shooting
oreille	ear
drapeaux	flags
boulanger	baker
conservateur	conservative
choc	shock
efficacité	effectiveness
attacher	tie
toit	roof
démontrer	demonstrate
atmosphère	atmosphere
baiser	kiss
bête	beast
ra	ra
exploité	operated
expérience	experiment
cibles	targets
achats	purchases
fédération	federation
Pizza	pizza
invité	invited
affectation	assignment
mod	mod
requêtes	queries
absence	absence
vendeurs	vendors
yoga	yoga
sert	serves
surprise	surprise
lampe	lamp
blagues	jokes
conseils	counseling
palais	palace
satisfait	satisfied
victoires	wins
entrepôt	warehouse
supposé	supposed
ordinaire	ordinary
fantôme	ghost
violation	violation
patron	boss
fierté	pride
attentes	expectations
indépendance	independence
connaissance	knowing
journaliste	reporter
métabolisme	metabolism
champion	champion
personnellement	personally
beaucoup	plenty
solo	solo
gorge	throat
richesse	wealth
vide	vacuum
dansant	dancing
reconnaître	recognize
écrit	writes
place	plaza
quête	quest
publier	publish
dépistage	screening
trans	trans
pionnier	pioneer
oublié	forgotten
acrobate	acrobat
plaques	plates
essais	essays
comportement	behaviour
récit	telling
équitablement	fairly
intelligent	intelligent
modes	modes
obligation	obligation
port	harbor
voyageur	traveler
segment	segment
ennemi	enemy
puzzle	puzzle
puits	wells
limité	restricted
républicain	republican
secrets	secrets
syndrome	syndrome
présence	attendance
peine	penalty
tambour	drum
permet	enables
constructeur	builder
vue	vista
inonder	flood
facilité	ease
arguments	arguments
arène	arena
aventures	adventures
élèves	pupils
annonce	announcement
résultat	outcome
apprécier	appreciate
étendu	expanded
mûr	grown
charmant	lovely
centres	centres
clause	clause
sourire	smile
terres	lands
troupes	troops
armé	armed
pin	pine
refroidissement	cooling
golfe	gulf
camions	trucks
mécanismes	mechanisms
divorce	divorce
tradition	tradition
pilules	pills
tigre	tiger
gens	folks
capteur	sensor
exposé	exposed
chasse	hunt
anges	angels
adjoint	deputy
thaïlandais	thai
émissions	emissions
médecins	physicians
plainte	complaint
scènes	scenes
expériences	experiments
renforcer	boost
gouvernance	governance
moulin	mill
fondé	founded
chronique	chronic
tanière	den
doigt	finger
garde	keeps
livre	pound
Localiser	locate
PL	pl
qualifié	trained
exécution	implementing
pain	bread
moteurs	motors
dure	tough
incident	incident
dynamique	dynamics
mensonge	lie
conversation	conversation
diminution	decrease
culte	worship
aptitude	capability
Alaska	ak
précision	precision
dégâts	damages
réserves	reserves
résoudre	solve
minorité	minority
diverse	diverse
Ingrédients	ingredients
ah	ah
tons	tones
réhabilitation	rehabilitation
vue	sight
argile	clay
faible	weak
divisé	divided
accueil	reception
sage	wise
chances	odds
séminaires	seminars
conséquences	consequences
décideurs	makers
géographie	geography
intégrité	integrity
héritage	legacy
heureux	pleased
danger	danger
vitamine	vitamin
traité	processed
phrase	phrase
élevage	raising
implications	implications
fonctionnalité	functionality
paradis	paradise
hybride	hybrid
lit	reads
émotif	emotional
gloire	glory
ja	ja
géographique	geographic
dépasser	exceed
barre	rod
soie	silk
bébés	babies
bi	bi
romantique	romantic
révélé	revealed
spécialistes	specialists
Générateur	generator
suspension	suspension
triste	sad
correction	correction
Loup	wolf
lentement	slowly
supplément	supplement
portions	portions
bébé	infant
secteurs	sectors
fluide	fluid
terrains	grounds
repas	meal
ta	ta
machinerie	machinery
équation	equation
paniers	baskets
probabilité	probability
dimension	dimension
étudié	studied
bénéfices	profits
diable	devil
herbe	grass
illustré	illustrated
Cerise	cherry
continental	continental
réussite	achievement
limites	limitations
funérailles	funeral
chapitres	chapters
passager	passenger
pratique	convenient
Mars	mars
taille	sized
Oeuf	egg
signaux	signals
orientation	orientation
vol	theft
enfance	childhood
symboles	symbols
lat	lat
méta	meta
analogique	analog
Talent	talent
daté	dated
sagesse	wisdom
frontière	boundary
élite	elite
gi	gi
croit	believes
poèmes	poems
juridiction	jurisdiction
robot	robot
visualisation	displaying
témoin	witness
équipé	equipped
étapes	stages
sur	sur
acquis	acquired
évaluer	assess
lavage	wash
entrée	entrance
déclaration	declaration
perdant	losing
tentatives	attempts
noble	noble
automatisation	automation
impacts	impacts
tour	rev
avantages	advantages
Chevalier	knight
objectifs	aims
extensions	extensions
appels	appeals
maladie	illness
ho	ho
alternatives	alternatives
sh	sh
savon	soap
confiture	jam
inhabituel	unusual
répondu	answered
destruction	destruction
migration	migration
désordre	disorder
conventionnel	conventional
portant	wearing
axe	axis
recherché	sought
gènes	genes
médian	median
scanner	scanner
ici	herein
Animé	animated
ajustement	adjustment
héros	hero
traitements	treatments
attitude	attitude
tapis	carpet
lentilles	lenses
assisté	attended
difficulté	difficulty
punk	punk
coalition	coalition
inscription	enrollment
Duc	duke
rythme	pace
producteurs	producers
arc	arc
interfaces	interfaces
atlas	atlas
observation	observation
torture	torture
supprimé	deleted
manteau	coat
restauration	restoration
commodité	convenience
retour	returning
opposition	opposition
récipient	container
défendeur	defendant
superviseur	supervisor
corps	corps
acteurs	actors
foie	liver
assujetti	liable
pétition	petition
antenne	antenna
choisi	picked
croyance	belief
meurtre	killing
épaule	shoulder
décor	decor
ion	ion
diamètre	diameter
Podcast	podcast
interactions	interactions
chanteur	singer
héraut	herald
vieillissement	aging
intervention	intervention
brancher	plugin
attraction	attraction
plongée	diving
modification	modification
supposer	suppose
roseau	reed
impliquer	involve
modérer	moderate
souris	mice
compris	understood
rapidement	rapidly
interdire	ban
assurance	assurance
événement	happening
vaste	vast
moulins	mills
contour	outline
reçoit	receives
jeans	jeans
compilation	compilation
impair	odd
Sigma	sigma
gr	gr
attrayant	attractive
occasion	occasion
enregistrements	recordings
victime	victim
demandes	demands
prudent	careful
faisceau	beam
jardinage	gardening
obligations	obligations
arrivée	arrive
orchestre	orchestra
Licence	licence
Ajustable	adjustable
allocation	allocation
essai	essay
démontré	demonstrated
dialogue	dialogue
camps	camps
déclaré	declared
trace	trace
fermer	shut
paquets	packs
ge	ge
pose	installing
interrupteurs	switches
volontaire	voluntary
tu	thou
très	greatly
ng	ng
communément	commonly
pe	pe
photographe	photographer
cri	cry
quantum	quantum
construit	constructed
additions	additions
exigeant	requiring
flèche	arrow
engagement	engagement
rugueux	rough
bizarre	weird
Lion	lion
mariages	weddings
oxygène	oxygen
canyon	canyon
mètres	meters
seulement	merely
calendriers	calendars
arrangement	arrangement
conclusions	conclusions
bibliographie	bibliography
aiguille	pointer
compatibilité	compatibility
étendue	stretch
permis	permits
coopérative	cooperative
alimentation	feeding
canton	township
classements	rankings
mesure	measuring
sangle	strap
foule	crowd
transferts	transfers
olympique	olympic
transformation	transformation
dir	dir
douane	customs
administrateurs	administrators
personnalité	personality
crochet	hook
roulette	roulette
déclin	decline
corde	cord
nuage	cloud
faciliter	facilitate
val	val
explique	explains
procéder	proceed
sentiments	feelings
couteau	knife
adopter	adopt
dénié	denied
don	donation
extérieur	outer
surgir	crop
rivières	rivers
nœuds	nodes
cité	cited
centre	hub
ciblée	targeted
réalisé	realized
fondateur	founder
décennie	decade
contestation	dispute
fatigué	tired
négatif	adverse
extrait	excerpt
décharge	discharge
boissons	drinks
as	ace
voix	voices
escalade	climbing
tonnes	tons
parfum	perfume
dangereux	hazardous
restaurer	restore
empiler	stack
méthodologie	methodology
réputation	reputation
démocrates	democrats
pendre	hang
courbe	curve
créateur	creator
ambre	amber
musées	museums
codage	coding
traqueur	tracker
variation	variation
passage	passage
transféré	transferred
tronc	trunk
photographier	photograph
vagues	waves
chameau	camel
distributeur	distributor
chi	chi
rassemblement	gathering
projection	projection
mathématique	mathematical
logique	logical
sauce	sauce
célébrité	fame
spécialisé	specialized
sociétés	corporations
critique	criticism
voiture	automobile
juges	judges
remarques	remarks
détecté	detected
peintures	paintings
marché	walked
découlant	arising
populations	populations
peur	afraid
acoustique	acoustic
cassette	cassette
indicateur	indicator
jpg	jpg
erreur	mistake
éliminer	eliminate
minéral	mineral
rubis	ruby
perles	beads
fortune	fortune
Toile	canvas
seuil	threshold
paroisse	parish
écrans	screens
cimetière	cemetery
stade	stadium
exploration	exploration
minutes	mins
tige	stem
astronomie	astronomy
concours	contests
grippe	flu
costume	costume
vélos	bikes
évêque	bishop
tiré	pulled
blé	corn
compression	compression
établissement	establishing
agriculteur	farmer
étain	tin
esclave	slave
immédiatement	instantly
encadrement	coaching
examiné	examined
codage	encoding
soumissions	submissions
héros	heroes
peint	painted
portrait	portrait
terroriste	terrorist
éthique	ethical
transporteurs	carriers
mobilité	mobility
lutte	struggle
régimes	schemes
Souffrance	suffering
neutre	neutral
pêcheur	fisher
rat	rat
lances	spears
joindre	joining
titre	heading
artificiel	artificial
palier	bearing
spectaculaire	spectacular
mondes	worlds
coupable	guilty
Activation	activation
havre	haven
tablette	tablet
jury	jury
dos	dos
queue	tail
charme	charm
violent	violent
potentiellement	potentially
ranch	ranch
contraintes	constraints
traversée	crossing
compris	inclusive
chalet	cottage
ivre	drunk
considérable	considerable
crimes	crimes
résolu	resolved
octet	byte
nez	nose
branches	branches
extraterrestre	alien
processeurs	processors
cassé	broke
complexité	complexity
constamment	constantly
résoudre	resolve
territoires	territories
thèse	thesis
disques	discs
fréquent	frequent
plafond	ceiling
pixels	pixels
gen	gen
diamants	diamonds
flotte	fleet
bouquet	bunch
théorique	theoretical
référence	referral
quitter	quit
protocoles	protocols
poumon	lung
remplacer	substitute
brillant	brilliant
ti	ti
gel	gel
parlé	spoken
oméga	omega
évalué	evaluated
séjourné	stayed
voit	sees
Résiliation	termination
regardé	watched
ménages	households
racheter	redeem
grain	grain
régime	regime
taureau	bull
architectural	architectural
différer	differ
mouvements	movements
réparations	repairs
souffle	breath
équipements	amenities
virtuellement	virtually
marché	mart
bougie	candle
pendaison	hanging
coloré	colored
conte	tale
anciennement	formerly
projecteur	projector
situé	situated
cherche	seeks
strictement	strictly
psychologique	psychological
vitamines	vitamins
élégant	elegant
gains	gains
renouvellement	renewal
généalogie	genealogy
réputée	deemed
points	scoring
dépense	expenditure
critiques	critics
algorithmes	algorithms
pirate	hacker
salon	salon
turbo	turbo
guérir	cure
ni	ni
pense	thinks
suggestion	suggestion
soldat	soldier
bombe	bomb
nuire	harm
intervalle	interval
miroirs	mirrors
enquêter	investigate
tes	thy
panneaux	panels
répété	repeated
agression	assault
cerf	deer
langue	tongue
bowling	bowling
tri	tri
singe	monkey
proportion	proportion
jupe	skirt
analyses	analyses
dessins	drawings
importance	significance
scénario	scenario
vous	ye
arabe	arabic
jauge	gauge
protéger	protecting
face	faced
résolution	solving
produit	produces
intensif	intensive
Chaînes	chains
sixième	sixth
engager	engage
commutation	switching
correspondance	correspondence
importations	imports
surveillance	supervision
dépenses	expenditures
séparation	separation
témoignage	testimony
suspect	suspect
obligatoire	mandatory
limites	boundaries
fête	celebration
filtration	filtering
époux	spouse
exotique	exotic
téléspectateur	viewer
atteindre	reaching
rire	laugh
chirurgical	surgical
détruire	destroy
citation	citation
yo	yo
locaux	premises
prouvé	proved
offensive	offensive
impérial	imperial
douzaine	dozen
déploiement	deployment
tissu	cloth
lotus	lotus
Saumon	salmon
cargaison	cargo
directif	directive
camarade	mate
beurre	butter
poivre	pepper
arme	weapon
charge	burden
bandes	tapes
zones	zones
île	isle
svelte	slim
érable	maple
épicerie	grocery
gouvernant	governing
dépôt	depot
alt	alt
tarte	pie
mélange	blend
émission	emission
apparent	apparent
éducatif	instructional
autorisations	permissions
toilette	toilet
classé	ranked
routes	routes
montage	mounting
lié	tied
équilibré	balanced
différé	delayed
vallée	dale
calcul	calculation
villas	villas
occasions	occasions
équations	equations
huiles	oils
septembre	sept
exceptionnel	exceptional
anxiété	anxiety
spatial	spatial
répondants	respondents
considérations	considerations
paie	pays
ensoleillé	sunny
livre	delivers
je	je
Collier	necklace
composite	composite
lang	lang
théâtres	theaters
conception	designing
espoirs	hopes
évaluations	assessments
diagramme	diagram
chaussure	footwear
sg	sg
peuples	peoples
Victor	victor
licences	licenses
gammes	ranges
paires	pairs
sensibilité	sensitivity
préservation	preservation
isolé	isolated
intérimaire	interim
assisté	assisted
Divin	divine
approuver	approve
composé	compound
intensité	intensity
technologique	technological
Avortement	abortion
dialogue	dialog
lieux	venues
explosion	blast
adressage	addressing
pôle	pole
bouclier	shield
membrane	membrane
désespéré	desperate
mères	mothers
manifestation	demonstration
gouvernemental	governmental
fabriqué	manufactured
bougies	candles
variations	variations
mamans	moms
sacré	sacred
dépendance	addiction
chrome	chrome
refusé	refused
frein	brake
extérieur	exterior
salutation	greeting
écologie	ecology
glen	glen
chômage	unemployment
marqué	scored
renforcement	enhancement
cloner	clone
rapidité	velocity
lambda	lambda
composé	composed
larmes	tears
oasis	oasis
taxi	cab
FA	fa
sociétés	societies
silicium	silicon
identique	identical
pétrole	petroleum
rivaliser	compete
ist	ist
amoureux	lover
appartenir	belong
lèvres	lips
escorte	escort
étang	pond
traversier	ferry
lapin	rabbit
métier	profession
barrage	dam
physiologie	physiology
exportations	exports
pneu	tire
participant	participant
électron	electron
charges	loads
bruyère	heather
motel	motel
syndicats	unions
Trésorerie	treasury
occupé	occupied
Balance	scales
souche	strain
arrêté	arrested
enquêtes	investigations
gagné	gained
blanchisserie	laundry
placement	placing
régler	adjust
évalués	assessed
chiffrement	encryption
remplissage	filling
imposé	imposed
silence	silence
soviétique	soviet
possession	possession
traité	treaty
entraîneur	trainer
organe	organ
citron	lemon
obscurité	darkness
envergure	span
blague	joke
emballage	packing
loi	statute
rejeté	rejected
abri	shelter
chapelle	chapel
fabrication	manufacture
couches	layers
célébrer	celebrate
appareil	appliance
mélange	mixture
cavalier	rider
rayon	radius
impressionnant	impressive
mouton	sheep
architecte	architect
conférences	lectures
vins	wines
tasses	cups
cendre	ash
contributeurs	contributors
salade	salad
violations	violations
températures	temperatures
compétitions	competitions
préserver	preserve
poème	poem
rester	staying
Pâques	easter
théories	theories
dépôt	repository
ruisseaux	streams
atterrissage	landing
réalisé	executed
négociations	negotiations
réaliste	realistic
demande	asks
synopsis	synopsis
compositeur	composer
haricot	bean
épée	sword
modifications	modifications
corail	coral
pixel	pixel
chemins	paths
bulle	bubble
por	por
acquérir	acquire
contraire	contrary
tribune	tribune
navire	vessel
acides	acids
virus	viruses
autocollants	stickers
réactions	reactions
croyances	beliefs
équipe	squad
analyser	analyze
divisions	divisions
nager	swim
nano	nano
concerts	concerts
mâles	males
conserver	retain
couleurs	colours
exécuter	execute
tunnel	tunnel
genres	genres
brevets	patents
blé	wheat
chroniques	chronicles
obtention	obtaining
castor	beaver
lectures	readings
élargissement	enlargement
aigles	eagles
bases	bases
accusé	accused
campagnes	campaigns
unité	unity
définit	defines
instances	instances
indigène	indigenous
commencé	begun
paquets	packets
ancre	anchor
chaussettes	socks
déclencheur	trigger
cholestérol	cholesterol
différentiel	differential
surfaces	surfaces
terrible	terrible
routeurs	routers
horloges	clocks
arthrite	arthritis
bios	bios
femelles	females
reflète	reflects
Imposition	taxation
fièvre	fever
cuisine	cuisine
sûrement	surely
praticiens	practitioners
théorème	theorem
inflation	inflation
te	thee
composés	compounds
tambours	drums
raisonnablement	reasonably
nu	bare
radical	radical
recommande	recommends
commander	controlling
Trésor	treasure
flamme	flame
fosse	pit
mono	mono
particules	particles
flottant	floating
coordonner	coordinate
exclusivement	exclusively
limitation	limitation
frappé	struck
illustration	illustration
avertissements	warnings
construction	construct
applications	apps
enquêtes	inquiries
annexe	annex
inspiration	inspiration
fret	freight
éclipse	eclipse
affecte	affects
prévisions	forecasts
détecter	detect
activement	actively
compliqué	complicated
blessé	injured
expressions	expressions
tonne	ton
courrier	courier
astuces	hints
gif	gif
conflits	conflicts
boisson	beverage
hommage	tribute
immunitaire	immune
sylviculture	forestry
barrières	barriers
pente	cant
rarement	rarely
offres	offerings
barrière	barrier
vélo	bicycle
mobilier	furnishings
survenir	arise
celtique	celtic
particule	particle
humidité	humidity
bouteilles	bottles
dm	dm
Renaissance	renaissance
ordonnance	ordinance
photographes	photographers
infections	infections
échecs	chess
fonctionne	operates
festivals	festivals
possibilités	possibilities
canard	duck
canal	canal
contribuant	contributing
vache	cow
analytique	analytical
costumes	costumes
strict	strict
circulation	circulation
infraction	offense
supposition	assumption
loisir	hobby
essais	tries
invention	invention
technicien	technician
cadres	executives
enquêtes	enquiries
cognitif	cognitive
explorant	exploring
tour	trick
enquête	enquiry
fermeture	closure
bois	timber
volt	volt
intense	intense
partisans	supporters
statuts	statutes
inscrits	enrolled
capteurs	sensors
vis	screw
ministres	ministers
publiquement	publicly
souffert	suffered
admission	intake
papillon	butterfly
mécanique	mechanics
têtes	headers
erreurs	mistakes
numérique	numerical
définissant	defining
compte	counting
réflexion	reflection
invitation	invitation
sodium	sodium
hormone	hormone
enfants	childrens
brique	brick
poignée	grip
médiéval	medieval
porcelaine	porcelain
capturé	captured
décent	decent
fonderie	casting
traduit	translated
dona	donna
guerrier	warrior
cabine	cabin
balayage	scanning
polo	polo
copier	copying
klaxon	horn
journalisme	journalism
grenouille	frog
grammaire	grammar
intention	intention
pneus	tires
entreprise	undertaken
danger	hazard
épisodes	episodes
circulaire	circular
colère	anger
illustrations	illustrations
chances	chances
bonheur	happiness
bizarre	bizarre
ur	ur
fruits	fruits
identificateur	identifier
ruban	ribbon
calculs	calculations
jpeg	jpeg
Commencez	startup
pratique	handy
échanger	swap
exempter	exempt
cultures	crops
réduit	reduces
accompli	accomplished
géométrie	geometry
impression	impression
guilde	guild
corrélation	correlation
sim	sim
nerveux	nervous
fragrance	fragrance
réplique	replica
tribu	tribe
métiers	trades
superbe	superb
débarrasser	rid
trinité	trinity
manipulés	handled
légendes	legends
boom	boom
calme	calm
champions	champions
étages	floors
sélections	selections
comparant	comparing
parle	speaks
professionnel	vocational
pharmacies	pharmacies
Dans	ln
rouleau	roller
lot	batch
organiser	organize
apprécié	appreciated
modifier	alter
bords	edges
mélange	mixing
poignées	handles
harmonie	harmony
distingué	distinguished
asthme	asthma
hypothèses	assumptions
réglementé	regulated
Triangle	triangle
modifier	amend
anticipé	anticipated
Oriental	oriental
récompense	reward
hydrogène	hydrogen
comparable	comparable
avocat	advocate
confusion	confusion
contributions	inputs
garanties	warranties
génome	genome
médaille	medal
entraîneurs	coaches
navires	vessels
port	harbour
eco	eco
vulnérable	vulnerable
organiser	arrange
artistique	artistic
honneurs	honors
reflété	reflected
unifié	unified
race	breed
détecteur	detector
ignoré	ignored
précis	precise
évaluer	evaluating
lèvre	lip
recueillir	gather
formant	forming
journalistes	journalists
mince	slight
indirect	indirect
parmi	amongst
fondations	foundations
horizon	horizon
nu	nu
profondément	deeply
passif	liabilities
prix	prizes
diminué	decreased
décrivant	describing
optique	optics
poursuivre	pursue
foudre	lightning
OU	ou
citations	quotations
inspecteur	inspector
serpent	snake
rappel	reminder
cherché	searched
plaines	plains
idées	insights
capacités	abilities
initié	initiated
karaoké	karaoke
piège	trap
solitaire	lonely
ve	ve
observer	observe
conteneurs	containers
attitudes	attitudes
baie	berry
collier	collar
intégrer	integrate
sociologie	sociology
expositions	exhibits
meurt	dies
terrasse	terrace
bactéries	bacteria
devrait	ought
délicieux	delicious
traditions	traditions
fini	finite
envoie	sends
durable	durable
allié	allied
humidité	moisture
transformer	transform
minuteur	timer
comprimés	tablets
obtenu	gotten
éducateurs	educators
légume	vegetable
verset	verse
indépendamment	independently
concurrents	competitors
fusée	rocket
toujours	aye
balle	bullet
tours	towers
visibilité	visibility
latitude	latitude
conscience	consciousness
tumeur	tumor
laid	ugly
dépôts	deposits
maîtresse	mistress
rencontre	encounter
watts	watts
quarante	forty
tubes	tubes
tentative	attempted
prêtre	priest
analystes	analysts
marteau	hammer
invasion	invasion
coureur	runner
lignes	rows
administré	administered
notion	notion
orthographe	spelling
Arctique	arctic
récompenses	rewards
sous	beneath
renforcer	strengthen
défendre	defend
infrarouge	infrared
septième	seventh
ventre	belly
agressif	aggressive
annonces	advertisements
quarts	quarters
volé	stolen
détermine	determines
sculpture	sculpture
poly	poly
oreilles	ears
poing	fist
néo	neo
motivation	motivation
passagers	passengers
régulièrement	consistently
surplus	surplus
creuser	dig
Taxi	taxi
appréciation	appreciation
om	om
restriction	restriction
guitares	guitars
essence	essence
puissant	mighty
humanité	humanity
transcription	transcription
complications	complications
savants	scholars
galaxie	galaxy
soins	caring
testament	testament
dominant	dominant
estomac	stomach
partiellement	partially
minimiser	minimize
rangs	ranks
début	debut
générations	generations
tournois	tournaments
Nier	deny
anatomie	anatomy
écouteurs	headphones
fraction	fraction
trio	trio
instance	proceeding
cube	cube
défauts	defects
incertitude	uncertainty
panne	breakdown
colonisé	settled
vaccin	vaccine
sort	fate
réservations	bookings
républicains	republicans
jungle	jungle
Zen	zen
dis	dis
prédiction	prediction
écologique	ecological
ovale	oval
implique	implies
ser	ser
évaluation	appraisal
perspective	prospect
géographique	geographical
donneur	donor
tension	tension
poubelle	trash
formes	shapes
étage	tier
comte	earl
patrie	homeland
championnats	championships
races	breeds
disco	disco
aus	aus
finition	finishing
émotions	emotions
éternel	eternal
rotation	rotation
nam	nam
productif	productive
boulevard	boulevard
porc	pig
métrique	metric
pénalités	penalties
varié	varied
grande	grande
actrice	actress
attribuer	assign
accommoder	accommodate
tigres	tigers
villages	villages
ombre	shade
Refrain	chorus
rythme	rhythm
chiffre	digit
symphonie	symphony
soudain	sudden
acceptant	accepting
piscines	pools
lyrique	lyric
isolement	isolation
vitesses	speeds
soutenu	sustained
appariés	matched
approximatif	approximate
corde	rope
rationnel	rational
programmeur	programmer
combattants	fighters
hérité	inherited
incomplet	incomplete
voix	vocals
Fontaine	fountain
légitime	legitimate
Biographies	biographies
enquêteur	investigator
demandeur	plaintiff
doux	gentle
digne	worthy
architectes	architects
saints	saints
entrepreneur	entrepreneur
porte	carries
duo	duo
excessif	excessive
sauve	saves
considéré	regarded
évaluation	valuation
inattendu	unexpected
brouillard	fog
caractéristiques	characteristic
hall	lobby
décrit	outlined
énorme	enormous
karma	karma
consister	consist
reines	queens
universitaires	academics
tribus	tribes
distinction	distinction
dangers	hazards
exemption	exemption
locataire	tenant
durabilité	sustainability
tatouage	tattoo
algèbre	algebra
ombres	shadows
idiot	silly
librement	freely
doux	mild
fourrure	fur
facilement	readily
affiliation	affiliation
clôture	fence
infini	infinite
clan	clan
révolutionnaire	revolutionary
bracelets	bracelets
remède	remedy
respiration	breathing
brièvement	briefly
épaisseur	thickness
graphique	graphical
génie	genius
discuter	discussing
combattant	fighter
significatif	meaningful
adapté	adapted
domaines	estates
couverture	rug
démocrate	democrat
arrondissement	borough
maintient	maintains
ka	ka
retenu	retained
marbre	marble
dem	dem
méditation	meditation
microphone	microphone
combinant	combining
géants	giants
organisation	organizing
note	memo
jambon	ham
résolu	solved
marée	tide
cloison	partition
invisible	invisible
consoles	consoles
aimant	magnet
traductions	translations
jaguar	jaguar
marchandise	commodity
kilomètres	kilometers
garanties	guarantees
gothique	gothic
cylindre	cylinder
sorcière	witch
mâle	buck
ennemis	enemies
Conseil	consultancy
profiter	enjoying
patrouille	patrol
odeur	smell
carnaval	carnival
grossièrement	roughly
autocollant	sticker
promesses	promises
récif	reef
diviser	divide
consécutif	consecutive
bon	bon
représentations	representations
chan	chan
airs	tunes
mas	mas
phrases	phrases
kai	kai
péninsule	peninsula
ennuyeuse	boring
dom	dom
discours	speeches
atteint	reaches
schéma	schema
catalogues	catalogs
ministères	ministries
parlementaire	parliamentary
préfixe	prefix
savane	savannah
baril	barrel
nerf	nerve
Dans	dans
planètes	planets
déficit	deficit
renouveler	renew
accouplé	coupled
circuits	circuits
texture	texture
reconnaître	acknowledge
tente	tent
identifie	identifies
qualification	qualification
serrures	locks
miniature	miniature
euros	euros
pirates	pirates
aérien	aerial
faucon	hawk
conséquence	consequence
systématique	systematic
perçue	perceived
origines	origins
embauché	hired
maquillage	makeup
ui	ui
poids	weights
géologique	geological
durable	lasting
méchant	wicked
introduit	introduces
pressé	pushed
ro	ro
pente	slope
poète	poet
conspiration	conspiracy
théologie	theology
ongles	nails
évident	evident
manèges	rides
épique	epic
organisateur	organizer
allergie	allergy
Saké	sake
combinaisons	combinations
précédent	preceding
mérite	merit
enzyme	enzyme
Avions	planes
disques	disks
amplificateur	amplifier
arbitraire	arbitrary
important	prominent
sans	sans
construit	builds
contacté	contacted
arbre	shaft
maigre	lean
occasionnel	occasional
innovations	innovations
révision	reviewing
panique	panic
citoyenneté	citizenship
excuse	excuse
réformes	reforms
oignon	onion
sandwich	sandwich
alto	alto
hiérarchie	hierarchy
abandonné	abandoned
cercles	circles
Beats	beats
joyeux	merry
culte	cult
tiret	dash
passif	passive
estimé	valued
cage	cage
courage	courage
élévation	elevation
tour	lap
utilisation	utilization
boissons	beverages
ping	ping
divertissant	entertaining
prérequis	prerequisite
frontière	frontier
réfugiés	refugees
chevaliers	knights
hypothèse	hypothesis
médicaments	medicines
modifié	altered
doctrine	doctrine
scénique	scenic
améliorations	enhancements
intersection	intersection
couture	sewing
collectionneurs	collectors
reconnu	recognised
rage	rage
prix	prix
astrologie	astrology
conseillers	advisors
pavillon	pavilion
tactique	tactics
additionnel	supplemental
talentueux	talented
oreiller	pillow
diffusion	spreading
provinces	provinces
voler	steal
parcelle	parcel
incidence	incidence
craintes	fears
prédire	predict
saveur	flavor
affamé	hungry
métallique	metallic
ingérence	interference
guerriers	warriors
atmosphérique	atmospheric
Halo	halo
parental	parental
référencé	referenced
grèves	strikes
fourmi	ant
proposition	proposition
apte	apt
traité	dealt
Commerçant	trader
jeté	thrown
critère	criterion
badge	badge
civilisation	civilization
bruyère	heath
énorme	tremendous
exécute	performs
domaine	realm
corrigée	corrected
casque	helmet
rencontré	encountered
tsunami	tsunami
savant	scholar
entouré	surrounded
géologie	geology
créatures	creatures
dégagé	cleared
accomplir	accomplish
coins	corners
végétarien	vegetarian
Levure	yeast
pas	pas
enquête	investigated
ambassadeur	ambassador
recouvert	coated
condamner	doom
routines	routines
êtres	beings
dépendance	reliance
mythe	myth
ruisseau	brook
fu	fu
phénomène	phenomenon
ensemble	ensemble
assuré	assured
conscient	conscious
accent	accent
épouses	wives
utiliser	utilize
gage	pledge
vampire	vampire
Dock	dock
organisé	organised
musicien	musician
limitant	limiting
restauré	restored
allusion	hint
armure	armor
remarque	remark
douzaines	dozens
varie	varies
raisonnement	reasoning
gardes	guards
ouvertures	openings
remplaçant	replacing
chercheur	researcher
conseils	councils
professions	occupations
reconnu	acknowledged
porc	pork
zu	zu
équilibre	equilibrium
pipes	pipes
chalets	cottages
fusionner	merge
privilège	privilege
développe	develops
châssis	chassis
estimation	estimation
Grange	barn
gel	frost
instituts	institutes
moule	mold
dame	dame
yacht	yacht
préfère	prefers
forage	drilling
herbe	herb
violation	breach
baleine	whale
voyageur	traveller
crédits	appropriations
soupçonné	suspected
tomates	tomatoes
instructeurs	instructors
élan	momentum
ailette	fin
pasteur	pastor
boue	mud
émeraude	emerald
pousse	grows
tract	tract
ul	ul
ballet	ballet
journaliste	journalist
religions	religions
Ail	garlic
éclat	shine
explosion	explosion
slips	briefs
signatures	signatures
ozone	ozone
disciplines	disciplines
casa	casa
conversations	conversations
radios	radios
tarif	tariff
simplifié	simplified
muscles	muscles
rapide	swift
vagin	vagina
Champagne	champagne
déviation	deviation
samba	samba
employer	employ
manchot	penguin
magique	magical
influences	influences
inspections	inspections
irrigation	irrigation
miracle	miracle
hydraulique	hydraulic
pénétration	penetration
blessure	wound
belle	belle
rosa	rosa
conviction	conviction
paresseux	lazy
qualités	qualities
ancêtres	fathers
charge	charging
important	importantly
menue	petite
appareil	apparatus
terrain	terrain
expliquant	explaining
bandes	strips
nomination	nomination
empirique	empirical
ver	worm
dépendance	dependence
discret	discrete
débutant	beginner
couvercle	lid
sexualité	sexuality
saphir	sapphire
privilèges	privileges
spécialisation	specializing
marquage	marking
shérif	sheriff
diminué	declined
espions	spies
motocyclettes	motorcycles
élire	elect
autoroutes	highways
concentrer	concentrate
intime	intimate
molécules	molecules
tours	rounds
réfrigérateur	refrigerator
intervalles	intervals
Phrases	sentences
holocauste	holocaust
prospectus	flyer
pois	peas
dosage	dosage
variance	variance
navigateur	navigator
aiguille	needle
thermes	baths
freins	brakes
og	og
ko	ko
propriétaire	owns
destin	destiny
paysages	landscapes
calcul	computation
foins	hay
salut	salvation
prévisions	predictions
apprenants	learners
jeton	token
zinc	zinc
sacrifice	sacrifice
demandeurs	seekers
gourou	guru
adapté	suited
numérique	numeric
anthropologie	anthropology
empereur	emperor
grad	grad
ceintures	belts
noirs	blacks
cultivé	educated
fièrement	proudly
nécessité	necessity
courbes	curves
tournée	touring
sommet	vertex
tomate	tomato
voyages	travels
pâle	pale
fonctionnement	functioning
économies	economies
entreprendre	undertake
déclarer	declare
vannes	valves
lacunes	gaps
réalisations	achievements
larme	tear
enseigne	teaches
néant	nil
étranger	stranger
nid	nest
tribunal	tribunal
gouverné	ruled
pensions	pensions
prières	prayers
flic	cop
adolescent	adolescent
nominations	nominations
banane	banana
préliminaire	introductory
réservoir	reservoir
occurrence	occurrence
idole	idol
sanglant	bloody
rappeler	remind
charmant	charming
dent	tooth
respecté	respected
séjours	stays
affaire	affair
restreindre	restrict
mines	mines
portraits	portraits
interprété	interpreted
évaluations	evaluations
élimination	elimination
mètres	metres
hypothétique	hypothetical
hélicoptère	helicopter
crayon	pencil
interprète	performer
commissions	commissions
sphère	sphere
mousse	moss
rapports	ratios
concorde	concord
graduée	graduated
approuvé	endorsed
surprenant	surprising
lance	lance
échelle	ladder
Liège	cork
sénateurs	senators
saignement	bleeding
caractérisation	characterization
probabilité	likelihood
voies	lanes
fondamentaux	fundamentals
contamination	contamination
dôme	dome
bénir	bless
négociation	negotiation
crête	crest
adversaires	opponents
triomphe	triumph
nommé	nominated
soudage	welding
orgasme	orgasm
alliage	alloy
parcelles	plots
doucement	gently
verrouillage	locking
controversé	controversial
dessine	draws
frigo	fridge
lames	blades
boucles	loops
poussée	surge
traumatisme	trauma
publicité	advert
défensive	defensive
interdit	forbidden
vanille	vanilla
programmeurs	programmers
suivi	monitored
installations	installations
âmes	souls
motivé	motivated
stupide	dumb
creux	hollow
voûte	vault
rainure	groove
révélation	revelation
poursuite	pursuit
délégation	delegation
fils	wires
dictionnaires	dictionaries
transparence	transparency
orbite	orbit
devises	currencies
Niger	niger
placement	positioning
colonie	colony
canon	cannon
cirque	circus
promu	promoted
truite	trout
exploit	feat
temporairement	temporarily
cuit	cooked
transmettre	transmit
fréquences	frequencies
réflexions	reflections
faim	hunger
municipalité	municipality
détective	detective
ciment	cement
expérience	experiencing
cheminée	fireplace
approbation	endorsement
textiles	textiles
missile	missile
psychiatrie	psychiatry
aide	assists
Auditeur	auditor
violon	violin
prophète	prophet
oxyde	oxide
magnifique	magnificent
rapidement	promptly
adaptation	adaptation
nocif	harmful
sexuellement	sexually
enceinte	enclosure
glucose	glucose
norme	norm
lecture	playback
tortue	turtle
distances	distances
absorption	absorption
trésors	treasures
fossile	fossil
mal	badly
communiste	communist
entrepreneurs	entrepreneurs
robots	robots
faute	foul
biodiversité	biodiversity
excitation	excitement
verbal	verbal
mers	seas
mystérieux	mysterious
nouveauté	novelty
carrelage	tiles
bibliothécaire	librarian
commuté	switched
ru	ru
pose	pose
grammes	grams
thérapeute	therapist
budgets	budgets
chèvre	goat
rendre	render
voile	sail
commissaires	commissioners
dense	dense
courageux	brave
expéditeur	forwarding
terrible	awful
avion	airplane
organismes	organisms
télescope	telescope
amiante	asbestos
avancement	advancement
saule	willow
CV	resumes
existait	existed
générateurs	generators
génère	generates
patates	potatoes
approfondi	thorough
récepteurs	receptors
optimum	optimum
créature	creature
seul	lone
subtil	subtle
rayures	stripes
firmware	firmware
berger	shepherd
berceau	cradle
chancelier	chancellor
farine	flour
controverse	controversy
légendaire	legendary
chorale	choir
évitant	avoiding
magnifiquement	beautifully
attend	expects
sauteur	jumping
textile	fabrics
polymère	polymer
hygiène	hygiene
vertu	virtue
chirurgiens	surgeons
mandat	mandate
corpus	corpus
terminologie	terminology
gentilhomme	gentleman
condamné	convicted
jets	jets
indices	indices
Qui	qui
menaçant	threatening
militants	activists
prisonnier	prisoner
encourage	encourages
assemblé	assembled
terminaux	terminals
brut	crude
examine	examines
viking	viking
nettoyer	cleanup
conditionnel	conditional
attaqué	attacked
arrive	arrives
traducteur	translator
automobiles	automobiles
tracteur	tractor
continent	continent
tarifs	fares
longitude	longitude
espéré	hoped
insertion	insertion
contrainte	constraint
renforcement	strengthening
souhaitant	wishing
isolation	insulation
infraction	infringement
courbé	bent
subjectif	subjective
monstres	monsters
asile	asylum
pieu	stake
cocktail	cocktail
variétés	varieties
poison	poison
dominé	dominated
cher	costly
dérivés	derivatives
prévient	prevents
fusil	rifle
racisme	racism
interpréter	interpret
accord	accord
modeste	modest
joueurs	gamers
tri	sorting
liaison	liaison
bulbes	bulbs
touristes	tourists
comportements	behaviors
clarifier	clarify
taille	waist
attribué	attributed
hibou	owl
cristaux	crystals
dépasse	exceeds
complémentaire	complementary
batailles	battles
amer	bitter
mémorandum	memorandum
dragons	dragons
vacarme	din
incroyablement	incredibly
délégués	delegates
psychiatrique	psychiatric
adolescents	teenagers
Cour	courtyard
présidents	presidents
partir	depart
expressément	expressly
lis	lily
surveillance	oversight
résine	resin
alliés	allies
conservé	preserved
franchi	crossed
Ascendant	ascending
nominal	nominal
pourriture	decay
quartz	quartz
registres	registers
huitième	eighth
autorisé	authorised
améliore	improves
défenseurs	advocates
phénomènes	phenomena
inclinaison	tilt
granit	granite
masses	masses
athlète	athlete
franc	franc
similarité	similarity
fuite	leak
conseiller	adviser
brochure	booklet
attendant	expecting
rotation	turnover
urine	urine
serviette	towel
gingembre	ginger
chromosome	chromosome
als	als
mouches	flies
compétence	competence
pleurs	crying
amateurs	amateurs
grue	crane
enquête	investigating
pourri	rotten
habitude	habit
honneur	honour
protège	protects
iris	iris
gère	manages
érosion	erosion
Charpentier	carpenter
khan	khan
insuffisant	insufficient
formulation	formulation
intelligent	clever
seigneurs	lords
agréable	enjoyable
croissant	crescent
soixante	sixty
concentré	concentrated
distinguer	distinguish
ei	ei
projections	projections
étincelle	spark
fixation	securing
sentier	pathway
détecteurs	detectors
pointe	spike
ingrédient	ingredient
rideau	curtain
divulgués	disclosed
tactique	tactical
pilotes	pilots
expédition	expedition
opératoire	operative
humour	humour
mol	mol
imprimer	imprint
assistant	assisting
défaut	defect
pauvrement	poorly
déesse	goddess
observateurs	observers
aimants	magnets
formules	formulas
spacieux	spacious
soutient	argues
sols	soils
organes	organs
det	det
fidélité	loyalty
fidèle	faithful
infraction	offence
lithium	lithium
saut	leap
fondation	founding
cygne	swan
plantation	planting
engagement	covenant
archéologie	archaeology
marin	sailor
soins	cares
sanctuaire	sanctuary
statue	statue
citation	quotation
majors	majors
manipulation	manipulation
cloches	bells
toxicité	toxicity
émetteur	transmitter
quartiers	neighborhoods
trophée	trophy
émotion	emotion
spectacles	sights
uniformes	uniforms
blessés	wounded
dérivé	derivative
occupation	occupancy
doses	doses
éduquer	educate
préjudice	prejudice
techniciens	technicians
probable	probable
émission	issuance
décoration	decoration
ressortissants	nationals
troyen	trojan
assistants	assistants
conseiller	counselor
adopté	enacted
instable	unstable
pressé	urged
reflétant	reflecting
gagnant	gaining
définitive	definitive
voyagé	traveled
adapter	adapt
accession	accession
régulateur	regulator
carburants	fuels
soja	soy
soigné	neat
appellation	naming
arrière	stern
conçu	crafted
idiot	idiot
composé	comprised
extraterrestres	aliens
modifications	edits
corbeau	raven
habitation	dwelling
symbolique	symbolic
angles	angles
pressions	pressures
Vénus	venus
flammes	flames
primitif	primitive
stockage	stocking
écosystème	ecosystem
salles	halls
simplicité	simplicity
démon	demon
accueilli	welcomed
notation	notation
tante	aunt
corbeau	crow
sémantique	semantic
abandonnées	discontinued
décide	decides
mondialisation	globalization
ânes	asses
boussole	compass
évolué	evolved
infanterie	infantry
renommé	renowned
couloir	corridor
philosophique	philosophical
justification	justification
vacant	vacant
fixation	fixing
gramme	gram
cache	hiding
colorant	dye
alphabet	alphabet
nettoyé	cleaned
honoré	honored
optique	optic
téléphones	telephones
agendas	diaries
douleur	grief
transpiration	sweat
dauphin	dolphin
merveilles	wonders
ventilation	ventilation
masques	masks
buste	bust
ruelle	alley
voies	pathways
télégraphe	telegraph
monument	monument
officiellement	formally
rosée	dew
retiré	withdrawn
débats	debates
identités	identities
carence	deficiency
selle	saddle
paludisme	malaria
fidèle	loyal
tendance	tendency
utilisé	utilized
ein	ein
jumelles	binoculars
lancer	initiate
purement	purely
vif	vivid
allégations	allegations
correspond	corresponds
démon	daemon
célèbre	celebrated
chasseurs	hunters
agi	acted
coefficient	coefficient
crâne	skull
continuation	continuation
serviteur	servant
faucon	falcon
conjointement	jointly
éviter	avoided
explications	explanations
renouvelé	renewed
critique	critic
sédiment	sediment
carrés	squares
fourgonnettes	vans
cône	cone
survécu	survived
prévalence	prevalence
fragment	fragment
engage	commits
cobra	cobra
jeta	threw
hoc	hoc
interprètes	performers
dessert	dessert
thèse	dissertation
neuvième	ninth
enthousiasme	enthusiasm
célébrations	celebrations
gouverneurs	governors
atomes	atoms
tissus	tissues
rampe	ramp
bien	nicely
della	della
domination	domination
accords	chords
détérioration	impairment
molécule	molecule
