od	de
do	à
u	dans
za	pour
je	est
na	sur
da	cette
po	par
ovaj	ce
s	avec
ja	je
vas	toi
to	il
ili	ou
biti	être
su	sont
na	à
svi	tout
imati	avoir
novi	Nouveau
mi	nous
htjeti	volonté
Dom	maison
nas	nous
oko	sur
ako	si
stranica	page
moj	mon
ima	a
traži	chercher
besplatno	gratuit
ali	mais
naše	notre
jedan	un
drugo	autre
čini	faire
informacija	information
vrijeme	temps
on	il
koji	lequel
njihov	leur
vijesti	nouvelles
koristiti	utilisation
tamo	Là
vidjeti	voir
tako	alors
tko	qui
mreža	toile
također	aussi
dobiti	obtenir
pm	pm
pogled	vue
c	c
e	e
prvi	premier
bila	été
bi	aurait
su	étaient
a	s
Kao	comme
x	X
od	que
pronaći	trouver
cijena	prix
leđa	arrière
vrh	Haut
narod	gens
imala	avait
popis	liste
Ime	prénom
samo	juste
godina	an
dan	journée
u	dans
dva	deux
zdravlje	santé
n	n
ponovno	ré
koristi	utilisé
ići	aller
b	b
posljednji	dernier
napraviti	faire
ih	leur
treba	devrait
proizvod	produit
sistem	système
pošta	poster
nju	sa
Grad	ville
t	t
politika	politique
broj	nombre
podrška	soutien
poruka	message
nakon	après
zatim	puis
siječanj	jan
dobro	bien
d	ré
gdje	où
Informacije	Info
prava	droits
knjige	livres
visok	haute
škola	école
m	m
svaki	chaque
linkovi	liens
ona	elle
godine	années
narudžba	commande
vrlo	très
knjiga	livre
stavke	articles
društvo	compagnie
r	r
čitati	lis
skupina	groupe
seks	sexe
mnogi	beaucoup
korisnik	utilisateur
de	de
set	ensemble
general	général
istraživanje	recherche
sveučilište	Université
siječanj	janvier
pošta	courrier
puni	plein
recenzije	avis
program	programme
znati	connaître
igre	Jeux
put	façon
dana	journées
p	p
dio	partie
mogao	pourrait
Sjajno	génial
ujedinjen	uni
stvaran	réal
f	F
međunarodna	international
centar	centre
putovati	Voyage
komentari	commentaires
napravljen	fabriqué
razvoj	développement
izvješće	rapport
član	membre
detalji	détails
crta	ligne
Pojmovi	termes
prije	avant
hoteli	hôtels
učinio	fait
poslati	envoyer
pravo	droite
tip	type
lokalne	local
oni	ceux
rezultati	résultats
ured	Bureau
nacionalna	nationale
automobil	voiture
dizajn	conception
uzeti	prendre
objavljeno	posté
adresa	adresse
zajednica	communauté
unutar	dans
Države	États
željeti	vouloir
telefon	téléphone
DVD	DVD
predmet	assujettir
između	entre
forum	forum
obitelj	famille
l	l
dugo	longue
w	w
pokazati	montrer
o	o
čak	même
crno	noir
poseban	spécial
indeks	indice
biće	étant
žene	femmes
mnogo	beaucoup
znak	signe
datoteka	fichier
veza	lien
otvoren	ouvrir
jug	Sud
slučaj	Cas
projekt	projet
stranica	pages
verzija	version
odjeljak	section
vlastiti	posséder
kuća	maison
sigurnosti	Sécurité
g	g
okrug	comté
američki	américain
foto	photo
igra	Jeu
članovi	membres
vlast	Puissance
mreža	réseau
Računalo	ordinateur
sustavi	systèmes
tri	Trois
mjesto	endroit
kraj	fin
h	h
mu	lui
po	par
pristup	accès
razmišljati	pense
sjeverno	Nord
resursi	Ressources
Trenutno	actuel
velik	gros
media	médias
zakon	loi
kontrolirati	contrôle
voda	eau
povijest	histoire
veličina	Taille
osobni	personnel
vodič	guider
dućan	boutique
imenik	annuaire
promijeniti	changement
bijela	blanc
tekst	texte
mali	petit
klijenata	évaluation
stopa	taux
vlada	gouvernement
djeca	enfants
povratak	revenir
studenti	élèves
v	v
račun	Compte
puta	fois
nivo	niveau
digitalni	numérique
profil	profil
prijašnji	précédent
oblik	forme
događaji	événements
ljubav	amour
star	vieux
Ivan	John
glavni	principale
poziv	appel
slika	image
odjel	département
titula	Titre
ne	non
k	k
y	y
osiguranje	Assurance
treba	doit
svojstvo	propriété
klasa	classe
CD	CD
kvaliteta	qualité
svaki	chaque
spisak	inscription
sadržaj	contenu
zemlja	pays
malo	peu
alat	outils
nizak	faible
odgovor	répondre
kupac	client
prosinac	décembre
usporediti	comparer
filmovi	films
koledž	Université
vrijednost	valeur
članak	article
čovjek	homme
poslovi	emplois
j	j
hrana	aliments
Autor	auteur
drugačiji	différent
u	u
naučiti	apprendre
prodaja	vente
otisak	impression
tečaj	cours
posao	emploi
soba	chambre
zaliha	Stock
trening	entraînement
isto	aussi
Kreditna	crédit
točka	point
znanost	science
muškarci	Hommes
kategorije	catégories
Zapad	Ouest
izgled	Regardez
Engleski	Anglais
tim	équipe
imanje	biens
kutija	boîte
Uvjeti	conditions
fotografije	Photos
homoseksualac	gai
nit	fil
kategorija	Catégorie
Bilješka	Remarque
uživo	vivre
veliki	grand
galerija	Galerie
stol	table
međutim	toutefois
lipanj	juin
listopad	octobre
studeni	novembre
tržište	marché
knjižnica	bibliothèque
akcijski	action
početak	début
niz	séries
značajke	fonctionnalités
zrak	air
industrija	industrie
plan	plan
ljudski	Humain
Da	Oui
drugi	seconde
vruće	chaud
cijena	Coût
film	film
forumi	forums
ožujak	Mars
la	la
rujan	septembre
reći	dire
odlazak	Aller
medicinski	médical
prijatelj	ami
prosinca	déc
server	serveur
primjena	application
osoblje	Personnel
igra	jouer
pitanja	problèmes
travanj	avril
Korisnici	utilisateurs
ulica	rue
tema	sujet
protiv	contre
dobio	eu
blog	Blog
Zabava	fête
plaćanje	Paiement
oprema	équipement
pustiti	laisser
programi	programmes
pravni	légal
nedavni	récent
park	parc
čin	acte
problem	problème
Crvena	rouge
dati	donner
memorija	Mémoire
izvođenje	performance
socijalni	social
q	q
priča	récit
prodavati	vendre
opcije	Options
iskustvo	expérience
ključ	clé
tijelo	corps
mladi	Jeune
važno	important
polje	champ
nekoliko	peu
istočno	est
singl	unique
ii	ii
dob	âge
klub	club
primjer	Exemple
djevojke	filles
z	z
cesta	route
dar	cadeau
pitanje	question
ca	Californie
teško	difficile
platiti	Payer
četiri	quatre
poker	poker
problem	problème
opseg	gamme
zgrada	bâtiment
prodavač	vendeur
sud	tribunal
veljača	février
proizlaziti	résultat
svjetlo	lumière
pisati	écrire
rat	guerre
ponuda	offre
plava	bleu
grupe	groupes
al	Al
lako	facile
dan	donné
zahtjev	demande
faks	fax
Kina	Chine
izrađivanje	fabrication
slika	image
potrebe	Besoins
moguće	possible
mjesec	mois
glavni	Majeur
zvijezda	étoile
budućnost	avenir
prostor	espace
odbor	Comité
ruka	main
Sunce	Soleil
kartice	cartes
London	Londres
sastanak	réunion
postati	devenir
dijete	enfant
zadržati	garder
pornografija	porno
udio	partager
sličan	similaire
vrt	jardin
škola	écoles
milijuna	million
dodano	ajoutée
upućivanje	référence
tvrtke	entreprises
dijete	bébé
učenje	apprentissage
energija	énergie
trčanje	courir
dostava	livraison
popularan	populaire
termin	terme
film	film
priče	histoires
staviti	mettre
časopis	journal
izvještaji	rapports
ko	co
probati	essayer
slika	images
obavijest	remarquer
bog	Dieu
izvornik	original
glava	tête
radio	radio
ćelija	cellule
vijeće	conseil
uključuje	comprend
staza	Piste
rasprava	discussion
arhiva	archiver
drugi	autres
sporazum	accord
format	format
društvo	société
mjeseci	mois
sigurnosni	sécurité
prijatelji	copains
Naravno	sûr
izdanje	édition
poruke	messages
Marketing	commercialisation
reći	dire
asocijacija	association
pruža	fournit
zabava	amusement
već	déjà
zelena	vert
studije	études
Zatvoriti	Fermer
uobičajen	commun
specifično	spécifique
nekoliko	nombreuses
život	vivant
kolekcija	collection
zvao	appelé
kratak	court
umjetnost	lettres
mnogo	lot
pitati	demander
ograničen	limité
rješenja	solutions
direktor	réalisateur
plaža	plage
prošlost	passé
prirodni	Naturel
elektronika	électronique
na	sur
razdoblje	période
planiranje	Planification
kaže	dit
službeno	officiel
pokvariti	mar
učinio	terminé
tehnička	technique
prozor	fenêtre
profesionalac	pro
regija	Région
otoka	île
snimiti	record
direktno	direct
konferencija	conférence
ploče	archives
st	st
okrug	district
kalendar	calendrier
troškovi	frais
stil	style
izjava	déclaration
milja	miles
resurs	Ressource
aplikacije	applications
dokument	document
riječ	mot
djela	travaux
materijal	Matériel
račun	facture
napisan	écrit
pravila	règles
konačni	final
stvar	chose
centar	centre
zahtjevi	exigences
PRAVI	VRAI
minuta	minutes
drugo	autre
ocjena	marque
stijena	Roche
loše	mal
pojedinac	individuel
plus	plus
auto	auto
pokriti	couverture
Uredi	modifier
zajedno	ensemble
video	vidéos
brzo	vite
funkcija	fonction
činjenica	fait
uzimajući	obtention
globalno	global
tech	technologie
sastati	rencontrer
daleko	loin
ekonomski	économique
hr	en
igrač	joueur
projekti	projets
iznos	montant
Gledati	regarder
uključen	inclus
osjetiti	ressentir
banka	banque
rizik	risque
Popularna	offres
raznovrstan	divers
riječi	mots
proizvodnja	production
trgovački	commercial
težina	poids
srce	cœur
liječenje	traitement
bodova	points
znanje	connaissance
časopis	magazine
greška	Erreur
fotoaparat	caméra
djevojka	fille
izgradnja	construction
igračke	jouets
zabilježen	inscrit
domena	domaine
metode	méthodes
poglavlje	chapitre
zaštita	protection
politika	politiques
širok	large
ljepota	beauté
menadžer	directeur
Indija	Inde
položaj	position
poduzete	pris
vrsta	Trier
oglasi	annonces
znan	connu
pola	moitié
slučajevi	cas
korak	étape
inženjering	ingénierie
jednostavan	simple
brz	rapide
licenca	Licence
jezero	Lac
čitav	entier
godišnji	annuel
Objavljeno	publié
crkva	église
način	méthode
aktivan	actif
odgovor	réponse
lik	figure
materijali	matériaux
dovoljno	assez
konstruiran	conçu
među	parmi
smrt	décès
gubitak	perte
lice	visage
marka	marque
popust	remise
efekti	effets
stvorio	créé
standardi	normes
bit	bit
politički	politique
kraljevstvo	Royaume
baza	base
rade	Faire
krediti	prêts
cipele	chaussures
ulaz	entrée
boravak	rester
narudžbe	ordres
dostupnost	disponibilité
Sažetak	résumé
skretanje	tour
rast	croissance
agencija	agence
kralj	Roi
europska	européen
aktivnost	activité
kopirati	copie
zapadni	occidental
sila	Obliger
zapošljavanje	emploi
zaljev	baie
Rijeka	rivière
komisija	commission
paket	paquet
vidio	vu
igrači	joueurs
motor	moteur
luka	Port
album	album
Regionalni	régional
Stop	Arrêtez
počeo	commencé
uprava	administration
bar	bar
institut	institut
pregleda	vues
dvostruko	double
pas	chien
uskoro	bientôt
linije	lignes
elektronička	électronique
prednosti	avantages
potreban	nécessaire
printer	imprimante
stanje	condition
djelotvoran	efficace
vjerovati	croyez
organizacija	organisation
posljedica	effet
um	esprit
izbor	sélection
kasino	casino
pdf	pdf
obilazak	tour
križ	traverser
nada	espérer
korporacija	société
želja	souhait
riješenje	Solution
zreo	mature
uloga	rôle
tjedni	semaines
siguran	certain
niži	inférieur
potreban	nécessaire
unija	syndicat
mon	lun
com	com
posebno	particulier
fino	bien
sat	heure
plin	gaz
vještine	compétences
šest	six
grm	buisson
otoci	îles
savjet	Conseil
karijera	carrière
odluka	décision
napustiti	laisser
prije	pré
ogroman	énorme
žena	femme
postrojenja	installations
ponuda	offre
srednji	milieu
kabel	câble
prilike	Opportunités
uzimanje	prise
vrijednosti	valeurs
podjela	division
dolazak	arrivant
objekt	objet
lezbijka	lesbienne
prikladan	approprié
mašina	machine
logo	logo
dužina	longueur
Lijepo	agréable
postići	But
statistika	statistiques
klijent	client
uzorak	échantillon
ulaganje	investissement
poslao	envoyé
prikazan	montré
Božić	Noël
Kultura	Culture
bljesak	flash
ms	Mme
izbor	choix
tečajevi	cours
potrošač	consommateur
bok	salut
strana	étranger
umjetnik	artiste
namještaj	meubles
kanal	canal
pismo	lettre
način	mode
telefoni	Téléphones
ideje	idées
struktura	structure
stupanj	degré
ugovor	Contrat
super	super
muški	mâle
stvar	matière
skoro	presque
nalazi	situé
višekratnik	plusieurs
distribucija	Distribution
urednik	éditeur
gostionica	auberge
industrijski	industriel
potencijal	potentiel
pjesma	chanson
los	los
pad	tomber
ideja	idée
sobe	pièces
komunikacije	communications
pobijediti	gagner
osnovni	primaire
Rak	cancer
brojevi	Nombres
razlog	raison
alat	outil
Proljeće	printemps
temelj	fondation
odgovor	répondre
glas	voix
raspored	programme
dokumenti	documents
Svrha	objectif
svojstvo	fonctionnalité
krevet	lit
dolazi	vient
policija	police
samostalan	indépendant
pristup	approche
smeđ	marron
fizička	physique
brdo	colline
Karte	Plans
držati	tenir
ocjene	évaluations
sretan	content
kovač	forgeron
razvijen	développé
zahvaliti	remercier
sef	sûr
jedinstvena	unique
pregled	enquête
prije	avant
telefon	Téléphone
sport	sport
spreman	prêt
životinja	animal
izvori	sources
populacija	population
godišnje	Pennsylvanie
redovan	ordinaire
siguran	garantir
operacije	opérations
jednostavno	simplement
dokaz	preuve
stanica	gare
razumjeti	comprendre
opcija	option
dolina	vallée
vjerojatno	Probablement
more	mer
publikacije	publications
poboljšati	améliorer
veza	connexion
izdavač	éditeur
dvorana	salle
anti	anti
mreže	réseaux
Zemlja	Terre
roditelji	Parents
udarac	impact
prijenos	transfert
Uvod	introduction
kuhinja	cuisine
jak	fort
vjenčanje	mariage
nekretnine	Propriétés
bolnica	hôpital
tlo	sol
brod	navire
smještaj	hébergement
bolest	maladie
izvrstan	excellent
savršen	parfait
dlaka	cheveux
prilika	opportunité
oprema	trousse
klasik	classique
osnova	base
naredba	commander
gradovi	villes
izraziti	Express
dodijeliti	prix
udaljenost	distance
drvo	arbre
procjena	évaluation
zid	mur
umiješan	impliqué
el	el
ekstra	supplémentaire
posebno	notamment
budžet	budget
vodiči	guides
uspjeh	Succès
maksimum	maximum
majka	mère
operacija	opération
postojanje	existant
dosta	assez
odabran	choisi
dječak	garçon
restorani	Restaurants
lijep	beau
upozorenje	Attention
lokacije	Emplacements
konj	cheval
glasanje	vote
cvijeće	fleurs
zvijezde	étoiles
arena	listes
vlasnik	propriétaire
životinje	animaux
načine	façons
sin	fils
pružanje	fournir
Pravilo	règle
kućište	logement
traje	prend
donijeti	apporter
katalog	catalogue
maksimum	max
majka	mère
vlast	autorité
rekao	Raconté
program	programme
spojen	relié
ulazni	contribution
strategija	stratégie
noge	pieds
agent	agent
vrijedi	valide
moderan	moderne
stariji	Sénior
seksi	sexy
nastava	enseignement
vrata	porte
veličanstven	grandiose
suđenje	procès
jedinice	unités
svjež	cool
normalan	Ordinaire
poduzeće	entreprise
brodovi	navires
čitav	tout
pozitivan	positif
sposobnost	aptitude
kineski	chinois
mišljenje	opinion
nogomet	Football
sažetak	abstrait
izlaz	sortie
fondovi	fonds
mr	M
Vjerojatno	probable
razviti	développer
izvođači	artistes
alternativa	alternative
odgovornost	responsabilité
Java	Java
gost	client
objavljivanje	publication
proći	passer
odnosi	rapports
povjerenje	confiance
kombi	van
sadrži	contient
multi	multi
republika	république
naknada	honoraires
komponente	Composants
odmor	vacances
stoljeće	siècle
akademski	académique
pomoć	assistance
dovršen	terminé
koža	peau
grafika	graphique
Indijanac	Indien
prsten	bague
razred	qualité
planina	Montagne
organizacija	organisations
filtar	filtre
ploča	panneau
kat	sol
kupovina	achat
utakmica	rencontre
zaprosio	proposé
zahtijevati	exiger
dječaci	garçons
jutro	Matin
omogućuje	permet
protein	protéine
biljka	plante
izvijestio	signalé
pogoditi	frappé
mm	mm
bazen	bassin
mini	mini
politika	politique
partner	partenaire
autori	auteurs
ploče	planches
riba	poisson
članstvo	adhésion
misija	mission
oko	œil
niz	chaîne
osjećaj	sens
promijenjen	modifié
oslobođen	libéré
faza	étape
interni	interne
rođen	née
detaljan	détaillé
japanski	Japonais
utrka	course
odobren	approuvé
cilj	cible
osim	sauf
lik	personnage
održavanje	entretien
sposobnost	aptitude
ed	ed
silovanje	râpé
baterija	batterie
mladež	jeunesse
pritisak	pression
podnijeti	soumis
dug	dette
srednji	moyen
televizija	télévision
zainteresiran	intéressé
srž	coeur
pauza	Pause
svrhe	fins
setovi	ensembles
ples	Danse
drvo	bois
definiran	défini
novine	papiers
nagrade	prix
pristojba	frais
studio	studio
čitač	lecteur
uređaj	dispositif
osnovan	établi
odgovori	réponses
najam	location
las	Las
mrak	foncé
vanjski	externe
jabuka	Pomme
le	le
instrukcije	instructions
min	min
ponudio	offert
teorija	théorie
ukloniti	retirer
pomoć	aide
vidni	visuel
domaćin	hôte
raznolikost	variété
učitelji	enseignants
priručnik	Manuel
blok	bloc
teme	sujets
agenti	agents
popravak	réparation
pravedan	juste
željezo	acier
razumijevanje	compréhension
Pjesme	Chansons
fiksni	fixé
pogrešno	faux
početak	début
ruke	mains
AZ	az
Pariz	Paris
dobiva	obtient
sektor	secteur
kapacitet	capacité
uN	ONU
mast	graisse
otac	père
električni	électrique
pila	vu
instrumenti	instruments
časnik	officier
vozač	chauffeur
poduzeća	entreprises
mrtav	mort
nepoznat	inconnu
restoran	restaurant
mikrofon	Mike
putovanje	voyage
mi	mi
siromašan	pauvre
odnos	relation
radnici	ouvriers
mir	paix
tradicionalan	traditionnel
pokazivanje	projection
kreativan	Créatif
obala	côte
korist	avantage
financiranje	financement
uređaji	dispositifs
gospodar	Seigneur
odobriti	subvention
pod	sous
fikcija	fiction
satovi	montres
karijere	carrières
ide	va
vodio	LED
muzej	musée
ventilator	ventilateur
prijevoz	transport
zanimljiv	intéressant
blogovi	blogs
procjena	évaluation
prijašnji	ancien
zona	zone
kompleks	complexe
th	e
mačka	chat
umrijeti	mourir
predstavili	présenté
ravan	appartement
teći	couler
agencije	agences
književnost	Littérature
roditelj	parent
postavljanje	réglage
doktor	dr
ljestvica	échelle
Ekonomija	économie
koristan	utile
mjesečno	mensuel
kritično	critique
okvir	Cadre
mjuzikl	musical
definicija	définition
tajnica	secrétaire
staza	chemin
glavni	chef
daje	donne
paketi	paquets
detalj	détail
zakoni	lois
promijenjen	modifié
početi	commencer
kraljevski	Royal
čist	nettoyer
momak	gars
naslovi	titres
relevantan	pertinent
pravda	Justice
Spojiti	relier
kupa	Coupe
košara	panier
primijenjen	appliqué
tjedni	hebdomadaire
vol	vol
montaža	installation
str	pp
pažnja	attention
napredovati	avance
preskočiti	sauter
dijeta	régime
vojska	armée
zupčanik	équipement
razlika	différence
dopušteno	permis
ispravan	correct
narod	nation
prodaja	vente
mnogo	beaucoup
komad	pièce
list	drap
firma	raffermir
sedam	Sept
elementi	éléments
vrsta	espèce
skok	saut
Stanice	cellules
modul	module
pribjeći	recours
potvrda	certificat
ministar	ministre
pokret	mouvement
moda	mode
smjerovi	directions
posjetitelji	visiteurs
dokumentacija	Documentation
trgovački	commerce
šuma	forêt
pozivi	appels
pokrivenost	couverture
par	couple
davanje	donnant
prilika	chance
vizija	vision
lopta	ballon
završni	fin
klijenti	clients
akcije	actes
raspravljati	discuter
cilj	objectif
uspješan	réussi
prodan	vendu
vjetar	vent
zajednice	communautés
klinički	clinique
situacija	situation
tržišta	marchés
objavljivanje	édition
pojaviti	apparaître
razvoju	développement
život	vies
odrediti	déterminer
temperatura	Température
najave	annonces
pacijent	patient
stvaran	réel
povijesni	historique
kamen	pierre
bob	bob
trgovina	Commerce
osobe	personnes
težak	difficile
znanstvena	scientifique
satelit	Satellite
testovi	essais
selo	village
računi	comptes
amater	amateur
ex	ex
sastali	rencontré
bol	douleur
čimbenici	facteurs
kava	café
kupac	acheteur
poster	affiche
rub	bord
funkcionalna	fonctionnel
korijen	racine
fi	Fi
zatvoreno	fermé
Praznici	vacances
ružičasta	rose
ravnoteža	équilibre
nadgledanje	surveillance
odgovora	réponses
šut	coup
početni	initiale
označiti	étiquette
sek	seconde
kanon	canon
liga	ligue
gubljenje	déchets
minuta	minute
autobus	autobus
usluga	fournisseur
rječnik	dictionnaire
računovodstvo	comptabilité
proizvodnja	fabrication
dijelovi	sections
stolica	chaise
napor	effort
faza	phase
fantazija	fantaisie
PO	po
va	Virginie
profesor	professeur
instalirati	installer
košulja	chemise
odjeća	vêtements
noga	pied
grudi	Sein
Tehnike	techniques
dolara	dollars
religija	religion
dopuštenje	autorisation
divlji	sauvage
generacija	génération
propustiti	manquer
kemijski	chimique
liječnik	docteur
zadatak	tâche
smanjiti	réduire
donio	apporté
vježba	exercice
buba	punaise
jamčiti	garantie
vođa	chef
sebi	se
procesi	processus
mekan	doux
sastanci	réunions
sekundi	secondes
let	vol
kongres	congrès
gorivo	carburant
hodati	marche
izrađen	produit
svetac	Saint
argument	argument
konkurencija	compétition
lijekovi	drogues
zajednički	mixte
premija	prime
svježe	Frais
likovi	personnages
pravnik	avocat
di	di
faktor	facteur
tisuća	milliers
km	km
potok	courant
apartmani	appartements
odabrati	choisir
sluh	audition
istočni	est
terapija	thérapie
unosi	entrées
potpisan	signé
upravni	administratif
ozbiljan	sérieux
ograničiti	limite
koraci	pas
trgovine	magasins
ropstvo	esclavage
del	del
napori	efforts
informiran	informé
gA	Géorgie
misli	pensées
potok	ruisseau
ft	ft
količina	quantité
osnovni	essentiel
ture	Tours
opterećenje	charge
odmah	immédiatement
strojevi	Machines
određen	désigné
teško	lourd
pokriven	couvert
oporavak	récupération
integriran	intégré
konfiguracija	configuration
penis	coq
trgovac	marchande
opsežan	complet
stručnjak	expert
zaštititi	protéger
solidan	solide
prezentacija	présentation
postao	devenu
narančasta	Orange
usklađenost	conformité
tema	thème
bogat	riches
kampanja	campagne
vs	contre
gitara	guitare
nalaz	découverte
primjeri	exemples
duh	esprit
ar	ar
zahtjevi	réclamations
prihvaćanje	acceptation
strategije	stratégies
mj	mo
poslovi	affaires
namijenjen	prévu
sa	sa
ciljevi	buts
najam	louer
izbor	élection
predložiti	suggérer
podružnica	branche
poslužiti	servir
podružnice	affiliés
montiranje	monter
latinski	Latin
multimedijalni	multimédia
upravljati	gérer
ugao	coin
rang	rang
element	élément
rođenja	naissance
virus	virus
interaktivni	interactif
zahtjevi	demandes
odvojen	séparé
četvrtina	trimestre
postupak	procédure
rukovodstvo	direction
definirati	définir
vjerski	religieux
činjenicama	faits
doručak	déjeuner
kolona	colonne
vjera	Foi
lanac	chaîne
identificirati	identifier
avenija	rue
nedostaje	disparu
preporuke	recommandations
pomaknuto	déplacé
dohvatiti	atteindre
usporedba	Comparaison
trenutak	moment
produžen	élargi
slijed	séquence
palac	pouce
napad	attaque
centri	centres
otvor	ouverture
laboratorija	laboratoire
rezerva	réserve
gama	gamma
proizvoditi	produire
istina	vérité
brojač	compteur
neuspjeh	échec
slijedi	suit
dolar	dollar
kamp	camp
des	des
filmovi	films
most	pont
ispuniti	remplir
pokret	mouvement
tiskanje	impression
Nacrt	Brouillon
grafikon	graphique
igrao	joué
kontakti	Contacts
čitači	lecteurs
klubovi	clubs
wa	Washington
avantura	aventure
ponuda	offre
dobit	profit
čelnici	dirigeants
plakati	affiches
institucije	institutions
asistent	assistant
varijabla	variable
dj	dj
parkiralište	parking
jučer	hier
odlučan	déterminé
radionica	atelier
otišao	disparu
kodovi	codes
vrste	types
nastavak	extension
izjava	déclarations
potpuno	complètement
timovi	équipes
tvrđava	fort
cm	cm
senat	sénat
smiješno	drôle
gen	gène
okrenut	tourné
disk	disque
uzorak	modèle
čamac	bateau
kazalište	théâtre
proizvođači	fabricants
sponzor	parrainer
klasična	classique
ikona	icône
garancija	garantie
posvećen	dévoué
smjer	direction
košarka	basketball
objekti	objets
izbrisati	effacer
večer	soir
skupština	Assemblée
nuklearni	nucléaire
miš	Souris
signal	signal
kriminalac	criminel
izdaje	Publié
snažan	puissant
san	rêver
NETOČNO	FAUX
da	da
baciti	jeter
cvijet	fleur
osoblje	personnel
prošao	passé
isporučuje	fourni
Slapovi	chutes
duša	âme
unaprijediti	promouvoir
navedeno	déclaré
statistika	Statistiques
profesionalci	professionnels
Čini	apparaît
nositi	porter
zastava	drapeau
korice	couvertures
em	em
prednost	avantage
zdravo	Bonjour
dizajna	dessins
održavati	maintenir
turizam	tourisme
prioritet	priorité
odrasli	adultes
grafički	graphique
atom	atome
plaćanja	Paiements
vezivanje	contraignant
kratak	bref
završeno	terminé
osvajanjem	gagnant
anoniman	anonyme
skripta	scénario
služio	servi
želi	veut
pripremljen	préparé
poništiti	vide
označiti	marque
intervju	entretien
miješati	mélanger
okvir	cadre
disk	disque
instaliran	installée
kraljica	reine
krediti	crédits
jasno	clairement
popraviti	réparer
rukovati	manipuler
slatko	doux
kriteriji	Critères
suradnik	associer
NE	ne
ponašanje	comportement
uvećati	agrandir
zraka	rayon
prihod	revenu
mjera	mesure
glasova	votes
du	du
dužnost	devoir
rasprave	discussions
snositi	ours
dobit	Gain
festival	Festival
laboratorija	laboratoire
ocean	océan
letovi	vols
stručnjaci	experts
znakovi	signes
dubina	profondeur
vlak	train
suho	sec
istražiti	explorer
banja	spa
koncept	concept
skoro	presque
rukovanje	manipulation
podrijetlo	origine
milijardi	milliard
inteligencija	intelligence
kupio	acheté
protiv	escroquerie
nacije	nations
put	route
slomljen	cassé
bitka	bataille
govoriti	parler
protokol	protocole
pitanje	question
partnerstvo	Partenariat
izraz	expression
es	es
govor	discours
žica	câble
prijedlozi	suggestions
zamjena	remplacement
traka	ruban
strateški	stratégique
suditi	juge
kiselina	acide
bajtova	octets
cent	cent
prisiljeni	forcé
kompatibilan	compatible
apartman	appartement
nula	nul
nula	zéro
zvučnik	orateur
savjetodavni	consultant
dizajner	designer
pr	pr
brak	mariage
svitak	rouleau
banke	banques
fr	fr
sudionici	participants
tajna	secret
negativan	négatif
favoriti	favoris
kazalište	théâtre
izvori	ressorts
var	var
izvesti	effectuer
prijevod	Traduction
procjene	estimations
ozljeda	blessure
ministarstvo	ministère
vozači	conducteurs
odvjetnik	avocat
figure	chiffres
zaštićen	protégé
prijedlog	proposition
dijeljenje	partage
portal	portail
beta	bêta
besplatno	gratuitement
prema	vers
malo	légèrement
pomoći	aider
ponašanje	conduite
sadržane	contenu
zakonodavstvo	législation
zvanje	appel
parametri	paramètres
profili	profils
pitanja	questions
kuća	Maisons
kontrole	contrôles
kombinirana	combiné
ultimativno	ultime
predstavnik	représentant
manji	mineur
odjeli	départements
stanovnici	résidents
prikazati	affiché
mama	maman
smanjen	réduit
rijedak	rare
izvedena	réalisée
krajnost	extrême
uzorci	échantillons
barovi	barres
prognoza	prévoir
ukloniti	supprimé
ciklus	cycle
sadržati	contenir
točnost	précision
spavati	dormir
mg	mg
ptica	oiseau
ljekarna	pharmacie
stvaranje	création
statički	statique
Lovac	chasseur
adrese	adresses
dama	Dame
kristal	cristal
poznat	célèbre
pisac	écrivain
predsjednik	président
piće	boisson
akademija	académie
dinamičan	dynamique
jesti	manger
trajan	permanent
čišćenje	nettoyage
tvori	constitue
portfelj	portefeuille
praktičan	pratique
isporučena	livré
infrastruktura	Infrastructure
boja	Couleur
prodavač	vendeur
filozofija	philosophie
regulacija	règlement
službenici	officiers
cilj	objectif
ponude	offres
ishrana	nutrition
snimanje	enregistrement
mlađi	junior
les	les
rt	cap
prstenovi	anneaux
Savjet	pointe
predivan	formidable
ulaznica	billet
najavio	annoncé
nagađati	deviner
kome	qui
nogomet	football
matematika	math
uvoz	importer
postavljanje	affectation
prisutnost	présence
automatski	automatique
gledanja	visualisation
održavati	entretenu
CH	ch
Dan	dan
psi	chiens
direktori	directeurs
aspekti	aspects
naprijed	devant
mjesec	lune
sudjelovanje	participation
shema	schème
letjeti	mouche
držanje	manière
matrica	matrice
kombinacija	combinaison
amandman	amendement
snaga	force
purica	dinde
knjižnice	bibliothèques
ispravan	correct
stupnjeva	degrés
poduzeća	entreprises
delta	delta
strah	peur
traži	recherche
inča	pouces
konvencija	convention
dionice	actions
glavni	principal
udobnost	confort
boje	couleurs
ratovi	guerres
naručivanje	commande
čuva	conservé
alfa	alpha
apel	charme
krstarenje	croisière
bonus	prime
ej	Hey
građevine	bâtiments
specijalaca	promos
pobijediti	battre
baterije	batteries
postaje	devient
diskovi	disques
oružje	bras
čaj	thé
poboljšan	amélioré
postići	atteindre
pozicije	positions
haljina	robe
pretplata	abonnement
prodavač	Marchand
suvremeni	contemporain
nebo	ciel
ROM	ROM
prenosi	porté
izlaganje	exposition
sakriti	cacher
potpis	Signature
mlinar	meunier
opskrba	disposition
odjeća	vêtements
okviri	cadres
sigurno	certainement
novine	journal
igračka	jouet
sloj	couche
tiskan	imprimé
usporiti	lent
uklanjanje	suppression
odgovornost	responsabilité
pisači	imprimantes
dodajući	ajouter
mjesto	place
potrošiti	dépenser
tvornica	usine
unutrašnjost	intérieur
rasti	croître
optički	optique
promocija	promotion
rođak	relatif
nevjerojatan	incroyable
točka	point
identitet	identité
pretvaranje	conversion
osjećaj	sentiment
skriven	caché
razuman	raisonnable
revizija	révision
utjecaj	influence
omjer	rapport
važnost	importance
kiša	pluie
planeta	planète
kopije	copies
dozvola	permis
vidim	voyant
dokaz	preuve
bas	basse
recept	ordonnance
prazan	vide
primjer	exemple
rupa	trou
vožnja	balade
zavod	bureau
konzervacija	préservation
par	paire
idealan	idéal
naočale	spécification
zabilježena	enregistré
Don	Don
komada	pièces
gotov	fini
parkovi	parcs
odvjetnici	avocats
stres	stress
krema	crème
ss	ss
radi	fonctionne
otkriti	découvrir
ap	ap
obrasci	modèles
brda	collines
nm	nm
savjetnik	conseiller
svjestan	conscient
oblik	forme
evolucija	évolution
potvrde	certificats
ciljevi	objectifs
stanice	stations
predložio	suggéré
op	op
ostaci	restes
tvrtke	entreprises
euro	euro
operater	opérateur
strukture	structures
opći	générique
enciklopedija	encyclopédie
upotreba	usage
tinta	encre
mješovit	mixte
popis	recensement
kotač	roue
dobavljači	Fournisseurs
kompaktan	compact
poezija	poésie
svjetla	lumières
praćenje	suivi
anđeo	ange
priprema	préparation
pokušaj	tentative
primanje	recevoir
šibice	allumettes
suglasnost	conformité
širina	largeur
motori	moteurs
zaboraviti	oublier
red	tableau
raspravljati	discuté
točan	précis
klima	climat
grčki	grec
instrukcija	instruction
upravljanje	gérant
sirov	brut
Razlike	différences
objasniti	Explique
uspostaviti	établir
izrazio	exprimé
opseg	ampleur
oštar	tranchant
Ben	ben
stav	paragraphe
ubiti	tuer
matematika	mathématiques
kompenzacija	compensation
izvoz	exportation
menadžeri	gestionnaires
moduli	modules
provedena	menée
verzije	versions
zna	sait
opisati	décrire
građani	citoyens
nasljeđe	patrimoine
nevolja	difficulté
trener	entraîneur
poljoprivredni	agricole
proširiti	développer
publika	public
dodijeljena	attribué
zbirke	collections
dobi	âge
specijalista	spécialiste
kuhati	cuisinier
utjecati	affecter
Djevica	vierge
iskusan	expérimenté
istraga	enquête
uzdignut	relevé
šešir	chapeau
institucija	institution
usmjerene	dirigée
pogođeni	affecté
bicikl	bicyclette
potpuno	totalement
ploča	assiette
troškovi	frais
naznačiti	indiquer
plavuša	blond
postupak	procédure
ljubimac	préféré
karakteristike	caractéristiques
der	der
izgubiti	perdre
organski	biologique
tražiti	chercher
iskustva	expériences
albuma	albums
ugovori	contrats
gosti	invités
domaćin	hébergé
oboljenja	maladies
o	concernant
ekvivalent	équivalent
kemija	chimie
setove	kits
logika	logique
princ	prince
krug	cercle
tlo	sol
psihologija	psychologie
mokar	humide
okolnosti	conditions
investitor	investisseur
osnovni	élémentaire
sponzori	sponsors
lisica	Renard
neograničen	illimité
odgovarati	répondre
veličine	tailles
običan	plaine
Izlaz	Sortie
ruka	bras
ključevi	clés
val	vague
svet	saint
djela	actes
vođenje	orientation
trag	Piste
simbol	symbole
autocesta	Autoroute
promatranom	observé
dekan	doyen
postaviti	installer
anketa	sondage
stilovi	modes
ispunjen	rempli
veza	liaison
kanali	filières
dodatak	annexe
čokolada	Chocolat
dio	portion
djelokrug	portée
dobavljač	fournisseur
kabeli	câbles
pamuk	coton
zahtjev	exigence
ubijen	tué
granica	frontière
antički	ancien
debata	débat
predstavnici	représentants
počinje	départs
trudnoća	grossesse
atrakcije	attractions
naučeno	appris
transakcije	transactions
istraživač	explorateur
povijesni	historique
suprug	mari
odobren	autorisé
lud	fou
Nadolazeći	prochain
koncert	concert
rezultate	scores
efikasnost	Efficacité
komedija	comédie
usvojen	adopté
učinkovit	efficace
linearan	linéaire
opredjeljenje	engagement
specijalitet	spécialité
medvjedi	ours
hmelj	saut
prijevoznik	transporteur
konstantno	constant
Visa	visa
usta	bouche
metar	mètre
povezan	lié
razgovori	interviews
pojmovi	concepts
puška	pistolet
odraziti	réfléchir
čist	pur
pakao	enfer
voće	fruit
počinje	commence
kvalificiran	qualifié
reforma	réforme
leće	lentille
liječi	traités
otkriće	Découverte
crtati	dessiner
svrstan	classifié
pretpostaviti	assumer
savez	Alliance
potvrditi	confirmer
inženjer	ingénieur
dosljedan	cohérent
zamijeniti	remplacer
odobrenje	dégagement
konverter	convertisseur
organizacija	organisation
dijete	bébé
provjere	chèques
postignut	atteint
postaje	devenir
cilj	objectif
naznačeno	indiqué
šećer	sucre
posada	équipage
noge	jambes
štap	bâton
odnos	relation
omogućeno	activée
žanr	genre
dobrovoljac	bénévole
stražnji	arrière
demokratski	démocratique
povećati	améliorer
točno	exact
granica	lié
parametar	paramètre
procesor	processeur
čvor	nœud
formalan	formel
oluja	orage
mikro	micro
fakulteti	collèges
milja	mile
izazovi	défis
urednici	éditeurs
vrhovni	suprême
braća	frères
priznanje	reconnaissance
Najbolje	ref
procjena	estimation
dijete	enfant
inspekcija	inspection
potrošači	consommateurs
granice	limites
teritorija	territoire
oružje	armes
odgoditi	retard
pilot	pilote
doprinosi	contributions
stalan	continu
inicijativa	initiative
roman	roman
izvršenje	exécution
invalidnost	invalidité
ultra	ultra
pobjednik	gagnant
epizoda	épisode
lončar	potier
jelo	plat
igra	pièces
bilten	bulletin
ia	ia
izmijeniti	modifier
uistinu	vraiment
svemir	univers
kandidat	candidat
prorez	fente
izvanredan	exceptionnel
Ha	Ha
planirani	prévu
loža	loge
ogledalo	miroir
turnir	tournoi
obzir	considération
sjednice	sessions
zrno	noyau
kupci	acheteurs
časopisi	revues
siva	gris
katalog	catalogue
optužen	accusé
širok	vaste
und	und
odabran	choisi
demo	demo
mrziti	haine
terminal	Terminal
izdavači	éditeurs
noću	nuits
tekući	liquide
riža	riz
rezervacija	réservation
hrana	nourriture
straža	garde
ušteda	économie
carstvo	Empire
novo	nouvellement
podići	élever
nezakonit	illégal
ekspanzija	expansion
premijer	premier
sutra	demain
mlijeko	Lait
drama	drame
gostujući	visite
Natjecanje	concours
prikupljeni	collectées
bendovi	bandes
pogodan	adapté
apsolutno	absolument
revizija	vérification
komora	chambre
Gvineja	Guinée
nalazi	résultats
izo	iso
tipičan	typique
iznos	somme
piletina	poulet
privremen	temporaire
prisustvovati	assister
tuš	douche
slanje	envoi
dovoljan	suffisant
ljuska	coquille
pokrajina	Province
katolički	catholique
guverner	gouverneur
pivo	Bière
doprinos	contribution
formula	formule
ustav	Constitution
ambalaža	emballage
pouzdan	fiable
sumnjati	doute
zaraditi	gagner
razdoblja	périodes
napadi	attaques
roba	marchandise
simptomi	symptômes
spomen	Mémorial
blizanac	double
umetnuti	insérer
prolaz	passerelle
crtanje	dessin
kandidati	candidats
naredio	commandé
biološki	biologique
borba	combat
tranzicija	transition
postavke	préférences
špijun	espion
romantika	romance
instrument	instrument
podjela	Divisé
teme	thèmes
sile	pouvoirs
raj	paradis
komadići	morceaux
trudna	Enceinte
klasifikacija	classification
usmjerena	concentré
liječnik	médecin
traži	demander
blokovi	blocs
gle	lo
duhovni	spirituel
dijabetes	Diabète
ml	ml
smjena	décalage
sjediti	asseoir
tjelesa	corps
fotografije	photographies
rezanje	Coupe
pisci	écrivains
fleksibilno	flexible
voljen	aimé
favoriti	favoris
kartografija	cartographie
brojan	nombreux
relativno	relativement
predstavlja	représente
superioran	supérieur
poželjna	préféré
spremaju	enregistré
intelektualac	intellectuel
odobreno	accordé
ugljen	carbone
udobno	confortable
magnetski	magnétique
interakcija	interaction
slušanje	écoute
kriza	crise
pogled	perspective
masivan	massif
svijetao	brillant
formirana	formé
klavir	piano
jeka	écho
revolucija	révolution
prikazuje	affiche
plazma	plasma
zarada	gains
misterija	mystère
pejzaž	paysage
mehanički	mécanique
putovanje	périple
zastava	bannière
smokva	figue
županije	comtés
akvizicija	acquisition
priznat	reconnu
snovi	rêves
obavijest	notification
kg	kg
učiti	apprendre
brz	rapide
Vuci	tirer
Juta	Utah
seminar	séminaire
investicije	investissements
kotači	roues
odrediti	spécifier
osjetljiv	sensible
predlošci	modèles
formati	formats
drži	détient
usmjerivač	routeur
beton	béton
si	si
mapa	dossier
završetak	achèvement
puls	impulsion
tehnika	technique
glasanje	vote
sudovi	tribunaux
pretvaraju	converti
metro	métro
godišnjica	anniversaire
poboljšanja	améliorations
traka	bande
specifikacija	spécification
nesreća	accident
zarez	entaille
dostupan	accessible
Rezidencija	résident
zemljište	terrain
tipično	typiquement
prikaz	représentation
pumpa	pompe
postoji	existe
aranžmani	arrangements
konferencije	conférences
potrošnja	consommation
suziti	étroit
prijetnja	menace
ankete	enquêtes
sjedenje	séance
konzultant	consultant
kontrolor	manette
odbori	comités
penis	pénis
dvorac	Château
vrtovi	jardins
etikete	Étiquettes
spreman	prêt
bio	bio
gluma	agissant
glave	têtes
ispit	examen
prebivalište	résidence
gustoća	densité
stotina	cent
čudan	étrange
održiv	durable
statistički	statistique
spomenuti	mention
inovacija	innovation
siva	gris
paralelno	parallèle
raditi	fonctionner
novčanice	factures
stabilan	stable
definicije	définitions
von	von
liječnici	médecins
lekcija	leçon
kino	cinéma
izbori	élections
reakcija	réaction
prazan	blanc
poboljšane	renforcée
pravo	intitulé
ozbiljan	sévère
generirati	produire
novine	journaux
bolnice	hôpitaux
vi	vi
humor	humour
star	vieilli
monitori	moniteurs
izuzetak	exception
trajanje	durée
Glavnina	masse
posjeta	visites
sposobnosti	capacités
preporuka	recommandation
grijeh	péché
organizirani	organisé
ba	ba
stavak	para
posvajanje	adoption
poboljšanje	améliorer
skup	coûteux
bizon	buffle
organizacija	organisations
avion	avion
programi	programmes
mehanizam	mécanisme
ee	ee
obilježen	marqué
upravljan	poussé
boca	bouteille
inovativan	innovant
masaža	massage
zaključak	conclusion
zatvaranje	fermeture
tisuću	mille
legenda	Légende
vila	villa
kost	OS
stupovi	colonnes
poremećaji	troubles
kolaboracija	collaboration
otkrivanje	détection
unutrašnji	interne
formacija	formation
med	med
inženjeri	ingénieurs
osoba	entité
krstarenja	Croisières
vrata	porte
rimski	romain
dužnosti	fonctions
erotski	érotique
ton	Ton
etika	éthique
zmaj	dragon
zaposlen	occupé
kapetan	capitaine
donosi	apporte
grijanje	chauffage
noga	jambe
vrat	cou
krilo	aile
skripta	scripts
abeceda	abc
postavljen	nommé
bavljenje	transaction
počiniti	commettre
željeznički	rail
putovanja	voyages
praznina	écart
strane	côtés
cijev	tube
odgovara	correspondant
opisi	descriptions
pojas	ceinture
jakna	veste
animacija	animation
proročanstvo	oracle
er	er
produkcija	productions
zrakoplovstvo	aviation
ponos	fier
katastrofa	catastrophe
konzola	console
naredbe	commandes
jr	jr
telekomunikacija	télécommunications
instruktor	instructeur
gigantski	géant
postići	réalisé
ozljede	blessures
pristupi	approches
uobičajen	habituel
marke	timbres
kut	angle
opljačkati	Rob
dizajneri	concepteurs
sloboda	liberté
doba	ère
Pretvoriti	convertir
mogućnost	possibilité
analitičar	analyste
opasno	dangereux
pouzdanost	fiabilité
odnosno	respectivement
volonteri	bénévoles
izveden	dérivé
zadovoljstvo	plaisir
čast	honneur
orijentiran	orienté
orao	Aigle
molitva	prière
radionice	ateliers
uragan	ouragan
miran	silencieux
proizvođač	producteur
zastupljeni	représentée
odgovornosti	responsabilités
sir	fromage
pažljivo	soigneusement
produktivnost	productivité
kruna	couronne
jednakost	par
dijagnoza	diagnostic
tvorac	fabricant
pukotina	fissure
načelo	principe
motika	choix
banda	gang
fetiš	fétiche
izgled	apparence
dim	fumée
filteri	filtres
inkorporiran	incorporé
čamac	artisanat
kolega	compagnon
slijep	aveugle
salon	salon
lud	furieux
algoritam	algorithme
snažno	fortement
kafić	café
znanje	ken
proteini	protéines
Su	su
upoznat	familier
sposoban	capable
ulaz	admission
cipela	chaussure
izabran	élu
nošenje	portant
terorizam	terrorisme
radost	joie
izdanja	éditions
etnički	ethnique
parlament	parlement
glumac	acteur
nalazi	découvertes
pečat	joint
situacije	situations
peti	cinquième
građanin	citoyen
vertikala	verticale
ispravke	corrections
opisuje	décrit
invaliditetom	handicapées
supstanca	substance
zabranjen	interdit
cijev	tuyau
vojnici	soldats
čuvar	Gardien
predavanje	conférence
simuliranje	simulation
raspored	disposition
inicijative	initiatives
bolestan	mauvais
koncentracija	concentration
položiti	allonger
tumačenje	interprétation
prljav	sale
učio	enseigné
radnik	ouvrier
optimizacija	optimisation
hram	temple
tvari	substances
dokazati	prouver
otkriven	découvert
krila	ailes
genetski	génétique
ograničenja	restrictions
tanak	mince
izložba	exposition
greben	crête
modem	modem
donošenje	apportant
bolestan	malade
procijeniti	évaluer
tropski	tropical
prikupiti	collecte
vektor	vecteur
definitivno	absolument
tokarenje	tournant
postojanje	existence
komentar	commentaire
razvoj	développements
imigracija	immigration
destinacije	destinations
zajednički	mutuel
sintaksa	syntaxe
li	li
atribut	attribut
zatvor	prison
vještina	compétence
stolice	chaises
okolni	alentours
planine	montagnes
popularnost	popularité
pitanje	enquête
provjeren	vérifié
izložak	exposition
bacanje	jeter
trend	tendance
mačke	chats
pustinja	désert
ya	ya
koordinator	coordinateur
Merkur	Mercure
spaljivanje	brûlant
pobjeći	échapper
prijamnik	destinataire
progresivan	progressive
brodovi	bateaux
prvenstvo	championnat
arkada	arcade
nemoguće	impossible
govori	dit
očigledan	évident
depresija	dépression
grafikon	graphique
pokrivati	couvrant
platina	platine
osuda	jugement
razgovori	pourparlers
podnošenje	dépôt
gajiti	favoriser
nagrađen	décerné
ispitivanja	essais
majstori	maîtrise
kaseta	cartouche
obrazloženje	explication
org	org
prevara	fraude
elektricitet	électricité
spektar	spectre
dolazak	arrivée
posuđe	poterie
isticanje	accentuation
super	impressionnant
potvrđen	confirmé
broji	compte
sudar	crash
lift	ascenseur
između	entre
visine	hauteurs
sjena	ombre
trošak	frais
pothvat	entreprise
Klinika	clinique
liječenje	guérison
princeza	Princesse
ulazak	entrer
paket	paquet
studio	studios
učešće	participation
tata	papa
tipke	boutons
plasman	placement
zapažanja	observations
pobjednici	gagnants
ceste	routes
sljedeći	subséquent
dvorište	Cour
otkriće	divulgation
osnivanje	établissement
sjećanja	souvenirs
TE	te
stvara	crée
lica	visages
turist	touristique
ubiti	meurtre
adekvatan	adéquat
senator	sénateur
prezentacije	présentations
probaviti	digérer
prah	poussière
wiki	wiki
zamijeniti	remplacé
radar	radar
gubici	pertes
borba	combat
smanjivanje	réduire
prestao	arrêté
okupacija	Occupation
tijesno	étroitement
radijacija	radiation
kraljevi	rois
pucanje	tournage
uho	oreille
zastave	drapeaux
pekar	boulanger
konzervativan	conservateur
šok	choc
efikasnost	efficacité
kravata	attacher
krov	toit
pokazati	démontrer
atmosfera	atmosphère
poljubac	baiser
zvijer	bête
ra	ra
operiran	exploité
eksperiment	expérience
ciljevi	cibles
kupi	achats
federacija	fédération
pizza	Pizza
pozvan	invité
zadatak	affectation
modni	mod
upita	requêtes
odsutnost	absence
dobavljači	vendeurs
joga	yoga
služi	sert
iznenađenje	surprise
svjetiljka	lampe
vicevi	blagues
savjetovanje	conseils
palača	palais
zadovoljan	satisfait
pobjeda	victoires
skladište	entrepôt
trebala	supposé
običan	ordinaire
duh	fantôme
povreda	violation
šef	patron
ponos	fierté
očekivanja	attentes
nezavisnost	indépendance
poznavanje	connaissance
reporter	journaliste
metabolizam	métabolisme
prvak	champion
lično	personnellement
mnogo	beaucoup
solo	solo
grlo	gorge
bogatstvo	richesse
vakuum	vide
ples	dansant
prepoznati	reconnaître
piše	écrit
trg	place
traganje	quête
objaviti	publier
probir	dépistage
trans	trans
pionir	pionnier
zaboravljen	oublié
akrobata	acrobate
ploče	plaques
eseji	essais
ponašanje	comportement
reći	récit
pošteno	équitablement
inteligentan	intelligent
načini	modes
obaveza	obligation
luka	port
putnik	voyageur
segment	segment
neprijatelj	ennemi
puzzle	puzzle
bunara	puits
ograničen	limité
republikanac	républicain
tajne	secrets
sindrom	syndrome
pohađanje	présence
kazna	peine
bubanj	tambour
omogućuje	permet
graditelj	constructeur
vidik	vue
poplava	inonder
olakšati	facilité
argumenti	arguments
arena	arène
avanture	aventures
zjenice	élèves
Obavijest	annonce
ishod	résultat
cijeniti	apprécier
proširen	étendu
odrastao	mûr
lijep	charmant
centri	centres
klauzula	clause
osmijeh	sourire
zemljišta	terres
trupe	troupes
naoružan	armé
bor	pin
hlađenje	refroidissement
zaljev	golfe
kamioni	camions
mehanizmi	mécanismes
razvod	divorce
tradicija	tradition
tablete	pilules
tigar	tigre
ljudi	gens
senzor	capteur
izložen	exposé
lov	chasse
anđeli	anges
zamjenik	adjoint
thai	thaïlandais
emisija	émissions
liječnici	médecins
prigovor	plainte
scene	scènes
pokusi	expériences
pojačati	renforcer
vladavina	gouvernance
mlin	moulin
osnovan	fondé
kroničan	chronique
jazbina	tanière
prst	doigt
drži	garde
funta	livre
pronaći	Localiser
pl	PL
obučen	qualifié
provođenje	exécution
kruh	pain
motori	moteurs
tvrd	dure
incident	incident
dinamika	dynamique
laž	mensonge
razgovor	conversation
smanjenje	diminution
obožavanje	culte
sposobnost	aptitude
ak	Alaska
preciznost	précision
štete	dégâts
rezerve	réserves
riješiti	résoudre
manjina	minorité
drugačiji	diverse
Sastojci	Ingrédients
Ah	ah
tonovi	tons
rehabilitacija	réhabilitation
vid	vue
glina	argile
slab	faible
podijeljen	divisé
recepcija	accueil
mudar	sage
izgledi	chances
seminari	séminaires
posljedice	conséquences
odluka	décideurs
geografija	géographie
integritet	intégrité
nasljedstvo	héritage
zadovoljan	heureux
opasnost	danger
vitamin	vitamine
obrađen	traité
fraza	phrase
podizanje	élevage
implikacije	implications
funkcionalnost	fonctionnalité
raj	paradis
hibrid	hybride
čita	lit
emotivan	émotif
slava	gloire
ja	ja
geografski	géographique
prekoračiti	dépasser
štap	barre
svila	soie
bebe	bébés
dvo	bi
romantičan	romantique
objavi	révélé
stručnjaci	spécialistes
generator	Générateur
suspenzija	suspension
tužan	triste
korekcija	correction
vuk	Loup
polako	lentement
dopuniti	supplément
dijelovi	portions
dječji	bébé
sektori	secteurs
tekućina	fluide
teren	terrains
obrok	repas
tA	ta
strojevi	machinerie
jednadžba	équation
košare	paniers
vjerojatnost	probabilité
dimenzija	dimension
studirao	étudié
dobit	bénéfices
vrag	diable
trava	herbe
ilustrirano	illustré
trešnja	Cerise
kontinentalni	continental
dostignuće	réussite
ograničenja	limites
pogreb	funérailles
poglavlja	chapitres
putnik	passager
zgodan	pratique
Mars	Mars
veličine	taille
jaje	Oeuf
signali	signaux
orijentacija	orientation
krađa	vol
djetinjstvo	enfance
simboli	symboles
lat	lat
meta	méta
analog	analogique
talenat	Talent
datiran	daté
mudrost	sagesse
granica	frontière
elita	élite
vojnik	gi
vjeruje	croit
pjesme	poèmes
nadležnost	juridiction
robot	robot
prikazivanje	visualisation
svjedok	témoin
opremljen	équipé
faze	étapes
sur	sur
stečena	acquis
procijeniti	évaluer
pranje	lavage
ulaz	entrée
izjava	déclaration
gubljenje	perdant
pokušaji	tentatives
plemenite	noble
automatizacija	automatisation
utjecaji	impacts
revolucija	tour
prednosti	avantages
vitez	Chevalier
ciljevi	objectifs
ekstenzije	extensions
žalbe	appels
bolest	maladie
Ho	ho
alternative	alternatives
sh	sh
sapun	savon
pekmez	confiture
neuobičajen	inhabituel
odgovorio	répondu
razaranje	destruction
migracija	migration
poremećaj	désordre
konvencionalne	conventionnel
nošenje	portant
os	axe
traži	recherché
geni	gènes
srednja	médian
skener	scanner
ovdje	ici
animirani	Animé
podešavanje	ajustement
junak	héros
tretmani	traitements
stav	attitude
tepih	tapis
leće	lentilles
prisustvovao	assisté
teškoća	difficulté
punk	punk
koalicija	coalition
upis	inscription
vojvoda	Duc
tempo	rythme
proizvođači	producteurs
luk	arc
sučelja	interfaces
atlas	atlas
zapažanje	observation
mučenje	torture
izbrisana	supprimé
kaput	manteau
obnova	restauration
pogodnost	commodité
povratak	retour
opozicija	opposition
kontejner	récipient
tuženik	défendeur
nadglednik	superviseur
korpus	corps
glumci	acteurs
jetra	foie
odgovoran	assujetti
peticija	pétition
antena	antenne
izabran	choisi
vjerovanje	croyance
ubijanje	meurtre
rame	épaule
dekor	décor
ion	ion
promjer	diamètre
podcast	Podcast
interakcije	interactions
pjevač	chanteur
glasnik	héraut
starenje	vieillissement
intervencija	intervention
uključiti	brancher
privlačnost	attraction
ronjenje	plongée
modifikacija	modification
pretpostaviti	supposer
trska	roseau
obuhvatiti	impliquer
umjeren	modérer
miševi	souris
razumjeti	compris
brzo	rapidement
zabrana	interdire
uvjerenje	assurance
događa	événement
ogroman	vaste
mlinovi	moulins
obris	contour
prima	reçoit
traperice	jeans
kompilacija	compilation
neparan	impair
sigma	Sigma
gr	gr
atraktivan	attrayant
prilika	occasion
snimke	enregistrements
žrtva	victime
zahtjevi	demandes
pažljiv	prudent
snop	faisceau
vrtlarstvo	jardinage
obveze	obligations
stići	arrivée
orkestar	orchestre
licenca	Licence
prilagodljiv	Ajustable
namjena	allocation
esej	essai
pokazao	démontré
dijalog	dialogue
kampovi	camps
proglašen	déclaré
trag	trace
zatvoriti	fermer
omot	paquets
