arasında	di
için	a
içinde	in
için	per
olduğu	è
üzerinde	sopra
o	quella
tarafından	di
bu	Questo
ile	con
ben	io
sen	tu
o	esso
veya	o
olmak	essere
Hangi	siamo
en	a
herşey	tutti
var	avere
yeni	nuovo
Biz	noi
irade	volere
ev	casa
bize	noi
hakkında	di
Eğer	Se
sayfa	pagina
benim	mio
vardır	ha
arama	ricerca
ücretsiz	gratuito
fakat	ma
bizim	nostro
bir	uno
diğer	altro
yap	fare
bilgi	informazione
zaman	tempo
o	lui
hangi	quale
onların	loro
haber	notizia
kullanım	uso
Orada	Là
görmek	vedere
yani	così
kim	chi
ağ	web
Ayrıca	anche
almak	ottenere
pm	pm
görünüm	vista
c	c
e	e
ilk	primo
olmuştur	stato
olur	voluto
idi	erano
s	S
sevmek	piace
x	X
göre	di
bulmak	trova
fiyat	prezzo
geri	indietro
üst	superiore
insanlar	persone
vardı	aveva
liste	elenco
isim	nome
sadece	appena
yıl	anno
gün	giorno
içine	in
iki	Due
sağlık	Salute
n	n
yeniden	ri
Kullanılmış	Usato
gitmek	partire
b	B
son	ultimo
Yapmak	rendere
onları	loro
meli	dovrebbero
ürün	Prodotto
sistem	sistema
posta	inviare
ona	sua
Kent	città
t	t
politika	politica
numara	numero
destek	supporto
mesaj	Messaggio
sonra	dopo
sonra	poi
Ocak	gennaio
iyi	bene
d	d
nerede	dove
bilgi	Informazioni
haklar	diritti
kitaplar	libri
yüksek	alto
okul	scuola
m	m
her	ogni
bağlantılar	link
o	lei
yıl	anni
sipariş	ordine
çok	molto
kitap	libro
ürün	elementi
şirket	azienda
r	r
okumak	leggere
grup	gruppo
seks	sesso
çok	molti
kullanıcı	utente
de	de
set	impostato
genel	generale
Araştırma	ricerca
Üniversite	Università
Ocak	gennaio
posta	posta
tam	pieno
yorumlar	recensioni
program	programma
bilmek	conoscere
oyunlar	Giochi
yol	modo
günler	giorni
p	p
Bölüm	parte
could	poteva
harika	grande
birleşmiş	unito
gerçek	vero
f	f
Uluslararası	internazionale
merkez	centro
seyahat	viaggio
yorumlar	Commenti
yapılmış	fatto
gelişme	sviluppo
rapor	rapporto
üye	membro
ayrıntılar	dettagli
hat	linea
şartlar	condizioni
önce	prima
oteller	alberghi
did	fatto
göndermek	inviare
sağ	destra
tip	genere
yerel	Locale
bu	quelli
Sonuçlar	risultati
ofis	ufficio
Ulusal	nazionale
araba	auto
dizayn	design
almak	prendere
gönderildi	postato
adres	indirizzo
topluluk	Comunità
içinde	entro
devletler	stati
istemek	volere
telefon	Telefono
DVD	DVD
konu	soggetto
arasında	fra
forum	Forum
aile	famiglia
l	l
uzun	lungo
w	w
göstermek	mostrare
O	o
Üstelik	anche
siyah	nero
özel	speciale
indeks	indice
olmak	essere
KADIN	donne
çok	tanto
işaret	cartello
dosya	file
bağlantı	collegamento
açık	Aperto
güney	Sud
dava	Astuccio
proje	progetto
sayfalar	pagine
versiyon	versione
Bölüm	sezione
kendi	proprio
ev	Casa
güvenlik	sicurezza
g	g
kontluk	contea
Amerikan	americano
Fotoğraf	foto
oyun	gioco
üyeler	membri
güç	energia
ağ	Rete
bilgisayar	computer
sistemler	sistemi
üç	tre
yer	posto
son	fine
h	h
onu	lui
başına	per
erişim	accesso
düşünmek	pensare
kuzeyinde	nord
kaynaklar	risorse
şimdiki	attuale
büyük	grande
medya	media
kanun	legge
kontrol	controllo
Su	acqua
Tarihçe	storia
boyut	dimensione
kişisel	personale
kılavuz	guida
Dükkan	negozio
rehber	elenco
değişiklik	modificare
beyaz	bianca
Metin	testo
küçük	piccolo
değerlendirme	valutazione
oran	Vota
hükümet	governo
çocuklar	bambini
dönüş	ritorno
öğrencilerin	studenti
v	v
hesap	account
zamanlar	volte
seviye	livello
dijital	digitale
profil	profilo
önceki	precedente
form	modulo
olaylar	eventi
Aşk	amore
eski	vecchio
John	John
ana	principale
aramak	chiamata
görüntü	Immagine
Bölüm	Dipartimento
Başlık	titolo
olmayan	non
k	K
y	y
sigorta	assicurazione
acak	deve
özellik	proprietà
sınıf	classe
CD	CD
kalite	qualità
her	ogni
listeleme	listato
içerik	soddisfare
ülke	nazione
küçük	piccolo
araçlar	utensili
düşük	Basso
cevap	rispondere
müşteri	cliente
Aralık	dicembre
karşılaştırmak	confrontare
filmler	film
kolej	Università
değer	valore
makale	articolo
adam	uomo
Meslekler	lavori
j	j
Gıda	cibo
yazar	autore
farklı	diverso
u	u
öğrenmek	imparare
satış	saldi
baskı	stampare
kurs	corso
iş	lavoro
oda	camera
Stok	azione
Eğitim	formazione
çok	pure
kredi	credito
puan	punto
Bilim	scienza
erkekler	uomini
kategoriler	categorie
batı	ovest
bak	Guarda
ingilizce	Inglese
takım	squadra
arazi	tenuta
Kutu	scatola
koşullar	condizioni
fotoğraflar	fotografie
eşcinsel	gay
iplik	filo
kategori	categoria
Not	Nota
canlı	vivere
büyük	grande
galeri	galleria
tablo	tavolo
ancak	però
Haziran	giugno
Ekim	ottobre
Kasım	novembre
Market	mercato
kütüphane	biblioteca
aksiyon	azione
başla	inizio
dizi	serie
Özellikler	Caratteristiche
hava	aria
sanayi	industria
plan	Piano
insan	umano
Evet	sì
ikinci	secondo
Sıcak	caldo
maliyet	costo
film	film
forumlar	forum
Mart	marzo
la	la
Eylül	settembre
söylemek	dire
gidiyor	andando
tıbbi	medico
arkadaş	amico
Aralık	dicembre
sunucu	server
uygulama	applicazione
Personel	personale
oyun	giocare
sorunlar	problemi
Nisan	aprile
kullanıcılar	utenti
sokak	strada
konu	argomento
karşısında	contro
var	avuto
Blog	blog
Parti	festa
ödeme	pagamento
ekipman	attrezzatura
let	permettere
programlar	programmi
yasal	legale
son	recente
park	parco
davranmak	atto
sorun	problema
kırmızı	rosso
vermek	dare
bellek	memoria
performans	prestazione
sosyal	sociale
q	q
Öykü	storia
satmak	vendere
seçenekleri	opzioni
deneyim	Esperienza
anahtar	chiave
vücut	corpo
genç	giovane
önemli	importante
alan	campo
az	pochi
Doğu	est
tek	singolo
ii	ii
yaş	età
kulüp	club
örnek	esempio
kızlar	ragazze
z	z
yol	strada
hediye	regalo
soru	domanda
CA	circa
zor	difficile
ödeme	pagare
dört	quattro
poker	poker
konu	problema
menzil	gamma
bina	costruzione
satıcı	venditore
mahkeme	Tribunale
Şubat	febbraio
sonuç	risultato
ışık	leggero
yazmak	Scrivi
savaş	guerra
teklif	offrire
mavi	blu
gruplar	gruppi
ark	al
kolay	facile
verilmiş	dato
istek	richiesta
faks	fax
Çin	Cina
yapma	fabbricazione
resim	immagine
ihtiyaçlar	esigenze
mümkün	possibile
ay	mese
majör	maggiore
star	stella
gelecek	futuro
uzay	spazio
Kurul	Comitato
el	mano
Güneş	sole
kartları	carte
Londra	Londra
toplantı	incontro
olmak	diventare
çocuk	bambino
Tut	conservare
porno	porno
pay	Condividere
benzer	simile
Bahçe	giardino
okullar	scuole
milyon	milione
katma	aggiunto
referans	riferimento
şirketler	aziende
bebek	bambino
öğrenme	apprendimento
enerji	energia
koşmak	correre
teslim	consegna
popüler	popolare
terim	termine
film	film
hikayeleri	storie
koymak	mettere
dergi	rivista
raporlar	rapporti
ko	co
Deneyin	provare
Görüntüler	immagini
ihbar	Avviso
Allah	Dio
orijinal	originale
kafa	capo
radyo	Radio
hücre	cellula
konsey	consiglio
içerir	include
Izlemek	traccia
tartışma	discussione
Arşiv	archivio
diğerleri	altri
anlaşma	accordo
biçim	formato
toplum	società
ay	mesi
Emniyet	sicurezza
Arkadaş	amici
emin	sicuro
baskı	edizione
mesajları	messaggi
pazarlama	marketing
söylemek	raccontare
birleşme	associazione
sağlar	fornisce
eğlence	divertimento
zaten	già
yeşil	verde
çalışmalar	studi
kapat	vicino
ortak	Comune
özel	specifica
birkaç	parecchi
yaşam	vita
Toplamak	collezione
denilen	chiamato
kısa	corto
sanat	arti
çok	lotto
Sor	Chiedere
sınırlı	limitato
çözeltiler	soluzioni
yönetmen	direttore
plaj	spiaggia
geçmiş	passato
doğal	naturale
elektronik	elettronica
üzerine	su
dönem	periodo
planlama	pianificazione
diyor	dice
resmi	ufficiale
mar	mar
tamam	fatto
teknik	tecnico
pencere	finestra
profesyonel	professionista
bölge	regione
ada	isola
kayıt	disco
direkt	diretto
konferans	conferenza
kayıtlar	record
st	st
ilçe	quartiere
takvim	calendario
maliyetler	costi
stil	stile
Beyan	dichiarazione
mil	miglia
kaynak	risorsa
uygulamaları	applicazioni
belge	documento
sözcük	parola
Eserleri	lavori
malzeme	Materiale
fatura	conto
yazılı	scritto
kurallar	regole
nihai	finale
şey	cosa
merkez	centro
Gereksinimler	requisiti
DOĞRU	VERO
dakika	minuti
Başka	altro
işaret	marchio
Kaya	roccia
kötü	cattivo
bireysel	individuale
artı	più
Oto	auto
kapak	copertina
Düzenle	modificare
birlikte	insieme
videolar	video
hızlı	veloce
fonksiyon	funzione
gerçek	fatto
alma	ottenere
global	globale
teknoloji	Tech
karşılamak	incontrare
uzak	lontano
ekonomik	economico
tr	it
oyuncu	giocatore
projeler	progetti
Miktar	quantità
izlemek	orologio
dahil	incluso
hissetmek	sentire
banka	banca
risk	rischio
fırsatlar	offerte
çeşitli	vario
kelimeler	parole
üretim	produzione
ticari	commerciale
ağırlık	peso
kalp	cuore
tedavi	trattamento
makas	punti
bilgi	conoscenza
dergi	rivista
hata	errore
kamera	telecamera
kız	ragazza
inşaat	costruzione
oyuncaklar	giocattoli
kayıtlı	registrato
domain	dominio
yöntemleri	metodi
bölüm	capitolo
koruma	protezione
politikaları	politiche
geniş	largo
güzellik	bellezza
müdür	manager
Hindistan	India
pozisyon	posizione
alınmış	prese
çeşit	ordinare
listeleri	annunci
bilinen	conosciuto
yarım	metà
vakalar	casi
adım	passo
mühendislik	ingegneria
basit	semplice
hızlı	Presto
lisans	licenza
göl	lago
bütün	totale
yıllık	annuale
yayınlanan	pubblicato
kilise	Chiesa
yöntem	metodo
aktif	attivo
tepki	risposta
şekil	figura
malzemeler	materiale
yeterli	abbastanza
tasarlanmış	progettato
arasında	tra
ölüm	Morte
kayıp	perdita
yüz	viso
marka	marca
indirim	sconto
Etkileri	effetti
oluşturulan	creato
standartlar	norme
bit	po
siyasi	politico
krallık	regno
baz	base
iş	fare
krediler	prestiti
ayakkabı	scarpe
giriş	iscrizione
kalmak	restare
emirler	ordini
kullanılabilirlik	disponibilità
özet	sommario
dönüş	turno
büyüme	crescita
Ajans	agenzia
kral	re
Avrupa	europeo
aktivite	attività
kopya	copia
batı	occidentale
Kuvvet	vigore
iş	occupazione
Defne	baia
nehir	fiume
komisyon	commissione
paket	pacchetto
görüldü	visto
oyuncu	Giocatori
motor	motore
Liman	porta
albüm	album
bölgesel	regionale
durdurmak	Stop
başladı	iniziato
yönetim	amministrazione
bar	bar
enstitü	istituto
görünümler	visualizzazioni
çift	Doppio
köpek	cane
yakında	presto
hatlar	Linee
elektronik	elettronico
faydaları	benefici
gerekli	necessaria
yazıcı	stampante
şart	condizione
etkili	efficace
inanmak	credere
organizasyon	organizzazione
Efekt	effetto
us	mente
seçim	selezione
kumarhane	casinò
pdf	PDF
tur	giro
çapraz	attraversare
umut	speranza
şirket	società
dilek	desiderio
çözüm	soluzione
olgun	maturo
rol	ruolo
haftalar	settimane
belli	certo
alt	inferiore
gerekli	necessario
Birlik	unione
Pazartesi	mon
com	com
belirli	particolare
ince	bene
saat	ora
gaz	gas
becerileri	abilità
altı	sei
çalı	cespuglio
adaları	isole
tavsiye	consigli
kariyer	carriera
karar	decisione
ayrılmak	partire
önceden	pre
Kocaman	enorme
Kadın	donna
tesisler	strutture
teklif	offerta
orta	mezzo
kablo	cavo
fırsatlar	opportunità
alma	presa
değerler	valori
bölünme	divisione
gelecek	venuta
nesne	oggetto
lezbiyen	lesbica
uygun	adeguata
makine	macchina
logo	logo
uzunluk	lunghezza
Güzel	simpatico
Gol	Punto
istatistik	statistica
müşteri	cliente
Numune	campione
yatırım	investimento
gönderilen	inviato
gösterilen	mostrato
Noel	Natale
kültür	cultura
flaş	veloce
MS	Signorina
seçim	scelta
dersler	corsi
tüketici	consumatore
Merhaba	Ciao
yabancı	straniero
sanatçı	artista
mobilya	mobilia
kanal	canale
mektup	lettera
kip	modalità
telefonlar	telefoni
fikirler	idee
yapı	struttura
derece	grado
sözleşme	contrarre
Süper	super
erkek	maschio
madde	importa
neredeyse	quasi
bulunan	collocato
çoklu	multiplo
dağıtım	distribuzione
editör	editore
Han	Locanda
Sanayi	industriale
potansiyel	potenziale
şarkı	canzone
los	los
düşmek	autunno
Fikir	idea
Odalar	camere
iletişim	comunicazioni
kazanmak	vincere
birincil	primario
kanser	cancro
sayılar	numeri
neden	ragionare
araç	strumento
bahar	primavera
vakıf	fondazione
Cevap	risposta
ses	voce
program	programma
evraklar	documenti
amaç	scopo
özellik	caratteristica
yatak	letto
geliyor	viene
polis	polizia
bağımsız	indipendente
yaklaşım	approccio
kahverengi	Marrone
fiziksel	fisico
Tepe	collina
haritalar	mappe
ambar	tenere
derecelendirme	giudizi
mutlu	contento
demirci	fabbro
gelişmiş	sviluppato
teşekkür	grazie
kasa	sicuro
benzersiz	unico
anket	sondaggio
önceki	precedente
telefon	telefono
spor	sport
hazır	pronto
hayvan	animale
kaynaklar	fonti
nüfus	popolazione
baba	papà
düzenli	regolare
güvenli	sicuro
operasyonlar	operazioni
basitçe	semplicemente
kanıt	prova
istasyon	stazione
anlama	capire
seçenek	opzione
vadi	valle
muhtemelen	probabilmente
deniz	mare
yayınlar	pubblicazioni
iyileştirmek	Migliorare
bağ	connessione
Yayımcı	editore
salon	sala
anti	anti
ağlar	reti
toprak	terra
ebeveyn	genitori
darbe	urto
Aktar	trasferimento
Giriş	introduzione
mutfak	cucina
kuvvetli	forte
düğün	nozze
özellikleri	proprietà
hastane	ospedale
zemin	terra
gemi	nave
Konaklama	alloggio
hastalık	malattia
mükemmel	eccellente
mükemmel	perfezionare
saç	capelli
fırsat	opportunità
malzeme	kit
klasik	classico
temel	base
komuta	comando
şehirler	città
ekspres	esprimere
ödül	premio
mesafe	distanza
ağaç	albero
değerlendirme	valutazione
duvar	parete
ilgili	coinvolti
el	EL
ekstra	extra
özellikle	particolarmente
bütçe	bilancio
kılavuzlar	guide
başarı	successo
maksimum	massimo
anne	mamma
operasyon	operazione
mevcut	esistente
oldukça	abbastanza
seçilmiş	selezionato
oğlan	ragazzo
restoranlar	ristoranti
güzel	bellissimo
uyarı	avvertimento
yerleri	posizioni
at	cavallo
oy	votazione
Çiçekler	fiori
yıldızlar	stelle
listeleri	liste
sahip	proprietario
hayvanlar	animali
yolları	modi
oğul	figlio
sağlama	fornitura
kural	regola
Konut	alloggiamento
alır	prende
getirmek	portare
katalog	Catalogare
maksimum	max
anne	madre
yetki	autorità
söyledi	detto
program	programma
katıldı	Iscritto
giriş	ingresso
strateji	strategia
ayaklar	piedi
ajan	agente
geçerli	valido
modern	moderno
kıdemli	anziano
seksi	sexy
öğretim	insegnamento
kapı	porta
büyük	grande
Deneme	prova
birimler	unità
güzel	freddo
normal	normale
kuruluş	impresa
gemiler	navi
tüm	intero
pozitif	positivo
Fitness	fitness
Çince	Cinese
görüş	opinione
Futbol	calcio
soyut	astratto
çıktı	produzione
para	fondi
Bay	Sig
muhtemelen	probabile
geliştirmek	sviluppare
sanatçılar	artisti
alternatif	alternativa
sorumluluk	responsabilità
java	Giava
konuk	ospite
yayın	pubblicazione
pas	passaggio
ilişkiler	relazioni
güven	fiducia
kamyonet	furgone
içeren	contiene
çok	Multi
cumhuriyet	repubblica
harç	tasse
bileşenler	componenti
tatil	vacanza
yüzyıl	secolo
akademik	accademico
yardım	assistenza
tamamlanan	completato
cilt	pelle
grafik	grafica
Hintli	indiano
halka	squillare
sınıf	grado
dağ	montagna
organizasyonlar	organizzazioni
filtre	filtro
panel	pannello
zemin	pavimento
alış	acquisto
maç	incontro
önerilen	proposto
gerektirir	richiedere
çocuklar	ragazzi
sabah	mattina
verir	consente
protein	proteina
bitki	pianta
rapor	segnalati
vurmak	colpire
aa	mm
havuz	piscina
mini	mini
siyaset	politica
ortak	compagno
yazarlar	autori
panoları	tavole
balık	pesce
üyelik	membri
misyon	missione
göz	occhio
sicim	stringa
duyu	senso
değiştirilmiş	modificata
yayınlandı	rilasciato
evre	palcoscenico
iç	interno
doğmuş	Nato
detaylı	dettagliato
Japonca	giapponese
yarış	gara
onaylı	approvato
hedef	bersaglio
dışında	tranne
karakter	carattere
bakım	Manutenzione
kabiliyet	capacità
ed	Ed
kolza	stupro
pil	batteria
gençlik	gioventù
basınç	pressione
gönderilen	presentata
borç	debito
orta	medio
televizyon	televisione
Ilgilenen	interessato
çekirdek	nucleo
mola	rompere
amaçlar	scopi
kümeler	imposta
dans	danza
ahşap	legna
tanımlanmış	definito
kâğıtlar	documenti
ödülleri	premi
ücret	tassa
stüdyo	studio
okuyucu	lettore
cihaz	dispositivo
kurulmuş	stabilito
cevaplar	risposte
kira	affitto
las	las
karanlık	buio
dış	esterno
elma	Mela
le	Le
Talimatlar	Istruzioni
min	min
sunulan	offerta
teori	teoria
Kaldır	rimuovere
yardım	aiuto
görsel	visivo
evsahibi	ospite
Çeşitlilik	varietà
öğretmenler	insegnanti
Manuel	Manuale
blok	bloccare
konular	soggetti
ajanları	agenti
onarım	riparazione
adil	giusto
çelik	acciaio
anlayış	comprensione
şarkılar	canzoni
sabit	fisso
yanlış	sbagliato
başlangıç	inizio
eller	mani
az	az
Paris	Parigi
alır	prende
sektör	settore
kapasite	capacità
un	un
şişman	Grasso
baba	padre
elektrik	elettrico
testere	sega
enstrümanlar	strumenti
subay	ufficiale
sürücü	autista
işletmeler	aziende
ölü	morto
Bilinmeyen	sconosciuto
restoran	ristorante
mikrofon	Mike
gezi	viaggio
mi	mi
fakir	povero
ilişki	relazione
işçiler	lavoratori
Barış	pace
geleneksel	tradizionale
gösterme	mostrando
yaratıcı	creativo
sahil	costa
yarar	vantaggio
finansman	finanziamento
cihazlar	dispositivi
Kral	signore
hibe	concedere
alt	sub
kurgu	finzione
saatler	orologi
kariyer	carriere
gider	va
Led	guidato
müze	Museo
yelpaze	fan
taşıma	trasporto
ilginç	interessante
bloglar	blog
değerlendirme	valutazione
eski	ex
bölge	zona
karmaşık	complesso
inci	esimo
kedi	gatto
ölmek	morire
sunulan	presentata
düz	piatto
akış	flusso
ajanslar	agenzie
Edebiyat	letteratura
ebeveyn	genitore
ayar	ambientazione
dr	dr
ölçek	scala
ekonomi	economia
faydalı	utile
aylık	mensile
kritik	critico
çerçeve	telaio
müzikal	musicale
tanım	definizione
Sekreter	segretario
yol	sentiero
şef	capo
verir	dà
paketler	Pacchetti
detay	dettaglio
yasalar	legislazione
değişmiş	cambiato
başla	inizio
royal	reale
temiz	pulito
adam	tipo
başlıkları	titoli
uygun	pertinente
adalet	giustizia
bağlamak	Collegare
Fincan	tazza
sepet	cestino
uygulamalı	applicato
haftalık	settimanalmente
cilt	vol
Kurulum	installazione
s	pp
Dikkat	Attenzione
ilerlemek	avanzare
atlamak	Salta
diyet	dieta
ordu	esercito
vites	Ingranaggio
fark	differenza
izin	permesso
doğru	corretta
ulus	nazione
satış	vendita
çok	molte
parça	pezzo
tabaka	foglio
firma	azienda
Yedi	Sette
elementler	elementi
Türler	specie
atlama	saltare
hücreler	cellule
modül	modulo
çare	ricorrere
sertifika	certificato
bakan	ministro
hareket	movimento
moda	moda
talimatlar	indicazioni
Ziyaretçi	visitatori
belgeleme	documentazione
ticari	commercio
orman	foresta
aramalar	chiamate
kapsama	copertura
çift	coppia
vererek	dando
şans	opportunità
vizyon	visione
top	palla
bitirme	fine
istemciler	clienti
eylemler	Azioni
tartışmak	discutere
hedef	obbiettivo
başarılı	riuscito
satıldı	venduto
rüzgar	vento
topluluklar	comunità
klinik	clinico
durum	situazione
piyasalar	mercati
yayıncılık	editoriale
görünmek	apparire
gelişen	sviluppando
hayatları	vite
belirlemek	determinare
sıcaklık	temperatura
duyurular	annunci
hasta	paziente
gerçek	effettivo
tarihi	storico
taş	pietra
şilin	peso
ticaret	commercio
kişiler	persone
zor	difficile
ilmi	scientifico
uydu	satellitare
testler	test
köy	villaggio
hesapları	conti
amatör	dilettante
eski	ex
met	incontrato
Ağrı	dolore
faktörler	fattori
Kahve	caffè
alıcı	acquirente
afiş	manifesto
kenar	bordo
fonksiyonel	funzionale
kök	radice
fi	fi
kapalı	chiuso
Bayram	vacanze
pembe	rosa
denge	equilibrio
izleme	monitoraggio
cevaplar	risposte
atış	tiro
ilk	iniziale
etiket	etichetta
sek	secondo
kanon	canone
lig	lega
atık	rifiuto
dakika	minuto
otobüs	autobus
sağlayan	fornitore
sözlük	dizionario
muhasebe	contabilità
imalat	produzione
bölümler	sezioni
sandalye	sedia
çaba	sforzo
faz	fase
fantezi	fantasia
po	Po
va	va
profesör	Professore
kurmak	installare
gömlek	camicia
giysi	abbigliamento
ayak	piede
meme	Seno
teknikleri	tecniche
dolar	dollari
din	religione
izin	autorizzazione
vahşi	selvaggio
nesil	generazione
bayan	Perdere
kimyasal	chimico
doktor	medico
görev	compito
azaltmak	ridurre
getirdi	portato
egzersiz	esercizio
böcek	insetto
garanti	garanzia
lider	capo
se	SE
süreçler	processi
yumuşak	morbido
toplantılar	incontri
saniye	secondi
uçuş	volo
kongre	congresso
yakıt	carburante
yürümek	camminare
üretilmiş	prodotta
aziz	santo
tartışma	discussione
yarışma	concorrenza
ilaçlar	farmaci
ortak	comune
ödül	premio
taze	fresco
karakterler	personaggi
avukat	procuratore
di	di
faktör	fattore
binlerce	migliaia
km	km
Akış	ruscello
daireler	appartamenti
almak	raccogliere
işitme	udito
doğu	orientale
terapi	terapia
girdileri	inserimenti
imzalı	firmato
idari	amministrativo
ciddi	grave
sınır	limite
adımlar	passaggi
dükkanlar	negozi
esaret	servitù
del	del
çabaları	sforzi
bilgili	informato
ga	ga
düşünceler	pensieri
dere	torrente
ft	ft
miktar	quantità
gerekli	essenziale
turlar	tour
yük	caricare
hemen	subito
makineler	macchine
belirlenmiş	designato
ağır	pesante
kapalı	coperto
kurtarma	recupero
entegre	integrato
yapılandırma	configurazione
horoz	cazzo
tüccar	mercante
kapsamlı	globale
uzman	esperto
korumak	proteggere
katı	solido
sunum	presentazione
oldu	divenne
Portakal	arancia
uyma	conformità
tema	tema
zengin	ricco
kampanya	campagna
vs	vs
gitar	chitarra
bulgu	scoperta
örnekler	esempi
ruh	spirito
ar	ar
iddialar	reclami
kabul	accettazione
stratejiler	strategie
mo	momento
işler	affari
istenilen	destinato
sa	sa
hedefleri	obiettivi
kiralama	assumere
seçim	elezione
önermek	suggerire
şube	ramo
servis	servire
bağlı	affiliati
dağ	montare
Latince	latino
multimedya	multimedia
yönetmek	gestire
köşe	angolo
rütbe	rango
eleman	elemento
doğum	nascita
virüs	virus
interaktif	interattivo
istekler	richieste
ayrı	separato
çeyrek	trimestre
prosedür	procedura
liderlik	comando
tanımlamak	definire
dini	religioso
Gerçekler	fatti
kahvaltı	colazione
kolon	colonna
inanç	fede
Zincir	catena
belirlemek	identificare
cadde	viale
eksik	mancante
tavsiyeler	raccomandazioni
taşındı	mosso
ulaşmak	raggiungere
karşılaştırma	confronto
an	momento
Genişletilmiş	esteso
sıra	sequenza
inç	pollice
saldırı	attacco
merkezleri	centri
açılış	apertura
laboratuvar	laboratorio
rezerv	Riserva
gama	gamma
üretmek	produrre
hakikat	verità
sayaç	contatore
başarısızlık	fallimento
şu	segue
dolar	dollaro
kamp	campo
des	des
filmler	cinema
köprü	ponte
doldurmak	riempire
hareket	movimento
baskı	stampa
taslak	bozza
grafik	grafico
Oyunun	giocato
kontaklar	contatti
okuyucular	lettori
kulüpleri	club
WA	wa
macera	avventura
teklif	offerta
kâr	profitto
liderler	capi
afişler	manifesti
kurumlar	istituzioni
asistan	assistente
değişken	variabile
dj	dj
otopark	parcheggio
dün	ieri
belirlenen	determinato
atölye	laboratorio
gitmiş	andato
kodlar	codici
çeşit	tipi
uzantı	estensione
ifadeleri	dichiarazioni
tamamen	completamente
takımlar	squadre
kale	forte
santimetre	centimetro
senato	senato
komik	divertente
gen	gene
dönük	trasformato
disk	disco
Desen	modello
tekne	barca
tiyatro	Teatro
üreticileri	produttori
sponsor	sponsor
klasik	classico
ikon	icona
garanti	garanzia
adanmış	dedito
yön	direzione
Basketbol	pallacanestro
nesneleri	oggetti
silmek	Elimina
akşam	sera
montaj	montaggio
nükleer	nucleare
fare	topo
işaret	segnale
adli	penale
Veriliş	rilasciato
güçlü	potente
rüya	sognare
YANLIŞ	FALSE
da	da
oyuncular	lanciare
çiçek	fiore
personel	personale
geçti	passato
verilen	fornito
düşme	cascate
ruh	anima
desteklemek	promuovere
belirtilen	dichiarato
istatistikler	statistiche
profesyoneller	professionisti
belirir	appare
Taşımak	trasportare
bayrak	bandiera
kapaklar	coperture
em	em
avantaj	vantaggio
Merhaba	Ciao
tasarımlar	disegni
sürdürmek	mantenere
turizm	turismo
öncelik	priorità
yetişkinler	adulti
grafik	grafico
atom	atomo
ödemeler	pagamenti
bağlayıcı	rilegatura
kısa	breve
Bitti	conclusa
kazanan	vincente
anonim	anonimo
senaryo	copione
hizmet	servito
istiyor	vuole
hazırlanmış	preparato
geçersiz	vuoto
etiket	etichetta
röportaj	colloquio
karıştırmak	mescolare
iskelet	struttura
disk	disco
Kurulmuş	installato
kraliçe	Regina
kredi	crediti
Açıkça	chiaramente
düzeltmek	fissare
sap	maniglia
tatlı	dolce
kriterleri	criteri
ortak	socio
ne	NE
davranış	comportamento
büyütmek	Ingrandire
ışın	raggio
gelir	reddito
ölçmek	misurare
oy	voti
du	du
görev	dovere
tartışmalar	discussioni
ayı	orso
kazanç	guadagno
Festival	Festival
laboratuvar	laboratorio
okyanus	oceano
uçuşlar	voli
uzmanlar	esperti
işaretler	segni
derinlik	profondità
tren	treno
kuru	asciutto
keşfetmek	Esplorare
spa	terme
kavram	concetto
neredeyse	quasi
kullanma	maneggio
Menşei	origine
milyar	miliardo
zeka	intelligenza
satın	comprato
aleyhte	contro
milletler	nazioni
rota	itinerario
kırık	rotto
savaş	battaglia
konuşmak	parlare
protokol	protocollo
sorgu	domanda
ortaklık	associazione
ifade	espressione
es	es
konuşma	discorso
tel	filo
öneri	suggerimenti
değiştirme	sostituzione
bant	nastro
stratejik	strategico
hakim	giudice
asit	acido
bayt	byte
sent	centesimo
zorunlu	costretto
uyumlu	compatibile
apartman	appartamento
boş	nullo
sıfır	zero
konuşmacı	altoparlante
Danışmanlık	consulenza
tasarımcı	progettista
pr	pr
evlilik	matrimonio
rulo	rotolo
bankalar	banche
fr	fr
katılımcılar	partecipanti
gizli	segreto
negatif	negativo
Favoriler	preferiti
tiyatro	Teatro
yaylar	molle
var	var
yapmak	eseguire
çeviri	traduzione
tahminler	stime
hasar	ferita
bakanlık	ministero
sürücüler	driver
avukat	avvocato
rakamlar	figure
korumalı	protetta
öneri	proposta
paylaşım	compartecipazione
kapı	portale
beta	beta
bedava	gratis
karşı	verso
hafifçe	leggermente
yardım	assistere
davranış	condotta
içeriyordu	contenuta
mevzuat	legislazione
çağrı	chiamata
parametreler	parametri
profiller	profili
hususlar	questioni
evler	case
kontroller	controlli
kombine	combinato
nihai	finale
temsilci	rappresentante
küçük	minore
bölümler	dipartimenti
sakinleri	residenti
görüntülenen	visualizzati
anne	mamma
indirimli	ridotto
nadir	raro
gerçekleştirilen	eseguita
aşırı	estremo
örnekler	campioni
Barlar	barre
tahmin	previsione
çıkarıldı	rimosso
Çevrim	ciclo
içermek	contenere
doğruluk	precisione
uyku	dormire
mg	mg
kuş	uccello
eczane	farmacia
oluşturma	creazione
statik	statico
avcı	cacciatore
adresler	indirizzi
bayan	signora
kristal	cristallo
ünlü	famoso
yazar	scrittore
başkan	presidente
içki	bere
akademi	accademia
dinamik	dinamico
yemek	mangiare
kalıcı	permanente
temizlik	pulizia
teşkil	costituisce
portföy	portafoglio
pratik	pratico
teslim	consegnato
altyapı	infrastruttura
renk	colore
satıcı	venditore
Felsefe	filosofia
düzenleme	regolamento
görevlileri	ufficiali
amaç	scopo
teklifleri	offerte
beslenme	nutrizione
kayıt	registrazione
genç	junior
les	les
pelerin	mantellina
halkalar	anelli
bahşiş	mancia
olağanüstü	meraviglioso
bilet	biglietto
açıkladı	annunciato
tahmin	indovina
kime	chi
Futbol	calcio
matematik	matematica
ithalat	importare
gönderme	spedizione
varlık	presenza
otomatik	automatico
görüntüleme	visualizzazione
muhafaza	mantenuto
ch	ch
dan	dan
köpekler	cani
yönetmenler	registi
yönleri	aspetti
önde	avanti
ay	Luna
katılım	partecipazione
düzen	schema
sinek	volare
tavır	maniera
matris	matrice
kombinasyon	combinazione
düzeltme	emendamento
kuvvet	forza
Türkiye	tacchino
kütüphaneler	librerie
uygun	corretto
derece	gradi
işletmelerin	aziende
delta	delta
korku	paura
arayan	cerca
inç	pollici
Kongre	convenzione
hisseleri	azioni
asıl	principale
konfor	comfort
renkler	colori
savaşlar	guerre
sipariş	ordinazione
tuttu	tenuto
alfa	alfa
temyiz	appello
seyir	crociera
bonus	indennità
Hey	Hey
binalar	edifici
özel	Speciali
dövmek	battere
piller	batterie
olur	diventa
sürücüler	unità
silâh	braccia
Çay	tè
gelişmiş	migliorata
başarmak	raggiungere
pozisyonları	posizioni
elbise	vestito
abone	sottoscrizione
satıcı	commerciante
çağdaş	contemporaneo
gökyüzü	cielo
ROM	rom
taşınan	trasportato
poz	esposizione
saklamak	nascondere
imza	firma
değirmenci	mugnaio
hüküm	fornitura
çamaşırlar	Abiti
çerçeveler	montatura
kesinlikle	certamente
gazete	giornale
oyuncak	giocattolo
tabaka	strato
basılı	stampato
yavaş	lento
uzaklaştırma	rimozione
yükümlülük	responsabilità
yazıcılar	stampanti
ekleme	aggiungendo
yer	individuare
harcamak	trascorrere
fabrika	fabbrica
iç	interno
büyümek	crescere
optik	ottico
tanıtım	promozione
bağıl	parente
şaşırtıcı	Stupefacente
nokta	punto
Kimlik	identità
dönüştürme	conversione
duygu	sensazione
gizli	nascosto
makul	ragionevole
revizyon	revisione
etki	influenza
oran	rapporto
önem	importanza
yağmur	pioggia
gezegen	pianeta
kopyalar	copie
izin	permesso
görme	vedendo
kanıt	prova
bas	basso
reçete	prescrizione
boş	vuoto
örnek	esempio
delik	buco
binmek	cavalcata
büro	ufficio
koruma	conservazione
çift	paio
ideal	ideale
gözlük	Specifiche
kaydedilmiş	registrato
don	don
parçalar	pezzi
bitmiş	finito
parklar	parchi
avukatları	avvocati
stres	stress
krem	crema
ss	ss
koşar	piste
keşfetmek	scoprire
ap	ap
desenler	modelli
tepeler	colline
mil	nm
danışman	consulente
farkında	consapevole
şekil	forma
evrim	Evoluzione
sertifikalar	certificati
hedefleri	obiettivi
istasyonlar	stazioni
önerdi	suggerito
op	operazione
kalıntılar	resti
firmalar	aziende
euro	Euro
Şebeke	operatore
yapıları	strutture
genel	generico
ansiklopedi	enciclopedia
kullanım	uso
mürekkep	inchiostro
karışık	misto
sayım	censimento
tekerlek	ruota
tedarikçileri	fornitori
kompakt	compatto
şiir	poesia
ışıklar	luci
izleme	puntamento
melek	angelo
hazırlık	preparazione
girişim	tentativo
kabul	ricevente
maçlar	fiammiferi
uyum	conformità
Genişlik	larghezza
motorlar	motori
unutmak	dimenticare
dizi	schieramento
tartışılan	discusso
doğru	preciso
iklim	clima
Yunan	greco
talimat	istruzione
yönetme	gestione
çiğ	crudo
farklar	differenze
açıklamak	spiegare
kurmak	stabilire
ifade	espresso
derece	estensione
keskin	acuto
ben	Ben
paragraf	paragrafo
öldürmek	uccidere
matematik	matematica
tazminat	compensazione
ihracat	esportare
yöneticileri	manager
modüller	moduli
yürütülen	condotto
versiyonları	versioni
bilir	conosce
tanımlamak	descrivere
vatandaşlar	cittadini
miras	eredità
sorun	guaio
Koç	allenatore
tarım	agricolo
genişletmek	espandere
seyirci	pubblico
atanmış	assegnato
koleksiyonları	collezioni
yaşlar	evo
uzman	specialista
pişirmek	cucinare
etkilemek	influenzare
bakire	vergine
deneyimli	esperto
soruşturma	indagine
kalkık	sollevato
şapka	cappello
kurum	istituzione
yönlendirilmiş	dirette
etkilenmiş	influenzato
bisiklet	bicicletta
bütünüyle	totalmente
plaka	piatto
giderler	spese
belirtmek	indicare
sarışın	bionda
kovuşturma	procedimento
favori	preferito
karakteristikleri	caratteristiche
der	der
kaybetmek	perdere
organik	biologico
aramak	ricercare
deneyimler	esperienze
albüm	album
sözleşmeler	contratti
misafir	ospiti
barındırılan	ospitato
hastalıklar	malattie
ilişkin	circa
eşdeğer	equivalente
kimya	chimica
kitleri	kit
mantık	logica
prens	Principe
daire	cerchio
toprak	suolo
Psikoloji	psicologia
ıslak	bagnato
koşullar	condizioni
yatırımcı	investitore
temel	elementare
sponsorlar	sponsor
tilki	Volpe
sınırsız	illimitato
yanıtlamak	rispondere
boyutları	dimensioni
sade	pianura
çıkış	Uscita
kol	braccio
anahtarlar	chiavi
dalga	onda
kutsal	santo
eylemler	atti
rehberlik	guida
iz	pista
sembol	simbolo
karayolu	autostrada
gözlenen	osservata
dekan	decano
kurmak	impostare
anket	sondaggio
stilleri	stili
dolu	pieno
bağ	legame
kanallar	canali
apandis	appendice
çikolata	cioccolato
kısım	porzione
kapsam	scopo
satıcı	fornitore
kablolar	cavi
pamuk	cotone
gereklilik	Requisiti
öldürdü	ucciso
sınır	confine
eski	antico
tartışma	discussione
temsilcileri	rappresentanti
başlar	inizia
gebelik	gravidanza
konumlar	attrazioni
bilgili	imparato
işlemler	transazioni
kâşif	esploratore
tarihi	storico
koca	marito
yetkili	autorizzato
çılgın	pazzo
yaklaşan	imminente
konser	concerto
Skorlar	punteggi
verim	efficienza
komedi	commedia
benimsenen	adottato
verimli	efficiente
doğrusal	lineare
taahhüt	impegno
uzmanlık	specialità
ayılar	orsi
atlama	luppolo
taşıyıcı	vettore
sabit	costante
Visa	Visa
ağız	bocca
metre	metro
bağlantılı	connesso
görüşmeler	interviste
kavramlar	concetti
tabanca	pistola
yansıtmak	riflettere
saf	puro
cehennem	inferno
meyve	frutta
başlar	inizia
nitelikli	qualificato
reform	riforma
lens	lente
işlenmiş	trattati
keşif	scoperta
çekmek	disegnare
sınıflandırılmış	classificato
üstlenmek	assumere
ittifak	alleanza
onaylamak	Confermare
mühendis	ingegnere
tutarlı	coerente
değiştirmek	sostituire
Boşluk	autorizzazione
dönüştürücü	convertitore
organizasyon	organizzazione
bebek	bambino
çekler	controlli
ulaştı	raggiunto
olma	diventando
amaç	obbiettivo
belirtilen	indicato
şeker	zucchero
mürettebat	equipaggio
bacaklar	gambe
Çubuk	bastone
ilişki	relazione
etkin	abilitato
Tür	genere
gönüllü	volontario
arka	posteriore
demokratik	democratico
artırmak	accrescere
kesin	esatto
ciltli	limite
parametre	parametro
işlemci	processore
düğüm	nodo
biçimsel	formale
fırtına	tempesta
mikro	micro
kolejler	collegi
mil	miglio
zorluklar	sfide
editörler	redattori
yüce	supremo
Kardeşler	fratelli
tanıma	riconoscimento
ref	arbitro
tahmin	stima
çocuk	ragazzo
teftiş	ispezione
tüketicilerin	consumatori
sınırları	limiti
bölge	territorio
silahlar	Armi
gecikme	ritardo
pilot	pilota
katkıları	contributi
sürekli	continuo
girişim	iniziativa
yeni	romanzo
icra	esecuzione
sakatlık	invalidità
ultra	ultra
kazanan	vincitore
bölüm	episodio
çömlekçi	vasaio
tabak	piatto
oyunlar	giochi
bülten	bollettino
ia	ia
değiştirmek	modificare
gerçekten	veramente
Evren	universo
aday	candidato
yarık	fessura
ödenmemiş	eccezionale
Ha	ah
planlı	pianificato
loca	casetta
ayna	specchio
turnuva	torneo
düşünce	considerazione
oturumları	sessioni
çekirdek	nocciolo
alıcılar	acquirenti
dergi	riviste
gri	grigio
katalog	Catalogare
yüklü	carico
geniş	ampio
und	und
seçilmiş	scelto
gösteri	dimostrazione
nefret	odiare
terminal	terminale
yayıncılar	editori
gece	notti
sıvı	liquido
pirinç	riso
rezervasyon	prenotazione
gıdalar	Alimenti
bekçi	guardia
tasarruf	Salvataggio
imparatorluk	impero
yeni	recentemente
yükseltmek	aumentare
yasadışı	illegale
genişleme	espansione
başbakan	premier
yarın	Domani
Süt	latte
dram	Dramma
ziyaret	visitare
yarışma	concorso
toplanmış	raccolto
bantları	bande
uygun	adatto
kesinlikle	assolutamente
denetim	revisione
bölme	Camera
Gine	Guinea
bulgular	risultati
iso	iso
tipik	tipico
toplam	somma
tavuk	pollo
geçici	temporaneo
katılmak	assistere
duş	doccia
gönderme	invio
yeterli	sufficiente
kabuk	conchiglia
il	Provincia
liberal	cattolico
Vali	governatore
bira	birra
katkı	contributo
formül	formula
anayasa	costituzione
paketleme	confezione
dürüst	affidabile
şüphe	dubbio
kazanmak	guadagnare
dönemleri	periodi
saldırılar	attacchi
mal	merce
semptomlar	sintomi
anıt	memoriale
ikiz	gemello
eklemek	inserire
geçit	porta
çizim	disegno
adaylar	candidati
düzenli	ordinato
biyolojik	biologico
kavga	combattente
geçiş	transizione
tercihleri	preferenze
casus	spiare
romantik	romanza
enstrüman	strumento
Bölünmüş	Diviso
temalar	temi
güçler	potenze
cennet	Paradiso
bit	bit
hamile	incinta
sınıflandırma	classificazione
odaklı	focalizzata
doktor	medico
sormak	chiede
bloklar	blocchi
bak	Lo
manevi	spirituale
diyabet	diabete
mi	ml
vardiya	cambio
oturmak	sedersi
bedenler	corpi
fotoğraflar	fotografie
kesim	taglio
yazarlar	scrittori
esnek	flessibile
sevilen	amato
Favoriler	preferiti
haritalama	Mappatura
sayısız	numerose
Nispeten	relativamente
temsil	rappresenta
üstün	superiore
tercihli	preferito
kaydedilmiş	salvato
entellektüel	intellettuale
verilmiş	concesso
karbon	carbonio
rahat	confortevole
manyetik	magnetico
etkileşim	interazione
dinleme	ascoltando
kriz	crisi
görünüm	prospettiva
masif	massiccio
parlak	luminosa
oluşturulan	formato
piyano	pianoforte
Eko	eco
devrim	rivoluzione
görüntüler	visualizza
plazma	plasma
kazanç	guadagni
gizem	mistero
peyzaj	paesaggio
mekanik	meccanico
seyahat	viaggio
afiş	bandiera
incir	Figura
ilçeler	contee
edinme	acquisizione
tanınan	riconosciuto
rüyalar	sogni
bildirim	notifica
kilogram	kg
öğretmek	insegnare
hızlı	rapido
Çek	Tirare
ut	ut
seminer	seminario
yatırımlar	investimenti
tekerlekler	ruote
belirtmek	specificare
hassas	sensibile
şablonları	modelli
formatları	formati
tutar	detiene
yönlendirici	router
beton	calcestruzzo
si	SI
Klasör	cartella
tamamlama	completamento
nabız	impulso
teknik	tecnica
oylama	voto
mahkemeler	tribunali
dönüştürülmüş	convertito
metro	Metro
yıldönümü	anniversario
iyileştirmeler	miglioramenti
şerit	striscia
Şartname	specificazione
kaza	incidente
Nick	tacca
ulaşılabilir	accessibile
oturan	residente
arsa	tracciare
tipik	tipicamente
temsil	rappresentazione
pompa	pompa
var	esiste
düzenlemeler	accordi
konferanslar	conferenze
tüketim	consumo
dar	stretto
tehdit	minaccia
anketler	sondaggi
oturma	seduta
danışman	consulente
kontrolör	controllore
komiteler	comitati
penis	pene
kale	castello
bahçeleri	giardini
etiketler	etichette
istekli	disposto
biyo	bio
oyunculuk	recitazione
kafaları	teste
sınav	esame
Konut	residenza
yoğunluk	densità
yüz	centinaio
garip	strano
sürdürülebilir	sostenibile
istatistiksel	statistico
Anma	citare
yenilik	innovazione
gri	grigio
paralel	parallelo
işletmek	operare
fatura	fatture
kararlı	stabile
tanımlar	definizioni
von	von
doktorlar	medici
ders	lezione
sinema	cinema
seçimler	elezioni
reaksiyon	reazione
boş	vuoto
gelişmiş	migliorata
adlı	intitolato
şiddetli	grave
üretmek	creare
gazeteler	giornali
hastaneler	ospedali
vi	VI
Mizah	umorismo
yaşlı	anziano
monitör	monitor
istisna	eccezione
süre	durata
kütle	massa
ziyaret	visite
yetenekleri	capacità
tavsiye	raccomandazione
günah	peccato
örgütlü	organizzato
ba	ba
paragraf	parà
Benimseme	adozione
geliştirme	miglioramento
pahalı	costoso
bizon	bufalo
organizasyonlar	organizzazioni
uçak	aereo
programlar	programmi
mekanizma	meccanismo
ee	EE
işaretlenmiş	segnato
tahrik	guidato
şişe	bottiglia
yenilikçi	innovativo
masaj	massaggio
Sonuç	conclusione
kapanış	chiusura
bin	mille
efsane	leggenda
villa	villa
kemik	osso
sütunlar	colonne
bozukluklar	disturbi
işbirliği	collaborazione
bulma	rivelazione
iç	interno
formasyon	formazione
med	med
mühendisler	ingegneri
varlık	entità
yolculukları	crociere
kapı	cancello
Roma	romano
görevleri	doveri
erotik	erotico
ton	tono
ahlâk	etica
Ejderha	Drago
meşgul	occupato
Kaptan	Capitano
getiriyor	porta
ısıtma	riscaldamento
bacak	gamba
boyun	collo
kanat	ala
senaryo	script
ABC	abc
döşenmiş	designato
muamele	rapporti
işlemek	commettere
Demiryolu	rotaia
gezileri	viaggi
boşluk	divario
taraf	lati
tüp	tubo
uyan	corrispondente
açıklamaları	descrizioni
kemer	cintura
ceket	giacca
animasyon	animazione
torpil	oracolo
er	er
yapımları	produzioni
havacılık	aviazione
gururlu	orgoglioso
afet	disastro
konsol	consolle
komutlar	comandi
jr	jr
telekomünikasyon	telecomunicazioni
eğitmen	istruttore
dev	gigante
elde	raggiunto
yaralanmalar	lesioni
yaklaşımlar	approcci
olağan	solito
pullar	francobolli
açı	angolo
soymak	rapinare
tasarımcılar	progettisti
özgürlük	libertà
çağ	era
dönüştürmek	convertire
olasılık	possibilità
analist	analista
tehlikeli	pericoloso
güvenilirlik	affidabilità
sırasıyla	rispettivamente
gönüllüler	volontari
türetilmiş	derivato
Zevk	piacere
Onur	onore
yönlü	orientata
kartal	aquila
namaz	preghiera
atölyeler	workshop
kasırga	uragano
sessiz	silenzioso
yapımcı	produttore
temsil	rappresentato
sorumluluklar	responsabilità
peynir	formaggio
dikkatlice	accuratamente
verimlilik	produttività
taç	corona
eşitlik	par
Teşhis	diagnosi
yapıcı	creatore
çatlak	crepa
prensip	principio
seçtikleri	picconi
çete	banda
fetiş	feticcio
görünüm	aspetto
duman	Fumo
filtreler	filtri
Anonim	incorporato
zanaat	mestiere
adam	compagno
kör	cieco
salon	sala
deli	pazzo
algoritma	algoritmo
şiddetle	fortemente
kafe	bar
ken	comprensione
proteinler	proteine
su	su
tanıdık	familiare
yetenekli	capace
kabul	ammissione
ayakkabı	scarpa
seçildi	eletto
taşıma	portando
terörizm	terrorismo
sevinç	gioia
sürümleri	edizioni
etnik	etnico
parlamento	parlamento
aktör	attore
buluntular	reperti
mühür	foca
durumlar	situazioni
beşinci	quinto
vatandaş	cittadino
dikey	verticale
düzeltmeler	correzioni
açıklar	descrive
engelli	disabilità
madde	sostanza
yasak	proibito
boru	tubo
askerler	soldati
Gardiyan	custode
ders	conferenza
simülasyon	simulazione
düzen	disposizione
girişimler	iniziative
hasta	malato
konsantrasyon	concentrazione
yatırmak	posare
yorumlama	interpretazione
kirli	sporco
öğretilen	insegnato
işçi	lavoratore
optimizasyon	ottimizzazione
tapınak	tempio
maddeler	sostanze
kanıtlamak	dimostrare
keşfedilen	scoperto
kanatlar	Ali
genetik	genetico
kısıtlamalar	restrizioni
ince	magro
sergi	esposizione
sırt	cresta
modem	modem
getiren	portando
hasta	malato
değerlendirmek	valutare
tropikal	tropicale
toplamak	raccogliere
vektör	vettore
kesinlikle	decisamente
döndürme	svolta
varoluş	esistenza
yorum	commento
gelişmeler	sviluppi
göç	immigrazione
yerler	destinazioni
karşılıklı	reciproco
sözdizimi	sintassi
li	Li
nitelik	attributo
hapis	prigione
beceri	abilità
sandalye	sedie
çevreleyen	circostante
dağlar	montagne
popülerlik	popolarità
soruşturma	inchiesta
kontrol	verificato
sergi	mostra
atmak	gettare
akım	tendenza
kediler	gatti
çöl	deserto
ya	ya
koordinatör	coordinatore
Merkür	mercurio
yanan	ardente
kaçış	fuga
alıcı	ricevitore
ilerici	progressivo
tekneler	Barche
şampiyonluk	campionato
çarşı	portico
imkansız	impossibile
anlatır	dice
açık	evidente
depresyon	depressione
grafik	grafico
kaplama	copertura
platin	platino
yargı	giudizio
görüşmeler	trattativa
dosyalama	limatura
beslemek	adottivo
layık	premiato
denemeler	prove
ustaları	maestri
kartuş	cartuccia
açıklama	spiegazione
org	org
dolandırıcılık	frode
elektrik	elettricità
spektrum	spettro
varış	arrivo
çömlekçilik	ceramica
vurgu	enfasi
müthiş	eccezionale
onaylı	confermato
sayımları	conta
kaza	schianto
asansör	sollevamento
arası	Inter
yükseklikleri	altezza
gölge	ombra
gider	spese
girişim	avventurarsi
klinik	clinica
şifa	guarigione
prenses	Principessa
girme	entrare
paket	pacchetto
stüdyoları	studios
ilgi	coinvolgimento
baba	papà
düğmeleri	pulsanti
yerleştirme	posizionamento
gözlemler	osservazioni
kazananlar	vincitori
yollar	strade
sonraki	successivo
avlu	cortile
ifşa	rivelazione
kuruluş	istituzione
hatıralar	ricordi
te	TE
yaratır	crea
yüzleri	facce
turist	turista
cinayet	omicidio
yeterli	adeguato
senatör	senatore
sunumlar	presentazioni
özet	digerire
toz	polvere
wiki	wiki
değiştirilir	sostituito
radar	radar
kayıplar	perdite
savaş	combattere
indirgen	riducendo
durduruldu	fermato
Meslek	occupazione
yakından	strettamente
radyasyon	radiazione
krallar	re
çekim	tiro
kulak	orecchio
bayraklar	bandiere
fırıncı	panettiere
muhafazakâr	prudente
şok	shock
etki	efficacia
kravat	cravatta
çatı	tetto
göstermek	dimostrare
atmosfer	atmosfera
öpücük	bacio
canavar	bestia
ra	RA
ameliyat	operato
deney	sperimentare
hedefler	obiettivi
alımları	acquisti
federasyon	federazione
Pizza	Pizza
davet	invitato
atama	assegnazione
şık	mod
sorguları	interrogazioni
yokluk	assenza
satıcıları	fornitori
yoga	yoga
vermektedir	servi
sürpriz	sorpresa
Lamba	lampada
espriler	scherzi
danışmanlık	consulenza
Saray	palazzo
memnun	soddisfatto
kazanç	vittorie
depo	magazzino
sözde	ipotetico
sıradan	ordinario
hayalet	fantasma
ihlal	violazione
patron	capo
gurur	orgoglio
beklentiler	aspettative
bağımsızlık	indipendenza
bilme	sapendo
muhabir	reporter
metabolizma	metabolismo
şampiyon	campione
Şahsen	personalmente
bol	abbondanza
solo	assolo
boğaz	gola
servet	ricchezza
vakum	vuoto
dans	danza
tanımak	riconoscere
yazıyor	scrive
plaza	plaza
araştırma	ricerca
Yayınla	pubblicare
tarama	selezione
trans	trans
öncü	pioniere
unutulmuş	dimenticato
akrobat	acrobata
plakalar	piatti
denemeler	saggi
davranış	comportamento
söylüyorum	raccontare
oldukça	abbastanza
akıllı	intelligente
modları	modalità
yükümlülük	obbligo
liman	porto
gezgin	viaggiatore
bölüm	segmento
düşman	nemico
bulmaca	puzzle
kuyular	pozzi
kısıtlı	limitato
cumhuriyetçi	repubblicano
sırlar	segreti
sendrom	sindrome
katılım	partecipazione
ceza	pena
davul	tamburo
sağlayan	Abilita
kurucu	costruttore
manzara	vista
sel	alluvione
kolaylaştırmak	alleviare
argümanlar	argomenti
arena	arena
maceralar	avventure
öğrenciler	allievi
duyuru	annuncio
sonuç	risultato
anlamak	apprezzare
genişletilmiş	allargato
yetişkin	cresciuto
güzel	bello
merkezleri	centri
fıkra	clausola
gülümseme	Sorriso
topraklar	terre
asker	truppe
silâhlı	armato
çam	pino
soğutma	raffreddamento
körfez	golfo
kamyonlar	camion
mekanizmalar	meccanismi
boşanma	divorzio
gelenek	tradizione
haplar	pillole
kaplan	tigre
arkadaşlar	gente
algılayıcı	sensore
maruz	esposto
av	caccia
melekler	angeli
milletvekili	vice
Tayland	tailandese
emisyonları	emissioni
hekimler	medici
şikâyet	denuncia
sahneler	scene
deneyler	esperimenti
artırmak	Incremento
Yönetim	governo
değirmen	mulino
kurulmuş	fondato
kronik	cronico
den	tana
parmak	dito
tutar	mantiene
pound	libbra
yerleştirmek	individuare
pl	pl
eğitilmiş	allenato
uygulanması	attuazione
ekmek	pane
motorlar	motori
sert	difficile
olay	incidente
dinamik	dinamica
Yalan	menzogna
konuşma	conversazione
azaltmak	diminuire
ibadet	culto
kabiliyet	capacità
ak	ak
hassas	precisione
tazminat	danni
rezervler	riserve
çözmek	risolvere
azınlık	minoranza
çeşitli	diverso
malzemeler	ingredienti
Ah	ah
sesleri	toni
rehabilitasyon	reinserimento
görme	vista
kil	argilla
zayıf	debole
bölünmüş	diviso
resepsiyon	ricezione
bilge	saggio
olasılık	probabilità
seminer	seminari
sonuçları	conseguenze
vericiler	maker
coğrafya	geografia
bütünlük	integrità
miras	eredità
memnun	contento
Tehlike	Pericolo
vitamin	vitamina
işlenmiş	trasformati
ifade	frase
yükselen	raccolta
etkileri	implicazioni
işlevselliği	funzionalità
cennet	Paradiso
melez	ibrido
okur	legge
duygusal	emotivo
şan	gloria
ja	ja
coğrafi	geografico
aşmak	superare
çubuk	asta
ipek	seta
bebekler	bambini
bi	bi
romantik	romantico
ortaya	rivelato
uzmanlar	specialisti
jeneratör	Generatore
süspansiyon	sospensione
üzgün	triste
düzeltme	correzione
Kurt	lupo
yavaşça	lentamente
ek	supplemento
bölümleri	porzioni
bebek	infantile
sektörler	settori
akışkan	fluido
zeminler	motivo
yemek	pasto
ta	ta
makinalar	macchinario
denklem	equazione
sepetler	cesti
olasılık	probabilità
boyut	dimensione
okudu	studiato
kar	profitti
şeytan	diavolo
çimen	erba
resimli	illustrato
Kiraz	ciliegia
kıta	continentale
başarı	realizzazione
sınırlamaları	limitazioni
cenaze	funerale
bölümler	capitoli
yolcu	passeggeri
uygun	conveniente
Mars	Marte
boy	dimensioni
Yumurta	uovo
sinyalleri	segnali
oryantasyon	orientamento
Çalınması	furto
çocukluk	infanzia
semboller	simboli
lat	lat
meta	meta
analog	analogico
yetenek	talento
tarihli	datato
bilgelik	saggezza
sınır	confine
seçkinler	elite
gi	gi
inanır	crede
şiirler	poesie
yargı	Giurisdizione
robot	robot
sergileyen	visualizzazione
tanık	testimone
donanımlı	fornito
aşamaları	stadi
sur	sur
Edinilen	acquisita
belirlemek	valutare
yıkama	lavaggio
Giriş	Ingresso
deklarasyon	dichiarazione
kaybetme	perdere
denemeler	tentativi
asil	nobile
otomasyon	automazione
etkiler	impatti
devir	rev
avantajları	vantaggi
şövalye	cavaliere
Amaçları	obiettivi
uzantılar	estensioni
itirazlar	appelli
hastalık	malattia
ho	Ho
alternatifleri	alternative
sh	sh
sabun	sapone
reçel	marmellata
olağandışı	insolito
cevap	risponde
imha	distruzione
göç	migrazione
düzensizlik	disturbo
Konvansiyonel	convenzionale
giyme	indossare
eksen	asse
aranan	ricercato
genler	geni
medyan	mediano
tarayıcı	scanner
burada	qui
canlandırılmış	animato
ayarlama	registrazione
kahraman	eroe
tedaviler	trattamenti
tutum	atteggiamento
halı	tappeto
lensler	lenti
katıldı	frequentato
zorluk	difficoltà
punk	punk
koalisyon	coalizione
kayıt	iscrizione
dük	duca
hız	ritmo
üreticileri	produttori
yay	arco
arayüzleri	interfacce
Atlas	atlante
gözlem	osservazione
işkence	tortura
silindi	cancellato
ceket	cappotto
restorasyon	restauro
Kolaylık	convenienza
dönen	ritorno
muhalefet	opposizione
konteyner	contenitore
sanık	imputato
gözetmen	supervisore
kolordu	corpo
aktörler	attori
karaciğer	fegato
sorumlu	responsabile
dilekçe	petizione
anten	antenna
seçilmiş	raccolto
inanç	credenza
öldürme	uccisione
omuz	spalla
dekor	arredamento
iyon	ione
çap	diametro
podcast	Podcast
etkileşimler	interazioni
şarkıcı	cantante
haberci	araldo
yaşlanma	invecchiamento
müdahale	intervento
Eklenti	collegare
cazibe	attrazione
dalış	immersione
değişiklik	modifica
varsaymak	supporre
kamış	canna
dahil	coinvolgere
ılımlı	moderare
fareler	topi
anladım	inteso
hızla	rapidamente
yasak	bandire
güvence	garanzia
olay	avvenimento
Muazzam	vasto
üreticiler	mulini
taslak	contorno
aldığı	riceve
kot	jeans
derleme	compilazione
garip	dispari
sigma	sigma
gr	gr
çekici	attraente
fırsat	occasione
kayıtları	registrazioni
kurban	vittima
talepler	richieste
dikkatli	attento
kiriş	fascio
Bahçıvanlık	giardinaggio
yükümlülükleri	obblighi
varmak	arrivo
orkestra	orchestra
lisans	licenza
ayarlanabilir	regolabile
tahsis	assegnazione
deneme	tema
gösterdi	dimostrato
diyalog	dialogo
kampları	campi
beyan	dichiarato
iz	traccia
kapamak	chiuso
paketleri	confezioni
