arasında	of
için	että
içinde	sisään
için	varten
olduğu	on
üzerinde	päällä
o	että
tarafından	mennessä
bu	Tämä
ile	kanssa
ben	minä
sen	sinä
o	se
veya	tai
olmak	olla
Hangi	olemme
en	at
herşey	kaikki
var	omistaa
yeni	Uusi
Biz	me
irade	tahtoa
ev	Koti
bize	meille
hakkında	noin
Eğer	jos
sayfa	sivu
benim	minun
vardır	on
arama	Hae
ücretsiz	vapaa
fakat	mutta
bizim	meidän
bir	yksi
diğer	muut
yap	tehdä
bilgi	tiedot
zaman	aika
o	hän
hangi	joka
onların	heidän
haber	uutiset
kullanım	käyttää
Orada	siellä
görmek	nähdä
yani	niin
kim	Kuka
ağ	verkko
Ayrıca	myös
almak	saada
pm	pm
görünüm	näkymä
c	C
e	e
ilk	ensimmäinen
olmuştur	ollut
olur	olisi
idi	olivat
s	s
sevmek	Kuten
x	x
göre	kuin
bulmak	löytö
fiyat	hinta
geri	takaisin
üst	ylin
insanlar	ihmiset
vardı	oli
liste	lista
isim	nimi
sadece	vain
yıl	vuosi
gün	päivä
içine	osaksi
iki	kaksi
sağlık	terveys
n	n
yeniden	re
Kullanılmış	käytetty
gitmek	mennä
b	b
son	kestää
Yapmak	tehdä
onları	niitä
meli	pitäisi
ürün	tuote
sistem	järjestelmä
posta	lähettää
ona	hänen
Kent	kaupunki
t	T
politika	politiikka
numara	määrä
destek	tuki
mesaj	viesti
sonra	jälkeen
sonra	sitten
Ocak	tammikuu
iyi	hyvä
d	d
nerede	missä
bilgi	tiedot
haklar	oikeudet
kitaplar	kirjat
yüksek	korkea
okul	koulu
m	m
her	kukin
bağlantılar	linkit
o	hän
yıl	vuotta
sipariş	tilata
çok	erittäin
kitap	kirja
ürün	kohdetta
şirket	yhtiö
r	R
okumak	lukea
grup	ryhmä
seks	sukupuoli
çok	monet
kullanıcı	käyttäjä
de	de
set	sarja
genel	yleinen
Araştırma	tutkimus
Üniversite	yliopisto
Ocak	tammikuu
posta	posti
tam	koko
yorumlar	arvostelut
program	ohjelmoida
bilmek	tietää
oyunlar	pelit
yol	tapa
günler	päivää
p	p
Bölüm	osa
could	voisi
harika	loistava
birleşmiş	yhdistynyt
gerçek	todellinen
f	f
Uluslararası	kansainvälinen
merkez	keskusta
seyahat	matkustaa
yorumlar	kommentit
yapılmış	tehty
gelişme	kehitys
rapor	raportti
üye	jäsen
ayrıntılar	yksityiskohdat
hat	linja
şartlar	ehdot
önce	ennen
oteller	hotellit
did	teki
göndermek	lähettää
sağ	oikea
tip	tyyppi
yerel	paikallinen
bu	nuo
Sonuçlar	tulokset
ofis	toimisto
Ulusal	kansallinen
araba	auto
dizayn	design
almak	ottaa
gönderildi	lähetetty
adres	osoite
topluluk	Yhteisö
içinde	sisällä
devletler	valtiot
istemek	haluta
telefon	puhelin
DVD	DVD
konu	aihe
arasında	välillä
forum	foorumi
aile	perhe
l	l
uzun	pitkä
w	w
göstermek	show
O	O
Üstelik	jopa
siyah	musta
özel	erityinen
indeks	indeksi
olmak	ollessa
KADIN	naiset
çok	paljon
işaret	merkki
dosya	tiedosto
bağlantı	linkki
açık	avata
güney	etelä
dava	tapaus
proje	projekti
sayfalar	sivut
versiyon	versio
Bölüm	jakso
kendi	oma
ev	talo
güvenlik	turvallisuus
g	g
kontluk	lääni
Amerikan	amerikkalainen
Fotoğraf	kuva
oyun	peli
üyeler	jäsenet
güç	teho
ağ	verkko
bilgisayar	tietokone
sistemler	järjestelmät
üç	kolme
yer	paikka
son	pää
h	h
onu	häntä
başına	kohti
erişim	pääsy
düşünmek	ajatella
kuzeyinde	pohjoinen
kaynaklar	voimavarat
şimdiki	nykyinen
büyük	iso
medya	tiedotusvälineet
kanun	laki
kontrol	ohjaus
Su	vesi
Tarihçe	historia
boyut	koko
kişisel	henkilökohtainen
kılavuz	opas
Dükkan	myymälä
rehber	hakemisto
değişiklik	muuttaa
beyaz	valkoinen
Metin	teksti
küçük	pieni
değerlendirme	luokitus
oran	nopeus
hükümet	hallitus
çocuklar	lapset
dönüş	palata
öğrencilerin	opiskelijoille
v	v
hesap	tili
zamanlar	ajat
seviye	taso
dijital	digitaalinen
profil	profiili
önceki	Edellinen
form	muoto
olaylar	Tapahtumat
Aşk	rakkaus
eski	vanha
John	Johannes
ana	tärkein
aramak	puhelu
görüntü	kuva
Bölüm	osasto
Başlık	otsikko
olmayan	ei
k	K
y	y
sigorta	vakuutus
acak	on
özellik	omaisuus
sınıf	luokka
CD	CD
kalite	laatu
her	joka
listeleme	listaus
içerik	pitoisuus
ülke	maa
küçük	vähän
araçlar	Työkalut
düşük	matala
cevap	Vastaa
müşteri	asiakas
Aralık	joulukuu
karşılaştırmak	vertailla
filmler	elokuvat
kolej	college
değer	arvo
makale	artikla
adam	mies
Meslekler	työpaikkaa
j	j
Gıda	ruoka
yazar	kirjailija
farklı	eri
u	U
öğrenmek	oppia
satış	myynti
baskı	Tulosta
kurs	kurssi
iş	Job
oda	huone
Stok	kalusto
Eğitim	koulutus
çok	liian
kredi	luotto
puan	kohta
Bilim	tiede
erkekler	miehet
kategoriler	luokat
batı	länsi
bak	Katso
ingilizce	Englanti
takım	tiimi
arazi	omaisuus
Kutu	laatikko
koşullar	olosuhteet
fotoğraflar	Valokuvat
eşcinsel	homo
iplik	lanka
kategori	kategoria
Not	Huomautus
canlı	elää
büyük	suuri
galeri	galleria
tablo	pöytä
ancak	kuitenkin
Haziran	kesäkuu
Ekim	lokakuu
Kasım	marraskuu
Market	markkinoida
kütüphane	kirjasto
aksiyon	toiminta
başla	alkaa
dizi	sarja
Özellikler	ominaisuudet
hava	ilma
sanayi	ala
plan	suunnitelma
insan	ihmisen
Evet	Joo
ikinci	toinen
Sıcak	kuuma
maliyet	kustannus
film	elokuva
forumlar	foorumit
Mart	maaliskuu
la	la
Eylül	syyskuu
söylemek	sanoa
gidiyor	menossa
tıbbi	lääketieteellinen
arkadaş	ystävä
Aralık	joulukuu
sunucu	palvelin
uygulama	hakemus
Personel	henkilöstö
oyun	pelata
sorunlar	kysymykset
Nisan	huhtikuu
kullanıcılar	käyttäjät
sokak	katu
konu	aihe
karşısında	vastaan
var	sai
Blog	blogi
Parti	juhla
ödeme	maksu
ekipman	laitteet
let	antaa
programlar	ohjelmat
yasal	oikeudellinen
son	viimeaikainen
park	pysäköidä
davranmak	toimia
sorun	ongelma
kırmızı	punainen
vermek	antaa
bellek	muisti
performans	esitys
sosyal	sosiaalinen
q	q
Öykü	tarina
satmak	myydä
seçenekleri	vaihtoehtoja
deneyim	kokea
anahtar	avain
vücut	ruumis
genç	nuori
önemli	tärkeä
alan	ala
az	harvat
Doğu	itään
tek	yksittäinen
ii	ii
yaş	ikä
kulüp	klubi
örnek	esimerkki
kızlar	tytöt
z	z
yol	tie
hediye	lahja
soru	kysymys
CA	ca
zor	kova
ödeme	maksaa
dört	neljä
poker	pokeri
konu	ongelma
menzil	alue
bina	rakennus
satıcı	myyjä
mahkeme	tuomioistuin
Şubat	helmikuu
sonuç	tulos
ışık	valo
yazmak	kirjoittaa
savaş	sota
teklif	tarjous
mavi	sininen
gruplar	ryhmät
ark	ai
kolay	helppo
verilmiş	tietty
istek	pyyntö
faks	faksi
Çin	Kiina
yapma	tehdä
resim	kuva
ihtiyaçlar	tarpeisiin
mümkün	mahdollinen
ay	kuukausi
majör	suuri
star	tähti
gelecek	tulevaisuus
uzay	tila
Kurul	komitea
el	käsi
Güneş	aurinko
kartları	kortit
Londra	Lontoo
toplantı	tapaaminen
olmak	tulla
çocuk	lapsi
Tut	pitää
porno	porno
pay	Jaa
benzer	samankaltainen
Bahçe	puutarha
okullar	koulut
milyon	miljoona
katma	lisättyä
referans	viite
şirketler	yritykset
bebek	vauva
öğrenme	oppiminen
enerji	energia
koşmak	juosta
teslim	toimitus
popüler	suosittu
terim	termi
film	elokuva
hikayeleri	tarinoita
koymak	laittaa
dergi	päiväkirja
raporlar	raporttien
ko	co
Deneyin	yrittää
Görüntüler	kuvien
ihbar	ilmoitus
Allah	Jumala
orijinal	alkuperäinen
kafa	pää
radyo	radio
hücre	solu
konsey	neuvosto
içerir	sisältää
Izlemek	seurata
tartışma	keskustelu
Arşiv	arkisto
diğerleri	toiset
anlaşma	sopimus
biçim	muoto
toplum	yhteiskunta
ay	kuukaudet
Emniyet	turvallisuus
Arkadaş	ystävät
emin	varma
baskı	painos
mesajları	viestien
pazarlama	markkinointi
söylemek	kertoa
birleşme	yhdistys
sağlar	tarjoaa
eğlence	hauska
zaten	jo
yeşil	vihreä
çalışmalar	opinnot
kapat	kiinni
ortak	yhteinen
özel	erityinen
birkaç	useat
yaşam	elävä
Toplamak	kokoelma
denilen	nimeltään
kısa	lyhyt
sanat	arts
çok	erä
Sor	kysyä
sınırlı	rajallinen
çözeltiler	ratkaisut
yönetmen	johtaja
plaj	ranta
geçmiş	menneisyys
doğal	luonnollinen
elektronik	elektroniikka
üzerine	päälle
dönem	aika
planlama	suunnittelu
diyor	sanoo
resmi	virallinen
mar	maaliskuu
tamam	tehty
teknik	tekninen
pencere	ikkuna
profesyonel	ammattilainen
bölge	alue
ada	saari
kayıt	ennätys
direkt	suoraan
konferans	konferenssi
kayıtlar	asiakirjat
st	st
ilçe	piiri
takvim	kalenteri
maliyetler	kustannukset
stil	tyyli
Beyan	selvitys
mil	mailia
kaynak	resurssi
uygulamaları	sovellukset
belge	asiakirja
sözcük	sana
Eserleri	teokset
malzeme	materiaali
fatura	laskuttaa
yazılı	kirjallinen
kurallar	säännöt
nihai	lopullinen
şey	asia
merkez	keskusta
Gereksinimler	vaatimuksista
DOĞRU	TOTTA
dakika	minuutit
Başka	muu
işaret	merkki
Kaya	rock
kötü	huono
bireysel	yksilö
artı	plus
Oto	auto
kapak	peite
Düzenle	muokata
birlikte	yhdessä
videolar	Videot
hızlı	nopeasti
fonksiyon	toiminto
gerçek	tosiasia
alma	saada
global	maailmanlaajuinen
teknoloji	teknologia
karşılamak	tavata
uzak	pitkälle
ekonomik	taloudellinen
tr	fi
oyuncu	pelaaja
projeler	hankkeet
Miktar	määrä
izlemek	katsella
dahil	Sisältää
hissetmek	tuntea
banka	pankki
risk	riski
fırsatlar	tarjoukset
çeşitli	eri
kelimeler	sanat
üretim	tuotanto
ticari	kaupallinen
ağırlık	paino
kalp	sydän
tedavi	hoito
makas	pistettä
bilgi	tuntemus
dergi	aikakauslehti
hata	virhe
kamera	kamera
kız	tyttö
inşaat	rakentaminen
oyuncaklar	lelut
kayıtlı	kirjattu
domain	verkkotunnuksen
yöntemleri	menetelmät
bölüm	luku
koruma	suojaus
politikaları	politiikkaa
geniş	leveä
güzellik	kauneus
müdür	johtaja
Hindistan	Intia
pozisyon	asento
alınmış	otettu
çeşit	järjestellä
listeleri	listat
bilinen	tunnettu
yarım	puoli
vakalar	tapauksissa
adım	vaihe
mühendislik	tekniikka
basit	yksinkertainen
hızlı	nopea
lisans	lisenssi
göl	järvi
bütün	koko
yıllık	vuotuinen
yayınlanan	julkaistu
kilise	kirkko
yöntem	menetelmä
aktif	aktiivinen
tepki	vastaus
şekil	kuva
malzemeler	tarvikkeet
yeterli	tarpeeksi
tasarlanmış	suunnitellut
arasında	keskuudessa
ölüm	kuolema
kayıp	menetys
yüz	kasvot
marka	brändi
indirim	alennus
Etkileri	tehosteet
oluşturulan	luotu
standartlar	standardit
bit	bitti
siyasi	poliittinen
krallık	kuningaskunta
baz	pohja
iş	tekemässä
krediler	lainat
ayakkabı	kengät
giriş	merkintä
kalmak	pysyä
emirler	tilaukset
kullanılabilirlik	saatavuus
özet	yhteenveto
dönüş	vuoro
büyüme	kasvu
Ajans	toimisto
kral	kuningas
Avrupa	eurooppalainen
aktivite	aktiviteetti
kopya	kopio
batı	Läntinen
Kuvvet	pakottaa
iş	työllisyys
Defne	lahti
nehir	joki
komisyon	komissio
paket	paketti
görüldü	nähdään
oyuncu	pelaajat
motor	moottori
Liman	portti
albüm	albumi
bölgesel	alueellinen
durdurmak	Stop
başladı	aloitti
yönetim	antaminen
bar	baari
enstitü	instituutti
görünümler	näkymät
çift	kaksinkertainen
köpek	koira
yakında	pian
hatlar	linjat
elektronik	elektroninen
faydaları	hyötyjä
gerekli	tarvittu
yazıcı	kirjoitin
şart	kunto
etkili	tehokas
inanmak	uskoa
organizasyon	organisaatio
Efekt	vaikutus
us	mieli
seçim	valinta
kumarhane	kasino
pdf	PDF
tur	kiertue
çapraz	ylittää
umut	toivoa
şirket	yhtiö
dilek	toive
çözüm	ratkaisu
olgun	kypsä
rol	rooli
haftalar	viikkoa
belli	tietty
alt	alempi
gerekli	välttämätön
Birlik	liitto
Pazartesi	mon
com	com
belirli	tietty
ince	hieno
saat	tunnin
gaz	kaasu
becerileri	taidot
altı	kuusi
çalı	Puska
adaları	saaret
tavsiye	neuvot
kariyer	ura
karar	päätös
ayrılmak	jättää
önceden	pre
Kocaman	valtava
Kadın	nainen
tesisler	laitteisto
teklif	tarjous
orta	keskimmäinen
kablo	kaapeli
fırsatlar	mahdollisuudet
alma	ottaen
değerler	arvot
bölünme	jako
gelecek	tuleva
nesne	esine
lezbiyen	lesbo
uygun	sopiva
makine	kone
logo	logo
uzunluk	pituus
Güzel	kiva
Gol	pisteet
istatistik	tilasto
müşteri	asiakas
Numune	näyte
yatırım	investointi
gönderilen	lähetetty
gösterilen	esitetty
Noel	joulu
kültür	kulttuuri
flaş	salama
MS	neiti
seçim	valinta
dersler	kurssit
tüketici	kuluttaja
Merhaba	Moi
yabancı	ulkomainen
sanatçı	taiteilija
mobilya	huonekalut
kanal	kanava
mektup	kirje
kip	tila
telefonlar	puhelimet
fikirler	ideoita
yapı	rakenne
derece	aste
sözleşme	sopimus
Süper	Super
erkek	Uros
madde	asia
neredeyse	melkein
bulunan	sijaitsevat
çoklu	moninkertainen
dağıtım	jakelu
editör	toimittaja
Han	majatalo
Sanayi	teollinen
potansiyel	mahdollinen
şarkı	laulu
los	los
düşmek	pudota
Fikir	ajatus
Odalar	Huoneet
iletişim	viestintä
kazanmak	voittaa
birincil	ensisijainen
kanser	syöpä
sayılar	numerot
neden	syy
araç	työkalu
bahar	kevät
vakıf	perusta
Cevap	vastaus
ses	ääni
program	ajoittaa
evraklar	asiakirjat
amaç	tarkoitus
özellik	ominaisuus
yatak	sänky
geliyor	tulee
polis	Poliisi
bağımsız	itsenäinen
yaklaşım	lähestyä
kahverengi	ruskea
fiziksel	fyysinen
Tepe	mäki
haritalar	kartat
ambar	pitää
derecelendirme	luokitukset
mutlu	onnellinen
demirci	seppä
gelişmiş	kehittyneillä
teşekkür	kiittää
kasa	turvallinen
benzersiz	ainutlaatuinen
anket	tutkimus
önceki	ennen
telefon	puhelin
spor	Urheilu
hazır	valmis
hayvan	eläin
kaynaklar	lähteet
nüfus	väestö
baba	pa
düzenli	säännöllinen
güvenli	turvallinen
operasyonlar	toiminnot
basitçe	yksinkertaisesti
kanıt	näyttö
istasyon	asema
anlama	ymmärtää
seçenek	vaihtoehto
vadi	laakso
muhtemelen	todennäköisesti
deniz	meri
yayınlar	Julkaisut
iyileştirmek	parantaa
bağ	yhteys
Yayımcı	kustantaja
salon	sali
anti	anti
ağlar	verkot
toprak	maa
ebeveyn	vanhemmat
darbe	vaikutus
Aktar	siirtää
Giriş	esittely
mutfak	keittiö
kuvvetli	vahva
düğün	häät
özellikleri	ominaisuudet
hastane	sairaala
zemin	maa
gemi	alus
Konaklama	majoitus
hastalık	tauti
mükemmel	erinomainen
mükemmel	täydellinen
saç	hiukset
fırsat	tilaisuus
malzeme	pakki
klasik	klassikko
temel	perusta
komuta	komento
şehirler	kaupungit
ekspres	ilmaista
ödül	myöntää
mesafe	etäisyys
ağaç	puu
değerlendirme	arviointi
duvar	seinä
ilgili	osallistuva
el	el
ekstra	ylimääräinen
özellikle	erityisesti
bütçe	talousarvio
kılavuzlar	oppaita
başarı	menestys
maksimum	enimmäismäärä
anne	äiti
operasyon	operaatio
mevcut	nykyinen
oldukça	melko
seçilmiş	valittu
oğlan	poika
restoranlar	ravintolat
güzel	kaunis
uyarı	Varoitus
yerleri	sijainnit
at	hevonen
oy	äänestys
Çiçekler	kukat
yıldızlar	tähdet
listeleri	luettelot
sahip	omistaja
hayvanlar	eläimet
yolları	tapoja
oğul	poika
sağlama	tarjoaminen
kural	sääntö
Konut	kotelo
alır	kestää
getirmek	tuoda
katalog	luettelo
maksimum	max
anne	äiti
yetki	auktoriteetti
söyledi	kertoi
program	ohjelmoida
katıldı	liittyi
giriş	panos
strateji	strategia
ayaklar	jalkaa
ajan	agentti
geçerli	pätevä
modern	moderni
kıdemli	vanhempi
seksi	seksikäs
öğretim	opetus
kapı	ovi
büyük	suuri
Deneme	oikeudenkäynti
birimler	yksiköt
güzel	viileä
normal	normaali
kuruluş	yritys
gemiler	laivat
tüm	koko
pozitif	positiivinen
Fitness	kunto
Çince	Kiinalainen
görüş	lausunto
Futbol	jalkapallo
soyut	abstrakti
çıktı	ulostulo
para	varat
Bay	Herra
muhtemelen	todennäköisesti
geliştirmek	kehittää
sanatçılar	Taiteilijat
alternatif	vaihtoehto
sorumluluk	vastuu
java	Jaava
konuk	vieras
yayın	julkaisu
pas	kulkea
ilişkiler	suhteet
güven	luottamus
kamyonet	pakettiauto
içeren	sisältää
çok	multi
cumhuriyet	tasavalta
harç	palkkiot
bileşenler	komponentit
tatil	loma
yüzyıl	vuosisata
akademik	akateeminen
yardım	apu
tamamlanan	valmistunut
cilt	iho
grafik	grafiikka
Hintli	intialainen
halka	rengas
sınıf	arvosana
dağ	vuori
organizasyonlar	organisaatioiden
filtre	suodattaa
panel	paneeli
zemin	lattia
alış	ostaminen
maç	ottelu
önerilen	ehdotettu
gerektirir	vaatia
çocuklar	pojat
sabah	aamu
verir	sallii
protein	proteiini
bitki	kasvi
rapor	raportoitu
vurmak	osuma
aa	mm
havuz	pool
mini	mini
siyaset	politiikka
ortak	kumppani
yazarlar	kirjoittajat
panoları	levyt
balık	kalastaa
üyelik	jäsenyys
misyon	tehtävä
göz	silmä
sicim	jono
duyu	tunne
değiştirilmiş	muokattu
yayınlandı	julkaisi
evre	vaihe
iç	sisäinen
doğmuş	syntynyt
detaylı	yksityiskohtainen
Japonca	japanilainen
yarış	rotu
onaylı	hyväksytty
hedef	kohde
dışında	paitsi
karakter	merkki
bakım	ylläpito
kabiliyet	kyky
ed	toim
kolza	raiskata
pil	akku
gençlik	nuoret
basınç	paine
gönderilen	toimitettu
borç	velka
orta	keskikokoinen
televizyon	televisio
Ilgilenen	kiinnostunut
çekirdek	ydin
mola	tauko
amaçlar	tarkoituksiin
kümeler	setit
dans	tanssi
ahşap	puu
tanımlanmış	määritellyt
kâğıtlar	paperit
ödülleri	palkinnot
ücret	maksu
stüdyo	studio
okuyucu	lukija
cihaz	laite
kurulmuş	perusti
cevaplar	vastauksia
kira	vuokrata
las	las
karanlık	tumma
dış	ulkoinen
elma	omena
le	le
Talimatlar	ohjeet
min	min
sunulan	tarjotaan
teori	teoria
Kaldır	poistaa
yardım	apu
görsel	visuaalinen
evsahibi	isäntä
Çeşitlilik	lajike
öğretmenler	opettajat
Manuel	manuaalinen
blok	lohko
konular	aiheita
ajanları	aineet
onarım	korjaus
adil	oikeudenmukainen
çelik	teräs
anlayış	ymmärtäminen
şarkılar	lauluja
sabit	kiinteä
yanlış	väärä
başlangıç	alku
eller	käsissä
az	az
Paris	Pariisi
alır	saa
sektör	sektori
kapasite	kapasiteetti
un	un
şişman	rasva
baba	isä
elektrik	sähköinen
testere	näin
enstrümanlar	välineet
subay	upseeri
sürücü	kuljettaja
işletmeler	yritykset
ölü	kuollut
Bilinmeyen	tuntematon
restoran	ravintola
mikrofon	mikrofoni
gezi	matka
mi	mi
fakir	huono
ilişki	yhteys
işçiler	työntekijöiden
Barış	rauha
geleneksel	perinteinen
gösterme	osoittavat
yaratıcı	luova
sahil	rannikko
yarar	hyöty
finansman	rahoitus
cihazlar	laitteet
Kral	herra
hibe	myöntää
alt	sub
kurgu	kaunokirjallisuus
saatler	kellot
kariyer	uraa
gider	menee
Led	led
müze	museo
yelpaze	tuuletin
taşıma	kuljetus
ilginç	mielenkiintoista
bloglar	blogit
değerlendirme	arviointi
eski	entinen
bölge	vyöhyke
karmaşık	monimutkainen
inci	th
kedi	kissa
ölmek	kuolla
sunulan	esittelyyn
düz	tasainen
akış	virtaus
ajanslar	virastojen
Edebiyat	kirjallisuus
ebeveyn	vanhempi
ayar	asetus
dr	DR
ölçek	asteikko
ekonomi	talous
faydalı	hyödyllinen
aylık	kuukausittain
kritik	kriittinen
çerçeve	kehys
müzikal	musikaali
tanım	määritelmä
Sekreter	sihteeri
yol	polku
şef	päällikkö
verir	antaa
paketler	paketit
detay	yksityiskohta
yasalar	lait
değişmiş	muutettu
başla	alkaa
royal	kuninkaallinen
temiz	puhdas
adam	kaveri
başlıkları	otsikot
uygun	merkityksellinen
adalet	oikeudenmukaisuus
bağlamak	kytkeä
Fincan	kuppi
sepet	kori
uygulamalı	soveltava
haftalık	viikoittain
cilt	vol
Kurulum	asennus
s	pp
Dikkat	huomio
ilerlemek	edetä
atlamak	hyppiä
diyet	ruokavalio
ordu	armeija
vites	vaihde
fark	ero
izin	sallittu
doğru	oikea
ulus	kansakunta
satış	myynti
çok	paljon
parça	pala
tabaka	arkki
firma	yritys
Yedi	seitsemän
elementler	elementtejä
Türler	laji
atlama	hypätä
hücreler	solut
modül	moduuli
çare	lomakeskus
sertifika	todistus
bakan	ministeri
hareket	liike
moda	muoti
talimatlar	ohjeet
Ziyaretçi	vierailijat
belgeleme	dokumentointi
ticari	kaupankäynti
orman	metsä
aramalar	puhelut
kapsama	kattavuus
çift	pari
vererek	antaminen
şans	mahdollisuus
vizyon	näkemys
top	pallo
bitirme	pääte
istemciler	asiakkaat
eylemler	toimet
tartışmak	keskustella
hedef	tavoite
başarılı	onnistunut
satıldı	myyty
rüzgar	tuuli
topluluklar	yhteisöt
klinik	kliininen
durum	tilanne
piyasalar	markkinat
yayıncılık	kustannustoiminta
görünmek	ilmestyä
gelişen	kehittämällä
hayatları	elämää
belirlemek	määrittää
sıcaklık	lämpötila
duyurular	ilmoitukset
hasta	potilas
gerçek	todellinen
tarihi	historiallinen
taş	kivi
şilin	Bob
ticaret	kaupankäynti
kişiler	henkilöt
zor	vaikea
ilmi	tieteellinen
uydu	satelliitti
testler	testit
köy	kylä
hesapları	tilit
amatör	amatööri
eski	entinen
met	tavannut
Ağrı	kipu
faktörler	tekijät
Kahve	kahvi
alıcı	ostaja
afiş	juliste
kenar	reuna
fonksiyonel	toiminnallinen
kök	juuri
fi	fi
kapalı	suljettu
Bayram	juhlapäivät
pembe	vaaleanpunainen
denge	saldo
izleme	seuranta
cevaplar	vastaukset
atış	laukaus
ilk	alkukirjain
etiket	etiketti
sek	sec
kanon	kaanon
lig	liiga
atık	jätteet
dakika	minuutti
otobüs	bussi
sağlayan	toimittaja
sözlük	sanakirja
muhasebe	kirjanpito
imalat	valmistus
bölümler	osiot
sandalye	tuoli
çaba	ponnistus
faz	vaihe
fantezi	fantasia
po	po
va	va
profesör	professori
kurmak	Asentaa
gömlek	paita
giysi	vaatteet
ayak	jalka
meme	rinta
teknikleri	tekniikat
dolar	dollaria
din	uskonto
izin	lupa
vahşi	villi
nesil	sukupolvi
bayan	neiti
kimyasal	kemiallinen
doktor	lääkäri
görev	tehtävä
azaltmak	vähentää
getirdi	toi
egzersiz	liikunta
böcek	vika
garanti	takuu
lider	johtaja
se	SE
süreçler	prosessit
yumuşak	pehmeä
toplantılar	kokoukset
saniye	sekuntia
uçuş	lento
kongre	kongressi
yakıt	polttoaine
yürümek	kävellä
üretilmiş	valmistettu
aziz	pyhimys
tartışma	Perustelu
yarışma	kilpailu
ilaçlar	huumeita
ortak	yhteinen
ödül	palkkio
taze	tuore
karakterler	merkkiä
avukat	asianajaja
di	di
faktör	tekijä
binlerce	tuhansia
km	km
Akış	virta
daireler	huoneisto
almak	valita
işitme	kuulo
doğu	itäinen
terapi	terapia
girdileri	merkinnät
imzalı	allekirjoitettu
idari	hallinnollinen
ciddi	vakava
sınır	raja
adımlar	askeleet
dükkanlar	kaupat
esaret	orjuus
del	del
çabaları	pyrkimyksiä
bilgili	ilmoitti
ga	ga
düşünceler	ajatuksia
dere	puro
ft	ft
miktar	määrä
gerekli	olennainen
turlar	matkat
yük	ladata
hemen	heti
makineler	koneet
belirlenmiş	nimetty
ağır	raskas
kapalı	katettu
kurtarma	elpyminen
entegre	integroitu
yapılandırma	kokoonpano
horoz	kukko
tüccar	kauppias
kapsamlı	kattava
uzman	asiantuntija
korumak	suojella
katı	vankka
sunum	esittely
oldu	tuli
Portakal	oranssi
uyma	noudattaminen
tema	teema
zengin	rikas
kampanya	kampanja
vs	vs
gitar	kitara
bulgu	havainto
örnekler	esimerkkejä
ruh	henki
ar	ar
iddialar	vaatimukset
kabul	hyväksyminen
stratejiler	strategiat
mo	mo
işler	asioihin
istenilen	tarkoitettu
sa	sa
hedefleri	tavoitteet
kiralama	vuokraus
seçim	vaalit
önermek	ehdottaa
şube	haara
servis	palvella
bağlı	Kumppanit
dağ	asentaa
Latince	Latina
multimedya	multimedia
yönetmek	hoitaa
köşe	kulma
rütbe	arvo
eleman	elementti
doğum	syntymä
virüs	virus
interaktif	interaktiivinen
istekler	pyynnöt
ayrı	erillinen
çeyrek	neljännes
prosedür	menettely
liderlik	johto
tanımlamak	määritellä
dini	uskonnollinen
Gerçekler	tosiasiat
kahvaltı	aamiainen
kolon	sarake
inanç	usko
Zincir	ketju
belirlemek	tunnistaa
cadde	katu
eksik	puuttuva
tavsiyeler	suosituksia
taşındı	siirretty
ulaşmak	saavuttaa
karşılaştırma	vertailu
an	hetki
Genişletilmiş	laajennettu
sıra	jakso
inç	tuuma
saldırı	hyökkäys
merkezleri	keskuksissa
açılış	aukko
laboratuvar	laboratorio
rezerv	varata
gama	gamma
üretmek	tuottaa
hakikat	totuus
sayaç	laskuri
başarısızlık	vika
şu	seuraa
dolar	dollari
kamp	leiri
des	des
filmler	elokuvat
köprü	silta
doldurmak	täyttää
hareket	liike
baskı	painaminen
taslak	luonnos
grafik	kartoittaa
Oyunun	pelataan
kontaklar	yhteystiedot
okuyucular	lukijoita
kulüpleri	risti
WA	wa
macera	seikkailu
teklif	uhri
kâr	voitto
liderler	johtajat
afişler	Julisteet
kurumlar	laitokset
asistan	avustaja
değişken	muuttuja
dj	dj
otopark	pysäköinti
dün	eilen
belirlenen	määritetty
atölye	työpaja
gitmiş	mennyt
kodlar	koodit
çeşit	Erilaisia
uzantı	laajentaminen
ifadeleri	lausuntoja
tamamen	täysin
takımlar	joukkueet
kale	linnake
santimetre	cm
senato	senaatti
komik	hauska
gen	geeni
dönük	kääntyi
disk	levy
Desen	kuvio
tekne	vene
tiyatro	teatteri
üreticileri	valmistajat
sponsor	sponsori
klasik	klassinen
ikon	ikoni
garanti	takuu
adanmış	omistautunut
yön	suunta
Basketbol	koripallo
nesneleri	esineet
silmek	poistaa
akşam	ilta
montaj	kokoonpano
nükleer	ydinaseiden
fare	hiiri
işaret	signaali
adli	rikollinen
Veriliş	annettu
güçlü	voimakas
rüya	unelma
YANLIŞ	VÄÄRÄ
da	da
oyuncular	heittää
çiçek	kukka
personel	henkilöstö
geçti	läpäissyt
verilen	toimitetaan
düşme	Falls
ruh	sielu
desteklemek	edistää
belirtilen	totesi
istatistikler	tilastot
profesyoneller	ammattilaisten
belirir	näyttää
Taşımak	kuljettaa
bayrak	lippu
kapaklar	kannet
em	em
avantaj	etu
Merhaba	Hei
tasarımlar	malleja
sürdürmek	ylläpitää
turizm	matkailu
öncelik	prioriteetti
yetişkinler	aikuiset
grafik	graafinen
atom	atomi
ödemeler	maksut
bağlayıcı	sitova
kısa	lyhyt
Bitti	päättyi
kazanan	voittoisa
anonim	anonyymi
senaryo	käsikirjoitus
hizmet	palveli
istiyor	haluaa
hazırlanmış	valmis
geçersiz	mitätön
etiket	tag
röportaj	haastatella
karıştırmak	sekoittaa
iskelet	puitteet
disk	levy
Kurulmuş	asennetut
kraliçe	kuningatar
kredi	ov
Açıkça	selvästi
düzeltmek	korjata
sap	kahva
tatlı	makea
kriterleri	kriteeri
ortak	kumppani
ne	NE
davranış	käytös
büyütmek	suurentaa
ışın	säde
gelir	tulot
ölçmek	mitata
oy	ääntä
du	du
görev	velvollisuus
tartışmalar	keskustelut
ayı	karhu
kazanç	saada
Festival	festivaali
laboratuvar	laboratorio
okyanus	valtameri
uçuşlar	lennot
uzmanlar	asiantuntijat
işaretler	merkkejä
derinlik	syvyys
tren	kouluttaa
kuru	kuiva
keşfetmek	tutkia
spa	kylpylä
kavram	konsepti
neredeyse	lähes
kullanma	käsittely
Menşei	alkuperä
milyar	miljardi
zeka	älykkyys
satın	ostettu
aleyhte	huijaus
milletler	kansakunnat
rota	reitti
kırık	rikki
savaş	taistelu
konuşmak	puhua
protokol	protokolla
sorgu	tiedustelu
ortaklık	kumppanuus
ifade	ilmaisu
es	es
konuşma	puhe
tel	johdin
öneri	ehdotukset
değiştirme	korvaus
bant	nauha
stratejik	strateginen
hakim	tuomari
asit	happo
bayt	tavua
sent	sentti
zorunlu	pakko
uyumlu	yhteensopiva
apartman	huoneisto
boş	tyhjä
sıfır	nolla
konuşmacı	kaiutin
Danışmanlık	konsultointi
tasarımcı	suunnittelija
pr	PR
evlilik	avioliitto
rulo	rulla
bankalar	pankit
fr	FR
katılımcılar	osallistujaa
gizli	salaisuus
negatif	negatiivinen
Favoriler	suosikit
tiyatro	teatteri
yaylar	jouset
var	var
yapmak	suorittaa
çeviri	käännös
tahminler	arvioiden
hasar	vahinko
bakanlık	ministeriö
sürücüler	kuljettajat
avukat	lakimies
rakamlar	luvut
korumalı	suojattu
öneri	ehdotus
paylaşım	jakaminen
kapı	portaali
beta	beeta
bedava	ilmaiseksi
karşı	kohti
hafifçe	hieman
yardım	avustaa
davranış	käytös
içeriyordu	sisälsi
mevzuat	lainsäädäntö
çağrı	kutsumus
parametreler	parametrit
profiller	profiilit
hususlar	asioissa
evler	talot
kontroller	ohjaimet
kombine	Yhdistetty
nihai	perimmäinen
temsilci	edustaja
küçük	vähäinen
bölümler	osastot
sakinleri	asukkaat
görüntülenen	näyttöön
anne	äiti
indirimli	pelkistetty
nadir	harvinainen
gerçekleştirilen	suoritettu
aşırı	äärimmäinen
örnekler	näytteet
Barlar	baarit
tahmin	ennuste
çıkarıldı	poistettu
Çevrim	sykli
içermek	sisältää
doğruluk	tarkkuus
uyku	nukkua
mg	mg
kuş	lintu
eczane	apteekki
oluşturma	luominen
statik	staattinen
avcı	metsästäjä
adresler	osoitteet
bayan	nainen
kristal	kristalli
ünlü	kuuluisa
yazar	kirjailija
başkan	puheenjohtaja
içki	juoda
akademi	akatemia
dinamik	dynaaminen
yemek	syödä
kalıcı	pysyvä
temizlik	puhdistus
teşkil	muodostaa
portföy	salkku
pratik	käytännöllinen
teslim	toimitetaan
altyapı	infrastruktuuri
renk	väri
satıcı	myyjä
Felsefe	filosofia
düzenleme	säätö
görevlileri	upseerit
amaç	tavoite
teklifleri	tarjouksia
beslenme	ravitsemus
kayıt	äänite
genç	nuorempi
les	les
pelerin	viitta
halkalar	renkaat
bahşiş	kärki
olağanüstü	ihana
bilet	lippu
açıkladı	ilmoitti
tahmin	arvaus
kime	ketä
Futbol	jalkapallo
matematik	matematiikka
ithalat	tuonti
gönderme	komennus
varlık	läsnäolo
otomatik	Automaattinen
görüntüleme	katselu
muhafaza	säilyy
ch	ch
dan	dan
köpekler	koirat
yönetmenler	johtajat
yönleri	näkökohdat
önde	eteenpäin
ay	kuu
katılım	osallistumista
düzen	ohjelma
sinek	lentää
tavır	tapa
matris	matriisi
kombinasyon	yhdistelmä
düzeltme	muutos
kuvvet	vahvuus
Türkiye	Turkki
kütüphaneler	kirjastot
uygun	asianmukainen
derece	astetta
işletmelerin	yrityksille
delta	delta
korku	pelko
arayan	etsiä
inç	tuumaa
Kongre	sopimus
hisseleri	osakkeiden
asıl	pääasiallinen
konfor	mukavuus
renkler	värit
savaşlar	sodat
sipariş	tilaaminen
tuttu	säilytetään
alfa	alfa
temyiz	valitus
seyir	risteily
bonus	bonus
Hey	Hei
binalar	rakennukset
özel	tarjoukset
dövmek	lyödä
piller	akut
olur	tulee
sürücüler	asemat
silâh	aseet
Çay	tee
gelişmiş	parantunut
başarmak	saavuttaa
pozisyonları	kannat
elbise	pukeutua
abone	tilaus
satıcı	jakaja
çağdaş	nykyajan
gökyüzü	taivas
ROM	rom
taşınan	kuljettaa
poz	valotus
saklamak	piilottaa
imza	allekirjoitus
değirmenci	mylläri
hüküm	säännös
çamaşırlar	vaatteet
çerçeveler	kehyksiä
kesinlikle	varmasti
gazete	sanomalehti
oyuncak	lelu
tabaka	kerros
basılı	painettu
yavaş	hidas
uzaklaştırma	poistaminen
yükümlülük	vastuu
yazıcılar	tulostimet
ekleme	lisäämällä
yer	täplä
harcamak	viettää
fabrika	tehdas
iç	sisusta
büyümek	kasvaa
optik	optinen
tanıtım	edistäminen
bağıl	suhteellinen
şaşırtıcı	hämmästyttävä
nokta	piste
Kimlik	identiteetti
dönüştürme	muuntaminen
duygu	tunne
gizli	kätketty
makul	kohtuullinen
revizyon	tarkistus
etki	vaikutus
oran	suhde
önem	merkitys
yağmur	sade
gezegen	planeetta
kopyalar	kappaletta
izin	lupa
görme	koska
kanıt	todiste
bas	basso
reçete	resepti
boş	tyhjä
örnek	ilmentymä
delik	reikä
binmek	ratsastaa
büro	toimisto
koruma	säilyttäminen
çift	pari
ideal	ihanteellinen
gözlük	silmälasit
kaydedilmiş	tallennettu
don	Don
parçalar	kappaletta
bitmiş	päättynyt
parklar	puistot
avukatları	lakimiehet
stres	stressi
krem	kerma
ss	ss
koşar	ajot
keşfetmek	löytää
ap	ap
desenler	kuviot
tepeler	Hills
mil	nm
danışman	neuvonantaja
farkında	tietoinen
şekil	muoto
evrim	evoluutio
sertifikalar	todistukset
hedefleri	tavoitteet
istasyonlar	asemat
önerdi	ehdotti
op	op
kalıntılar	jäännökset
firmalar	yritykset
euro	euro
Şebeke	operaattori
yapıları	rakenteet
genel	yleinen
ansiklopedi	tietosanakirja
kullanım	käyttö
mürekkep	muste
karışık	sekoitettu
sayım	väestönlaskenta
tekerlek	pyörä
tedarikçileri	toimittajat
kompakt	kompakti
şiir	runous
ışıklar	valot
izleme	seuranta
melek	enkeli
hazırlık	valmistautuminen
girişim	yrittää
kabul	vastaanotetaan
maçlar	Ottelut
uyum	mukaisesti
Genişlik	leveys
motorlar	moottorit
unutmak	unohtaa
dizi	ryhmä
tartışılan	keskusteltiin
doğru	tarkka
iklim	ilmasto
Yunan	kreikkalainen
talimat	ohje
yönetme	hallinnassa
çiğ	raaka
farklar	erot
açıklamak	selittää
kurmak	perustaa
ifade	ilmaisi
derece	laajuus
keskin	terävä
ben	ben
paragraf	kohta
öldürmek	tappaa
matematik	matematiikka
tazminat	korvaus
ihracat	viedä
yöneticileri	johtajat
modüller	moduulit
yürütülen	suoritettu
versiyonları	versiot
bilir	tietää
tanımlamak	kuvata
vatandaşlar	kansalaiset
miras	perintö
sorun	vaivata
Koç	valmentaja
tarım	maatalous
genişletmek	laajentaa
seyirci	yleisö
atanmış	osoitettu
koleksiyonları	kokoelmat
yaşlar	iät
uzman	asiantuntija
pişirmek	kokki
etkilemek	vaikuttaa
bakire	Neitsyt
deneyimli	kokenut
soruşturma	tutkimus
kalkık	nosti
şapka	hattu
kurum	instituutio
yönlendirilmiş	suunnattu
etkilenmiş	vaikuttaa
bisiklet	pyörä
bütünüyle	täysin
plaka	levy
giderler	kulut
belirtmek	osoittaa
sarışın	vaalea
kovuşturma	menettely
favori	suosikki
karakteristikleri	ominaisuudet
der	der
kaybetmek	menettää
organik	orgaaninen
aramak	etsiä
deneyimler	kokemukset
albüm	albumit
sözleşmeler	sopimuksia
misafir	vieraita
barındırılan	isännöi
hastalıklar	sairaudet
ilişkin	koskevat
eşdeğer	vastaava
kimya	kemia
kitleri	sarjat
mantık	logiikka
prens	prinssi
daire	ympyrä
toprak	maaperä
Psikoloji	psykologia
ıslak	märkä
koşullar	olosuhteet
yatırımcı	sijoittaja
temel	perus
sponsorlar	sponsorit
tilki	kettu
sınırsız	rajoittamaton
yanıtlamak	vastata
boyutları	koot
sade	tavallinen
çıkış	poistuminen
kol	käsivarsi
anahtarlar	näppäimet
dalga	Aalto
kutsal	pyhä
eylemler	säädökset
rehberlik	opastus
iz	polku
sembol	symboli
karayolu	valtatie
gözlenen	havaitun
dekan	dekaani
kurmak	perustaa
anket	äänestys
stilleri	tyylit
dolu	täynnä
bağ	side
kanallar	kanavat
apandis	liite
çikolata	suklaa
kısım	osa
kapsam	laajuus
satıcı	toimittaja
kablolar	kaapelit
pamuk	puuvilla
gereklilik	vaatimus
öldürdü	surmattu
sınır	reunus
eski	muinainen
tartışma	keskustelu
temsilcileri	edustajia
başlar	alkaa
gebelik	raskaus
konumlar	nähtävyydet
bilgili	oppinut
işlemler	liiketoimet
kâşif	tutkimusmatkailija
tarihi	historiallinen
koca	aviomies
yetkili	valtuutettu
çılgın	hullu
yaklaşan	tuleva
konser	konsertti
Skorlar	tulokset
verim	tehokkuus
komedi	komedia
benimsenen	hyväksyttiin
verimli	tehokas
doğrusal	lineaarinen
taahhüt	sitoutuminen
uzmanlık	erikoisuus
ayılar	karhut
atlama	hypätä
taşıyıcı	kantaja
sabit	jatkuva
Visa	Visa
ağız	suu
metre	mittari
bağlantılı	sidoksissa
görüşmeler	haastattelut
kavramlar	käsitteet
tabanca	ase
yansıtmak	heijastaa
saf	puhdas
cehennem	helvetti
meyve	hedelmä
başlar	alkaa
nitelikli	pätevä
reform	uudistaa
lens	linssi
işlenmiş	käsitelty
keşif	löytö
çekmek	piirtää
sınıflandırılmış	luokiteltu
üstlenmek	olettaa
ittifak	liitto
onaylamak	vahvistaa
mühendis	insinööri
tutarlı	johdonmukainen
değiştirmek	korvata
Boşluk	raivaaminen
dönüştürücü	muunnin
organizasyon	organisaatio
bebek	tyttö
çekler	tarkastuksia
ulaştı	saavuttanut
olma	tulossa
amaç	tavoite
belirtilen	osoitettu
şeker	sokeri
mürettebat	miehistö
bacaklar	jalat
Çubuk	tikku
ilişki	suhde
etkin	käytössä
Tür	laji
gönüllü	vapaaehtoinen
arka	takaosa
demokratik	demokraattinen
artırmak	parantaa
kesin	tarkka
ciltli	sidottu
parametre	parametri
işlemci	suoritin
düğüm	solmu
biçimsel	muodollinen
fırtına	myrsky
mikro	mikro
kolejler	oppilaitokset
mil	maili
zorluklar	haasteet
editörler	Editors
yüce	ylin
Kardeşler	veljet
tanıma	tunnustus
ref	viite
tahmin	arvio
çocuk	lapsi
teftiş	tarkastus
tüketicilerin	kuluttajien
sınırları	rajoja
bölge	alue
silahlar	aseet
gecikme	viive
pilot	lentäjä
katkıları	maksut
sürekli	jatkuva
girişim	aloite
yeni	uusi
icra	suoritus
sakatlık	vammaisuus
ultra	ultra
kazanan	voittaja
bölüm	episodi
çömlekçi	savenvalaja
tabak	ruokalaji
oyunlar	pelaa
bülten	tiedotuslehti
ia	ia
değiştirmek	muuttaa
gerçekten	todella
Evren	maailmankaikkeus
aday	ehdokas
yarık	aukko
ödenmemiş	maksamatta
Ha	ha
planlı	suunnitellut
loca	jättää
ayna	peili
turnuva	turnaus
düşünce	harkinta
oturumları	istuntoja
çekirdek	ydin
alıcılar	ostajien
dergi	lehdet
gri	harmaa
katalog	luettelo
yüklü	peritään
geniş	laaja
und	und
seçilmiş	valittu
gösteri	esittely
nefret	vihata
terminal	pääte
yayıncılar	julkaisijat
gece	öisin
sıvı	neste
pirinç	riisi
rezervasyon	varaus
gıdalar	elintarvikkeet
bekçi	vartija
tasarruf	tallentaa
imparatorluk	imperiumi
yeni	hiljattain
yükseltmek	nostaa
yasadışı	laiton
genişleme	laajeneminen
başbakan	johtava
yarın	huomenna
Süt	maito
dram	draama
ziyaret	vierailevat
yarışma	kilpailu
toplanmış	koottu
bantları	bändejä
uygun	sopiva
kesinlikle	ehdottomasti
denetim	tarkastaa
bölme	kammio
Gine	Guinea
bulgular	tulokset
iso	ISO
tipik	tyypillinen
toplam	summa
tavuk	kana
geçici	tilapäinen
katılmak	käydä
duş	suihku
gönderme	lähettäminen
yeterli	riittävä
kabuk	kuori
il	maakunta
liberal	katolinen
Vali	kuvernööri
bira	olut
katkı	panos
formül	kaava
anayasa	perustuslaki
paketleme	pakkaus
dürüst	luotettava
şüphe	epäillä
kazanmak	ansaita
dönemleri	aikoja
saldırılar	iskut
mal	kauppatavara
semptomlar	oireet
anıt	muistomerkki
ikiz	twin
eklemek	lisätä
geçit	portti
çizim	piirustus
adaylar	ehdokkaat
düzenli	tilasi
biyolojik	biologinen
kavga	taistelevat
geçiş	siirtyminen
tercihleri	mieltymykset
casus	vakooja
romantik	romanssi
enstrüman	väline
Bölünmüş	jakaa
temalar	teemat
güçler	valtuudet
cennet	taivas
bit	bitit
hamile	raskaana
sınıflandırma	luokittelu
odaklı	keskittynyt
doktor	lääkäri
sormak	pyytäminen
bloklar	lohkot
bak	katso
manevi	hengellinen
diyabet	diabetes
mi	ml
vardiya	siirtää
oturmak	istua
bedenler	elinten
fotoğraflar	valokuvat
kesim	leikkaus
yazarlar	kirjailijat
esnek	joustava
sevilen	rakastettu
Favoriler	suosikit
haritalama	kartoitus
sayısız	useat
Nispeten	suhteellisesti
temsil	edustaa
üstün	esimies
tercihli	edullinen
kaydedilmiş	tallennettu
entellektüel	älyllinen
verilmiş	myönnetty
karbon	hiili
rahat	mukava
manyetik	magneettinen
etkileşim	vuorovaikutus
dinleme	kuuntelee
kriz	kriisi
görünüm	näkymät
masif	massiivinen
parlak	kirkas
oluşturulan	muodostettu
piyano	piano
Eko	kaiku
devrim	vallankumous
görüntüler	näytöt
plazma	plasma
kazanç	tulot
gizem	mysteeri
peyzaj	maisema
mekanik	mekaaninen
seyahat	matka
afiş	lippu
incir	kuva
ilçeler	maakunnat
edinme	hankinta
tanınan	tunnistettu
rüyalar	unelmat
bildirim	ilmoitus
kilogram	kg
öğretmek	opettaa
hızlı	nopea
Çek	Vedä
ut	ut
seminer	seminaari
yatırımlar	investoinnit
tekerlekler	pyörät
belirtmek	eritellä
hassas	herkkä
şablonları	malleja
formatları	formaatit
tutar	pitää
yönlendirici	reititin
beton	betoni
si	si
Klasör	kansio
tamamlama	valmistuminen
nabız	pulssi
teknik	tekniikka
oylama	äänestys
mahkemeler	tuomioistuimet
dönüştürülmüş	muunnettu
metro	metro
yıldönümü	vuosipäivä
iyileştirmeler	parannuksia
şerit	kaistale
Şartname	määrittely
kaza	onnettomuus
Nick	lovi
ulaşılabilir	saatavilla
oturan	asukas
arsa	juoni
tipik	tyypillisesti
temsil	edustus
pompa	pumppu
var	olemassa
düzenlemeler	järjestelyt
konferanslar	konferenssit
tüketim	kulutus
dar	kapea
tehdit	uhkaus
anketler	tutkimukset
oturma	istuva
danışman	konsultti
kontrolör	ohjain
komiteler	valiokunnat
penis	penis
kale	linna
bahçeleri	puutarhat
etiketler	tarrat
istekli	halukas
biyo	bio
oyunculuk	näytteleminen
kafaları	päät
sınav	koe
Konut	asuinpaikka
yoğunluk	tiheys
yüz	sata
garip	outo
sürdürülebilir	kestävä
istatistiksel	tilastollinen
Anma	mainita
yenilik	innovaatio
gri	harmaa
paralel	rinnakkainen
işletmek	toimia
fatura	setelit
kararlı	vakaa
tanımlar	määritelmät
von	von
doktorlar	lääkärit
ders	oppitunti
sinema	elokuva
seçimler	vaalit
reaksiyon	reaktio
boş	tyhjä
gelişmiş	tehostettu
adlı	oikeutettu
şiddetli	vaikea
üretmek	Tuottaa
gazeteler	sanomalehdet
hastaneler	sairaalat
vi	vi
Mizah	huumori
yaşlı	ikäinen
monitör	näytöt
istisna	poikkeus
süre	kesto
kütle	pääosa
ziyaret	käyntiä
yetenekleri	kyvyt
tavsiye	suositus
günah	synti
örgütlü	järjestetty
ba	ba
paragraf	kappale
Benimseme	hyväksyminen
geliştirme	parantaminen
pahalı	kallis
bizon	puhveli
organizasyonlar	organisaatioiden
uçak	kone
programlar	ohjelmat
mekanizma	mekanismi
ee	ee
işaretlenmiş	merkitty
tahrik	ajettu
şişe	pullo
yenilikçi	innovatiivinen
masaj	hieronta
Sonuç	johtopäätös
kapanış	sulkeminen
bin	tuhat
efsane	legenda
villa	huvila
kemik	luu
sütunlar	pylväät
bozukluklar	häiriöt
işbirliği	yhteistyö
bulma	havaitseminen
iç	sisäinen
formasyon	muodostus
med	med
mühendisler	insinöörien
varlık	kokonaisuus
yolculukları	risteilyt
kapı	portti
Roma	roomalainen
görevleri	tehtävät
erotik	eroottinen
ton	sävy
ahlâk	etiikka
Ejderha	lohikäärme
meşgul	kiireinen
Kaptan	kapteeni
getiriyor	tuo
ısıtma	lämmitys
bacak	jalka
boyun	niska
kanat	siipi
senaryo	skriptejä
ABC	ABC
döşenmiş	nimitetty
muamele	tekemisissä
işlemek	sitoutumaan
Demiryolu	kisko
gezileri	matkat
boşluk	aukko
taraf	sivut
tüp	putki
uyan	vastaava
açıklamaları	kuvaukset
kemer	vyö
ceket	takki
animasyon	animaatio
torpil	oraakkeli
er	er
yapımları	tuotannot
havacılık	ilmailu
gururlu	ylpeä
afet	katastrofi
konsol	konsoli
komutlar	komennot
jr	jr
telekomünikasyon	tietoliikenne
eğitmen	ohjaaja
dev	jättiläinen
elde	saavutettu
yaralanmalar	vammat
yaklaşımlar	lähestymistavat
olağan	tavallinen
pullar	postimerkkejä
açı	kulma
soymak	ryöstää
tasarımcılar	suunnittelijat
özgürlük	vapaus
çağ	aikakausi
dönüştürmek	muuntaa
olasılık	mahdollisuus
analist	analyytikko
tehlikeli	vaarallinen
güvenilirlik	luotettavuus
sırasıyla	vastaavasti
gönüllüler	vapaaehtoiset
türetilmiş	johdettu
Zevk	ilo
Onur	kunnia
yönlü	suuntautunut
kartal	kotka
namaz	rukous
atölyeler	työpajat
kasırga	Hurrikaani
sessiz	hiljainen
yapımcı	tuottaja
temsil	edustettuina
sorumluluklar	vastuut
peynir	juusto
dikkatlice	huolellisesti
verimlilik	tuottavuus
taç	kruunu
eşitlik	par
Teşhis	diagnoosi
yapıcı	valmistaja
çatlak	crack
prensip	periaate
seçtikleri	poimii
çete	jengi
fetiş	fetissi
görünüm	ulkomuoto
duman	savu
filtreler	suodattimet
Anonim	yhdistetty
zanaat	alus
adam	kaveri
kör	sokea
salon	aula
deli	hullu
algoritma	algoritmi
şiddetle	voimakkaasti
kafe	kahvila
ken	ken
proteinler	proteiineja
su	su
tanıdık	tuttu
yetenekli	kykenevä
kabul	pääsy
ayakkabı	kenkä
seçildi	valittiin
taşıma	kuljettaa
terörizm	terrorismi
sevinç	ilo
sürümleri	painokset
etnik	etninen
parlamento	eduskunta
aktör	näyttelijä
buluntular	löydöt
mühür	tiiviste
durumlar	tilanteita
beşinci	viides
vatandaş	kansalainen
dikey	pystysuora
düzeltmeler	korjaukset
açıklar	kuvailee
engelli	vammaiset
madde	aine
yasak	kielletty
boru	putki
askerler	sotilaat
Gardiyan	holhooja
ders	luento
simülasyon	simulointi
düzen	layout
girişimler	aloitteita
hasta	sairas
konsantrasyon	keskittyminen
yatırmak	asettaa
yorumlama	tulkinta
kirli	likainen
öğretilen	opettanut
işçi	työntekijä
optimizasyon	optimointi
tapınak	temppeli
maddeler	aineet
kanıtlamak	todistaa
keşfedilen	löydetty
kanatlar	siivet
genetik	geneettinen
kısıtlamalar	rajoituksia
ince	ohut
sergi	näyttely
sırt	harjanne
modem	modeemi
getiren	tuoden
hasta	sairas
değerlendirmek	arvioida
tropikal	trooppinen
toplamak	kerätä
vektör	vektori
kesinlikle	ehdottomasti
döndürme	kääntyminen
varoluş	olemassaolo
yorum	selostus
gelişmeler	kehitys
göç	maahanmuutto
yerler	kohteet
karşılıklı	keskinäinen
sözdizimi	syntaksi
li	li
nitelik	ominaisuus
hapis	vankila
beceri	taito
sandalye	tuolit
çevreleyen	ympäröivä
dağlar	vuoret
popülerlik	suosio
soruşturma	tiedustelu
kontrol	tarkistettu
sergi	näyttely
atmak	heittää
akım	trendi
kediler	kissat
çöl	aavikko
ya	ya
koordinatör	koordinaattori
Merkür	elohopea
yanan	palaa
kaçış	paeta
alıcı	vastaanotin
ilerici	etenevä
tekneler	veneet
şampiyonluk	mestaruus
çarşı	arkadi
imkansız	mahdoton
anlatır	kertoo
açık	ilmeinen
depresyon	masennus
grafik	kaavio
kaplama	päällyste
platin	platina
yargı	tuomio
görüşmeler	neuvottelut
dosyalama	arkistointi
beslemek	edistää
layık	palkittiin
denemeler	tutkimuksissa
ustaları	Masters
kartuş	patruuna
açıklama	selitys
org	Org
dolandırıcılık	petos
elektrik	sähkö
spektrum	spektri
varış	saapuminen
çömlekçilik	keramiikka
vurgu	painotus
müthiş	mahtava
onaylı	vahvistettu
sayımları	laskee
kaza	romahdus
asansör	hissi
arası	inter
yükseklikleri	korkeudet
gölge	varjo
gider	kulu
girişim	hanke
klinik	klinikka
şifa	paranemista
prenses	prinsessa
girme	kirjoittamalla
paket	paketti
stüdyoları	studiot
ilgi	osallistuminen
baba	isä
düğmeleri	painikkeet
yerleştirme	sijoitus
gözlemler	havainnot
kazananlar	voittajat
yollar	tiet
sonraki	myöhempi
avlu	piha
ifşa	julkistaminen
kuruluş	perustaminen
hatıralar	muistoja
te	te
yaratır	luo
yüzleri	kasvoja
turist	turisti
cinayet	murhata
yeterli	riittävä
senatör	senaattori
sunumlar	esitykset
özet	sulattaa
toz	pöly
wiki	wiki
değiştirilir	vaihdettu
radar	tutka
kayıplar	tappiot
savaş	taistelu
indirgen	vähentäminen
durduruldu	pysäytetty
Meslek	ammatti
yakından	tarkasti
radyasyon	säteily
krallar	kuninkaat
çekim	ammunta
kulak	korva
bayraklar	liput
fırıncı	leipuri
muhafazakâr	konservatiivinen
şok	järkyttää
etki	tehokkuuden
kravat	solmio
çatı	katto
göstermek	osoittaa
atmosfer	ilmapiiri
öpücük	suudella
canavar	peto
ra	ra
ameliyat	toimi
deney	koe
hedefler	tavoitteet
alımları	ostot
federasyon	liittovaltio
Pizza	pizza
davet	kutsuttu
atama	toimeksianto
şık	mod
sorguları	kyselyt
yokluk	poissaolo
satıcıları	myyjät
yoga	jooga
vermektedir	palvelee
sürpriz	yllätys
Lamba	lamppu
espriler	vitsit
danışmanlık	neuvonta
Saray	palatsi
memnun	vakuuttunut
kazanç	voittoa
depo	varasto
sözde	oletettu
sıradan	tavallinen
hayalet	aave
ihlal	rikkominen
patron	pomo
gurur	ylpeys
beklentiler	odotukset
bağımsızlık	itsenäisyys
bilme	tietäen
muhabir	reportteri
metabolizma	aineenvaihdunta
şampiyon	mestari
Şahsen	henkilökohtaisesti
bol	paljon
solo	soolo
boğaz	kurkku
servet	rikkaus
vakum	tyhjiö
dans	tanssi
tanımak	tunnistaa
yazıyor	kirjoittaa
plaza	aukio
araştırma	etsintä
Yayınla	julkaista
tarama	seulonta
trans	trans
öncü	pioneeri
unutulmuş	unohdettu
akrobat	akrobaatti
plakalar	levyt
denemeler	esseitä
davranış	käytös
söylüyorum	kertominen
oldukça	melko
akıllı	älykäs
modları	tilat
yükümlülük	vaatimus
liman	satama
gezgin	matkustaja
bölüm	segmentti
düşman	vihollinen
bulmaca	palapeli
kuyular	kaivot
kısıtlı	rajoitettu
cumhuriyetçi	tasavaltalainen
sırlar	salaisuudet
sendrom	oireyhtymä
katılım	läsnäolo
ceza	rangaistus
davul	rumpu
sağlayan	mahdollistaa
kurucu	rakentaja
manzara	näköala
sel	tulva
kolaylaştırmak	helppous
argümanlar	argumentit
arena	areena
maceralar	seikkailuja
öğrenciler	oppilaat
duyuru	ilmoitus
sonuç	tulokset
anlamak	arvostaa
genişletilmiş	laajennettu
yetişkin	täysikasvuinen
güzel	ihana
merkezleri	keskuksissa
fıkra	lauseke
gülümseme	hymy
topraklar	maat
asker	joukot
silâhlı	aseistettu
çam	mänty
soğutma	jäähdytys
körfez	kuilu
kamyonlar	autot
mekanizmalar	mekanismit
boşanma	avioero
gelenek	perinne
haplar	pillereitä
kaplan	tiikeri
arkadaşlar	ihmiset
algılayıcı	sensori
maruz	avoin
av	metsästää
melekler	enkelit
milletvekili	sijainen
Tayland	thaimaalainen
emisyonları	päästöt
hekimler	lääkärit
şikâyet	valitus
sahneler	kohtaukset
deneyler	kokeiluja
artırmak	edistää
Yönetim	hallintotavan
değirmen	mylly
kurulmuş	perustettu
kronik	krooninen
den	den
parmak	sormi
tutar	pitää
pound	punta
yerleştirmek	paikantaa
pl	pl
eğitilmiş	koulutettu
uygulanması	toteuttamisessa
ekmek	leipä
motorlar	moottorit
sert	kova
olay	tapaus
dinamik	dynamiikka
Yalan	valehdella
konuşma	keskustelu
azaltmak	pienentää
ibadet	palvonta
kabiliyet	valmiudet
ak	ak
hassas	tarkkuus
tazminat	vahingonkorvaus
rezervler	varaukset
çözmek	ratkaista
azınlık	vähemmistö
çeşitli	monipuolinen
malzemeler	ainekset
Ah	Ah
sesleri	sävyt
rehabilitasyon	kuntoutus
görme	näky
kil	savi
zayıf	heikko
bölünmüş	jaettu
resepsiyon	vastaanotto
bilge	viisas
olasılık	todennäköisyys
seminer	seminaarit
sonuçları	seuraukset
vericiler	päättäjille
coğrafya	maantiede
bütünlük	eheys
miras	perintö
memnun	tyytyväinen
Tehlike	vaara
vitamin	vitamiini
işlenmiş	jalostettu
ifade	fraasi
yükselen	nostaminen
etkileri	vaikutukset
işlevselliği	toiminnallisuus
cennet	paratiisi
melez	hybridi
okur	lukee
duygusal	tunteellinen
şan	kunnia
ja	ja
coğrafi	maantieteellinen
aşmak	ylittää
çubuk	sauva
ipek	silkki
bebekler	vauvat
bi	bi
romantik	romanttinen
ortaya	paljastui
uzmanlar	asiantuntijat
jeneratör	generaattori
süspansiyon	jousitus
üzgün	surullinen
düzeltme	korjaus
Kurt	susi
yavaşça	hitaasti
ek	täydentää
bölümleri	osat
bebek	pikkulasten
sektörler	aloilla
akışkan	neste
zeminler	perusteet
yemek	ateria
ta	ta
makinalar	koneet
denklem	yhtälö
sepetler	korit
olasılık	todennäköisyys
boyut	ulottuvuus
okudu	tutkittu
kar	voitot
şeytan	paholainen
çimen	ruoho
resimli	kuvitettu
Kiraz	kirsikka
kıta	mannermainen
başarı	saavutus
sınırlamaları	rajoituksia
cenaze	hautajaiset
bölümler	luvuissa
yolcu	matkustaja
uygun	mukava
Mars	Mars
boy	kokoinen
Yumurta	muna
sinyalleri	signaalit
oryantasyon	suuntautuminen
Çalınması	varkaus
çocukluk	lapsuus
semboller	symbolit
lat	lat
meta	meta
analog	analoginen
yetenek	lahjakkuus
tarihli	päivätty
bilgelik	viisaus
sınır	raja
seçkinler	eliitti
gi	gi
inanır	uskoo
şiirler	runoja
yargı	toimivalta
robot	robotti
sergileyen	näyttämällä
tanık	todistaja
donanımlı	varustettu
aşamaları	vaiheet
sur	sur
Edinilen	hankittu
belirlemek	arvioida
yıkama	pestä
Giriş	Sisäänkäynti
deklarasyon	ilmoitus
kaybetme	menettää
denemeler	yrityksiä
asil	jalo
otomasyon	automaatio
etkiler	vaikutukset
devir	kierros
avantajları	edut
şövalye	ritari
Amaçları	tavoitteet
uzantılar	laajennukset
itirazlar	valitukset
hastalık	sairaus
ho	ho
alternatifleri	vaihtoehtoja
sh	sh
sabun	saippua
reçel	hillo
olağandışı	epätavallinen
cevap	vastasi
imha	tuho
göç	muutto
düzensizlik	häiriö
Konvansiyonel	tavanomainen
giyme	yllään
eksen	akseli
aranan	pyrittiin
genler	geenit
medyan	mediaani
tarayıcı	skanneri
burada	tässä
canlandırılmış	eloisa
ayarlama	säätö
kahraman	sankari
tedaviler	hoidot
tutum	asenne
halı	matto
lensler	linssit
katıldı	osallistui
zorluk	vaikeus
punk	punk
koalisyon	koalitio
kayıt	rekisteröinti
dük	herttua
hız	vauhti
üreticileri	tuottajia
yay	kaari
arayüzleri	rajapinnat
Atlas	kartasto
gözlem	havainto
işkence	kiduttaa
silindi	Poistetaan
ceket	takki
restorasyon	entisöinti
Kolaylık	sopivuus
dönen	palaavat
muhalefet	oppositio
konteyner	kontti
sanık	vastaaja
gözetmen	valvoja
kolordu	joukot
aktörler	toimijoiden
karaciğer	maksa
sorumlu	velvollinen
dilekçe	adressi
anten	antenni
seçilmiş	poimitaan
inanç	uskomus
öldürme	tappaminen
omuz	olkapää
dekor	sisustus
iyon	ioni
çap	halkaisija
podcast	podcast
etkileşimler	vuorovaikutukset
şarkıcı	laulaja
haberci	airut
yaşlanma	vanheneminen
müdahale	interventio
Eklenti	kytkeä
cazibe	vetovoima
dalış	sukellus
değişiklik	muutos
varsaymak	olettaa
kamış	ruoko
dahil	sisältää
ılımlı	kohtalainen
fareler	hiiret
anladım	ymmärsi
hızla	nopeasti
yasak	kieltää
güvence	varmuus
olay	happening
Muazzam	valtava
üreticiler	myllyt
taslak	ääriviivat
aldığı	vastaanottaa
kot	farkut
derleme	kokoelma
garip	outo
sigma	sigma
gr	gr
çekici	viehättävä
fırsat	tilaisuus
kayıtları	tallenteet
kurban	uhri
talepler	vaatii
dikkatli	varovainen
kiriş	palkki
Bahçıvanlık	puutarhanhoito
yükümlülükleri	velvoitteet
varmak	saapua
orkestra	orkesteri
lisans	lisenssi
ayarlanabilir	säädettävä
tahsis	jako
deneme	essee
gösterdi	osoittivat
diyalog	vuoropuhelu
kampları	leirit
beyan	julistettu
iz	jäljittää
kapamak	sulkea
paketleri	pakkauksissa
