arasında	de
için	à
içinde	dans
için	pour
olduğu	est
üzerinde	sur
o	cette
tarafından	par
bu	ce
ile	avec
ben	je
sen	toi
o	il
veya	ou
olmak	être
Hangi	sont
en	à
herşey	tout
var	avoir
yeni	Nouveau
Biz	nous
irade	volonté
ev	maison
bize	nous
hakkında	sur
Eğer	si
sayfa	page
benim	mon
vardır	a
arama	chercher
ücretsiz	gratuit
fakat	mais
bizim	notre
bir	un
diğer	autre
yap	faire
bilgi	information
zaman	temps
o	il
hangi	lequel
onların	leur
haber	nouvelles
kullanım	utilisation
Orada	Là
görmek	voir
yani	alors
kim	qui
ağ	toile
Ayrıca	aussi
almak	obtenir
pm	pm
görünüm	vue
c	c
e	e
ilk	premier
olmuştur	été
olur	aurait
idi	étaient
s	s
sevmek	comme
x	X
göre	que
bulmak	trouver
fiyat	prix
geri	arrière
üst	Haut
insanlar	gens
vardı	avait
liste	liste
isim	prénom
sadece	juste
yıl	an
gün	journée
içine	dans
iki	deux
sağlık	santé
n	n
yeniden	ré
Kullanılmış	utilisé
gitmek	aller
b	b
son	dernier
Yapmak	faire
onları	leur
meli	devrait
ürün	produit
sistem	système
posta	poster
ona	sa
Kent	ville
t	t
politika	politique
numara	nombre
destek	soutien
mesaj	message
sonra	après
sonra	puis
Ocak	jan
iyi	bien
d	ré
nerede	où
bilgi	Info
haklar	droits
kitaplar	livres
yüksek	haute
okul	école
m	m
her	chaque
bağlantılar	liens
o	elle
yıl	années
sipariş	commande
çok	très
kitap	livre
ürün	articles
şirket	compagnie
r	r
okumak	lis
grup	groupe
seks	sexe
çok	beaucoup
kullanıcı	utilisateur
de	de
set	ensemble
genel	général
Araştırma	recherche
Üniversite	Université
Ocak	janvier
posta	courrier
tam	plein
yorumlar	avis
program	programme
bilmek	connaître
oyunlar	Jeux
yol	façon
günler	journées
p	p
Bölüm	partie
could	pourrait
harika	génial
birleşmiş	uni
gerçek	réal
f	F
Uluslararası	international
merkez	centre
seyahat	Voyage
yorumlar	commentaires
yapılmış	fabriqué
gelişme	développement
rapor	rapport
üye	membre
ayrıntılar	détails
hat	ligne
şartlar	termes
önce	avant
oteller	hôtels
did	fait
göndermek	envoyer
sağ	droite
tip	type
yerel	local
bu	ceux
Sonuçlar	résultats
ofis	Bureau
Ulusal	nationale
araba	voiture
dizayn	conception
almak	prendre
gönderildi	posté
adres	adresse
topluluk	communauté
içinde	dans
devletler	États
istemek	vouloir
telefon	téléphone
DVD	DVD
konu	assujettir
arasında	entre
forum	forum
aile	famille
l	l
uzun	longue
w	w
göstermek	montrer
O	o
Üstelik	même
siyah	noir
özel	spécial
indeks	indice
olmak	étant
KADIN	femmes
çok	beaucoup
işaret	signe
dosya	fichier
bağlantı	lien
açık	ouvrir
güney	Sud
dava	Cas
proje	projet
sayfalar	pages
versiyon	version
Bölüm	section
kendi	posséder
ev	maison
güvenlik	Sécurité
g	g
kontluk	comté
Amerikan	américain
Fotoğraf	photo
oyun	Jeu
üyeler	membres
güç	Puissance
ağ	réseau
bilgisayar	ordinateur
sistemler	systèmes
üç	Trois
yer	endroit
son	fin
h	h
onu	lui
başına	par
erişim	accès
düşünmek	pense
kuzeyinde	Nord
kaynaklar	Ressources
şimdiki	actuel
büyük	gros
medya	médias
kanun	loi
kontrol	contrôle
Su	eau
Tarihçe	histoire
boyut	Taille
kişisel	personnel
kılavuz	guider
Dükkan	boutique
rehber	annuaire
değişiklik	changement
beyaz	blanc
Metin	texte
küçük	petit
değerlendirme	évaluation
oran	taux
hükümet	gouvernement
çocuklar	enfants
dönüş	revenir
öğrencilerin	élèves
v	v
hesap	Compte
zamanlar	fois
seviye	niveau
dijital	numérique
profil	profil
önceki	précédent
form	forme
olaylar	événements
Aşk	amour
eski	vieux
John	John
ana	principale
aramak	appel
görüntü	image
Bölüm	département
Başlık	Titre
olmayan	non
k	k
y	y
sigorta	Assurance
acak	doit
özellik	propriété
sınıf	classe
CD	CD
kalite	qualité
her	chaque
listeleme	inscription
içerik	contenu
ülke	pays
küçük	peu
araçlar	outils
düşük	faible
cevap	répondre
müşteri	client
Aralık	décembre
karşılaştırmak	comparer
filmler	films
kolej	Université
değer	valeur
makale	article
adam	homme
Meslekler	emplois
j	j
Gıda	aliments
yazar	auteur
farklı	différent
u	u
öğrenmek	apprendre
satış	vente
baskı	impression
kurs	cours
iş	emploi
oda	chambre
Stok	Stock
Eğitim	entraînement
çok	aussi
kredi	crédit
puan	point
Bilim	science
erkekler	Hommes
kategoriler	catégories
batı	Ouest
bak	Regardez
ingilizce	Anglais
takım	équipe
arazi	biens
Kutu	boîte
koşullar	conditions
fotoğraflar	Photos
eşcinsel	gai
iplik	fil
kategori	Catégorie
Not	Remarque
canlı	vivre
büyük	grand
galeri	Galerie
tablo	table
ancak	toutefois
Haziran	juin
Ekim	octobre
Kasım	novembre
Market	marché
kütüphane	bibliothèque
aksiyon	action
başla	début
dizi	séries
Özellikler	fonctionnalités
hava	air
sanayi	industrie
plan	plan
insan	Humain
Evet	Oui
ikinci	seconde
Sıcak	chaud
maliyet	Coût
film	film
forumlar	forums
Mart	Mars
la	la
Eylül	septembre
söylemek	dire
gidiyor	Aller
tıbbi	médical
arkadaş	ami
Aralık	déc
sunucu	serveur
uygulama	application
Personel	Personnel
oyun	jouer
sorunlar	problèmes
Nisan	avril
kullanıcılar	utilisateurs
sokak	rue
konu	sujet
karşısında	contre
var	eu
Blog	Blog
Parti	fête
ödeme	Paiement
ekipman	équipement
let	laisser
programlar	programmes
yasal	légal
son	récent
park	parc
davranmak	acte
sorun	problème
kırmızı	rouge
vermek	donner
bellek	Mémoire
performans	performance
sosyal	social
q	q
Öykü	récit
satmak	vendre
seçenekleri	Options
deneyim	expérience
anahtar	clé
vücut	corps
genç	Jeune
önemli	important
alan	champ
az	peu
Doğu	est
tek	unique
ii	ii
yaş	âge
kulüp	club
örnek	Exemple
kızlar	filles
z	z
yol	route
hediye	cadeau
soru	question
CA	Californie
zor	difficile
ödeme	Payer
dört	quatre
poker	poker
konu	problème
menzil	gamme
bina	bâtiment
satıcı	vendeur
mahkeme	tribunal
Şubat	février
sonuç	résultat
ışık	lumière
yazmak	écrire
savaş	guerre
teklif	offre
mavi	bleu
gruplar	groupes
ark	Al
kolay	facile
verilmiş	donné
istek	demande
faks	fax
Çin	Chine
yapma	fabrication
resim	image
ihtiyaçlar	Besoins
mümkün	possible
ay	mois
majör	Majeur
star	étoile
gelecek	avenir
uzay	espace
Kurul	Comité
el	main
Güneş	Soleil
kartları	cartes
Londra	Londres
toplantı	réunion
olmak	devenir
çocuk	enfant
Tut	garder
porno	porno
pay	partager
benzer	similaire
Bahçe	jardin
okullar	écoles
milyon	million
katma	ajoutée
referans	référence
şirketler	entreprises
bebek	bébé
öğrenme	apprentissage
enerji	énergie
koşmak	courir
teslim	livraison
popüler	populaire
terim	terme
film	film
hikayeleri	histoires
koymak	mettre
dergi	journal
raporlar	rapports
ko	co
Deneyin	essayer
Görüntüler	images
ihbar	remarquer
Allah	Dieu
orijinal	original
kafa	tête
radyo	radio
hücre	cellule
konsey	conseil
içerir	comprend
Izlemek	Piste
tartışma	discussion
Arşiv	archiver
diğerleri	autres
anlaşma	accord
biçim	format
toplum	société
ay	mois
Emniyet	sécurité
Arkadaş	copains
emin	sûr
baskı	édition
mesajları	messages
pazarlama	commercialisation
söylemek	dire
birleşme	association
sağlar	fournit
eğlence	amusement
zaten	déjà
yeşil	vert
çalışmalar	études
kapat	Fermer
ortak	commun
özel	spécifique
birkaç	nombreuses
yaşam	vivant
Toplamak	collection
denilen	appelé
kısa	court
sanat	lettres
çok	lot
Sor	demander
sınırlı	limité
çözeltiler	solutions
yönetmen	réalisateur
plaj	plage
geçmiş	passé
doğal	Naturel
elektronik	électronique
üzerine	sur
dönem	période
planlama	Planification
diyor	dit
resmi	officiel
mar	mar
tamam	terminé
teknik	technique
pencere	fenêtre
profesyonel	pro
bölge	Région
ada	île
kayıt	record
direkt	direct
konferans	conférence
kayıtlar	archives
st	st
ilçe	district
takvim	calendrier
maliyetler	frais
stil	style
Beyan	déclaration
mil	miles
kaynak	Ressource
uygulamaları	applications
belge	document
sözcük	mot
Eserleri	travaux
malzeme	Matériel
fatura	facture
yazılı	écrit
kurallar	règles
nihai	final
şey	chose
merkez	centre
Gereksinimler	exigences
DOĞRU	VRAI
dakika	minutes
Başka	autre
işaret	marque
Kaya	Roche
kötü	mal
bireysel	individuel
artı	plus
Oto	auto
kapak	couverture
Düzenle	modifier
birlikte	ensemble
videolar	vidéos
hızlı	vite
fonksiyon	fonction
gerçek	fait
alma	obtention
global	global
teknoloji	technologie
karşılamak	rencontrer
uzak	loin
ekonomik	économique
tr	en
oyuncu	joueur
projeler	projets
Miktar	montant
izlemek	regarder
dahil	inclus
hissetmek	ressentir
banka	banque
risk	risque
fırsatlar	offres
çeşitli	divers
kelimeler	mots
üretim	production
ticari	commercial
ağırlık	poids
kalp	cœur
tedavi	traitement
makas	points
bilgi	connaissance
dergi	magazine
hata	Erreur
kamera	caméra
kız	fille
inşaat	construction
oyuncaklar	jouets
kayıtlı	inscrit
domain	domaine
yöntemleri	méthodes
bölüm	chapitre
koruma	protection
politikaları	politiques
geniş	large
güzellik	beauté
müdür	directeur
Hindistan	Inde
pozisyon	position
alınmış	pris
çeşit	Trier
listeleri	annonces
bilinen	connu
yarım	moitié
vakalar	cas
adım	étape
mühendislik	ingénierie
basit	simple
hızlı	rapide
lisans	Licence
göl	Lac
bütün	entier
yıllık	annuel
yayınlanan	publié
kilise	église
yöntem	méthode
aktif	actif
tepki	réponse
şekil	figure
malzemeler	matériaux
yeterli	assez
tasarlanmış	conçu
arasında	parmi
ölüm	décès
kayıp	perte
yüz	visage
marka	marque
indirim	remise
Etkileri	effets
oluşturulan	créé
standartlar	normes
bit	bit
siyasi	politique
krallık	Royaume
baz	base
iş	Faire
krediler	prêts
ayakkabı	chaussures
giriş	entrée
kalmak	rester
emirler	ordres
kullanılabilirlik	disponibilité
özet	résumé
dönüş	tour
büyüme	croissance
Ajans	agence
kral	Roi
Avrupa	européen
aktivite	activité
kopya	copie
batı	occidental
Kuvvet	Obliger
iş	emploi
Defne	baie
nehir	rivière
komisyon	commission
paket	paquet
görüldü	vu
oyuncu	joueurs
motor	moteur
Liman	Port
albüm	album
bölgesel	régional
durdurmak	Arrêtez
başladı	commencé
yönetim	administration
bar	bar
enstitü	institut
görünümler	vues
çift	double
köpek	chien
yakında	bientôt
hatlar	lignes
elektronik	électronique
faydaları	avantages
gerekli	nécessaire
yazıcı	imprimante
şart	condition
etkili	efficace
inanmak	croyez
organizasyon	organisation
Efekt	effet
us	esprit
seçim	sélection
kumarhane	casino
pdf	pdf
tur	tour
çapraz	traverser
umut	espérer
şirket	société
dilek	souhait
çözüm	Solution
olgun	mature
rol	rôle
haftalar	semaines
belli	certain
alt	inférieur
gerekli	nécessaire
Birlik	syndicat
Pazartesi	lun
com	com
belirli	particulier
ince	bien
saat	heure
gaz	gaz
becerileri	compétences
altı	six
çalı	buisson
adaları	îles
tavsiye	Conseil
kariyer	carrière
karar	décision
ayrılmak	laisser
önceden	pré
Kocaman	énorme
Kadın	femme
tesisler	installations
teklif	offre
orta	milieu
kablo	câble
fırsatlar	Opportunités
alma	prise
değerler	valeurs
bölünme	division
gelecek	arrivant
nesne	objet
lezbiyen	lesbienne
uygun	approprié
makine	machine
logo	logo
uzunluk	longueur
Güzel	agréable
Gol	But
istatistik	statistiques
müşteri	client
Numune	échantillon
yatırım	investissement
gönderilen	envoyé
gösterilen	montré
Noel	Noël
kültür	Culture
flaş	flash
MS	Mme
seçim	choix
dersler	cours
tüketici	consommateur
Merhaba	salut
yabancı	étranger
sanatçı	artiste
mobilya	meubles
kanal	canal
mektup	lettre
kip	mode
telefonlar	Téléphones
fikirler	idées
yapı	structure
derece	degré
sözleşme	Contrat
Süper	super
erkek	mâle
madde	matière
neredeyse	presque
bulunan	situé
çoklu	plusieurs
dağıtım	Distribution
editör	éditeur
Han	auberge
Sanayi	industriel
potansiyel	potentiel
şarkı	chanson
los	los
düşmek	tomber
Fikir	idée
Odalar	pièces
iletişim	communications
kazanmak	gagner
birincil	primaire
kanser	cancer
sayılar	Nombres
neden	raison
araç	outil
bahar	printemps
vakıf	fondation
Cevap	répondre
ses	voix
program	programme
evraklar	documents
amaç	objectif
özellik	fonctionnalité
yatak	lit
geliyor	vient
polis	police
bağımsız	indépendant
yaklaşım	approche
kahverengi	marron
fiziksel	physique
Tepe	colline
haritalar	Plans
ambar	tenir
derecelendirme	évaluations
mutlu	content
demirci	forgeron
gelişmiş	développé
teşekkür	remercier
kasa	sûr
benzersiz	unique
anket	enquête
önceki	avant
telefon	Téléphone
spor	sport
hazır	prêt
hayvan	animal
kaynaklar	sources
nüfus	population
baba	Pennsylvanie
düzenli	ordinaire
güvenli	garantir
operasyonlar	opérations
basitçe	simplement
kanıt	preuve
istasyon	gare
anlama	comprendre
seçenek	option
vadi	vallée
muhtemelen	Probablement
deniz	mer
yayınlar	publications
iyileştirmek	améliorer
bağ	connexion
Yayımcı	éditeur
salon	salle
anti	anti
ağlar	réseaux
toprak	Terre
ebeveyn	Parents
darbe	impact
Aktar	transfert
Giriş	introduction
mutfak	cuisine
kuvvetli	fort
düğün	mariage
özellikleri	Propriétés
hastane	hôpital
zemin	sol
gemi	navire
Konaklama	hébergement
hastalık	maladie
mükemmel	excellent
mükemmel	parfait
saç	cheveux
fırsat	opportunité
malzeme	trousse
klasik	classique
temel	base
komuta	commander
şehirler	villes
ekspres	Express
ödül	prix
mesafe	distance
ağaç	arbre
değerlendirme	évaluation
duvar	mur
ilgili	impliqué
el	el
ekstra	supplémentaire
özellikle	notamment
bütçe	budget
kılavuzlar	guides
başarı	Succès
maksimum	maximum
anne	mère
operasyon	opération
mevcut	existant
oldukça	assez
seçilmiş	choisi
oğlan	garçon
restoranlar	Restaurants
güzel	beau
uyarı	Attention
yerleri	Emplacements
at	cheval
oy	vote
Çiçekler	fleurs
yıldızlar	étoiles
listeleri	listes
sahip	propriétaire
hayvanlar	animaux
yolları	façons
oğul	fils
sağlama	fournir
kural	règle
Konut	logement
alır	prend
getirmek	apporter
katalog	catalogue
maksimum	max
anne	mère
yetki	autorité
söyledi	Raconté
program	programme
katıldı	relié
giriş	contribution
strateji	stratégie
ayaklar	pieds
ajan	agent
geçerli	valide
modern	moderne
kıdemli	Sénior
seksi	sexy
öğretim	enseignement
kapı	porte
büyük	grandiose
Deneme	procès
birimler	unités
güzel	cool
normal	Ordinaire
kuruluş	entreprise
gemiler	navires
tüm	tout
pozitif	positif
Fitness	aptitude
Çince	chinois
görüş	opinion
Futbol	Football
soyut	abstrait
çıktı	sortie
para	fonds
Bay	M
muhtemelen	probable
geliştirmek	développer
sanatçılar	artistes
alternatif	alternative
sorumluluk	responsabilité
java	Java
konuk	client
yayın	publication
pas	passer
ilişkiler	rapports
güven	confiance
kamyonet	van
içeren	contient
çok	multi
cumhuriyet	république
harç	honoraires
bileşenler	Composants
tatil	vacances
yüzyıl	siècle
akademik	académique
yardım	assistance
tamamlanan	terminé
cilt	peau
grafik	graphique
Hintli	Indien
halka	bague
sınıf	qualité
dağ	Montagne
organizasyonlar	organisations
filtre	filtre
panel	panneau
zemin	sol
alış	achat
maç	rencontre
önerilen	proposé
gerektirir	exiger
çocuklar	garçons
sabah	Matin
verir	permet
protein	protéine
bitki	plante
rapor	signalé
vurmak	frappé
aa	mm
havuz	bassin
mini	mini
siyaset	politique
ortak	partenaire
yazarlar	auteurs
panoları	planches
balık	poisson
üyelik	adhésion
misyon	mission
göz	œil
sicim	chaîne
duyu	sens
değiştirilmiş	modifié
yayınlandı	libéré
evre	étape
iç	interne
doğmuş	née
detaylı	détaillé
Japonca	Japonais
yarış	course
onaylı	approuvé
hedef	cible
dışında	sauf
karakter	personnage
bakım	entretien
kabiliyet	aptitude
ed	ed
kolza	râpé
pil	batterie
gençlik	jeunesse
basınç	pression
gönderilen	soumis
borç	dette
orta	moyen
televizyon	télévision
Ilgilenen	intéressé
çekirdek	coeur
mola	Pause
amaçlar	fins
kümeler	ensembles
dans	Danse
ahşap	bois
tanımlanmış	défini
kâğıtlar	papiers
ödülleri	prix
ücret	frais
stüdyo	studio
okuyucu	lecteur
cihaz	dispositif
kurulmuş	établi
cevaplar	réponses
kira	location
las	Las
karanlık	foncé
dış	externe
elma	Pomme
le	le
Talimatlar	instructions
min	min
sunulan	offert
teori	théorie
Kaldır	retirer
yardım	aide
görsel	visuel
evsahibi	hôte
Çeşitlilik	variété
öğretmenler	enseignants
Manuel	Manuel
blok	bloc
konular	sujets
ajanları	agents
onarım	réparation
adil	juste
çelik	acier
anlayış	compréhension
şarkılar	Chansons
sabit	fixé
yanlış	faux
başlangıç	début
eller	mains
az	az
Paris	Paris
alır	obtient
sektör	secteur
kapasite	capacité
un	ONU
şişman	graisse
baba	père
elektrik	électrique
testere	vu
enstrümanlar	instruments
subay	officier
sürücü	chauffeur
işletmeler	entreprises
ölü	mort
Bilinmeyen	inconnu
restoran	restaurant
mikrofon	Mike
gezi	voyage
mi	mi
fakir	pauvre
ilişki	relation
işçiler	ouvriers
Barış	paix
geleneksel	traditionnel
gösterme	projection
yaratıcı	Créatif
sahil	côte
yarar	avantage
finansman	financement
cihazlar	dispositifs
Kral	Seigneur
hibe	subvention
alt	sous
kurgu	fiction
saatler	montres
kariyer	carrières
gider	va
Led	LED
müze	musée
yelpaze	ventilateur
taşıma	transport
ilginç	intéressant
bloglar	blogs
değerlendirme	évaluation
eski	ancien
bölge	zone
karmaşık	complexe
inci	e
kedi	chat
ölmek	mourir
sunulan	présenté
düz	appartement
akış	couler
ajanslar	agences
Edebiyat	Littérature
ebeveyn	parent
ayar	réglage
dr	dr
ölçek	échelle
ekonomi	économie
faydalı	utile
aylık	mensuel
kritik	critique
çerçeve	Cadre
müzikal	musical
tanım	définition
Sekreter	secrétaire
yol	chemin
şef	chef
verir	donne
paketler	paquets
detay	détail
yasalar	lois
değişmiş	modifié
başla	commencer
royal	Royal
temiz	nettoyer
adam	gars
başlıkları	titres
uygun	pertinent
adalet	Justice
bağlamak	relier
Fincan	Coupe
sepet	panier
uygulamalı	appliqué
haftalık	hebdomadaire
cilt	vol
Kurulum	installation
s	pp
Dikkat	attention
ilerlemek	avance
atlamak	sauter
diyet	régime
ordu	armée
vites	équipement
fark	différence
izin	permis
doğru	correct
ulus	nation
satış	vente
çok	beaucoup
parça	pièce
tabaka	drap
firma	raffermir
Yedi	Sept
elementler	éléments
Türler	espèce
atlama	saut
hücreler	cellules
modül	module
çare	recours
sertifika	certificat
bakan	ministre
hareket	mouvement
moda	mode
talimatlar	directions
Ziyaretçi	visiteurs
belgeleme	Documentation
ticari	commerce
orman	forêt
aramalar	appels
kapsama	couverture
çift	couple
vererek	donnant
şans	chance
vizyon	vision
top	ballon
bitirme	fin
istemciler	clients
eylemler	actes
tartışmak	discuter
hedef	objectif
başarılı	réussi
satıldı	vendu
rüzgar	vent
topluluklar	communautés
klinik	clinique
durum	situation
piyasalar	marchés
yayıncılık	édition
görünmek	apparaître
gelişen	développement
hayatları	vies
belirlemek	déterminer
sıcaklık	Température
duyurular	annonces
hasta	patient
gerçek	réel
tarihi	historique
taş	pierre
şilin	bob
ticaret	Commerce
kişiler	personnes
zor	difficile
ilmi	scientifique
uydu	Satellite
testler	essais
köy	village
hesapları	comptes
amatör	amateur
eski	ex
met	rencontré
Ağrı	douleur
faktörler	facteurs
Kahve	café
alıcı	acheteur
afiş	affiche
kenar	bord
fonksiyonel	fonctionnel
kök	racine
fi	Fi
kapalı	fermé
Bayram	vacances
pembe	rose
denge	équilibre
izleme	surveillance
cevaplar	réponses
atış	coup
ilk	initiale
etiket	étiquette
sek	seconde
kanon	canon
lig	ligue
atık	déchets
dakika	minute
otobüs	autobus
sağlayan	fournisseur
sözlük	dictionnaire
muhasebe	comptabilité
imalat	fabrication
bölümler	sections
sandalye	chaise
çaba	effort
faz	phase
fantezi	fantaisie
po	po
va	Virginie
profesör	professeur
kurmak	installer
gömlek	chemise
giysi	vêtements
ayak	pied
meme	Sein
teknikleri	techniques
dolar	dollars
din	religion
izin	autorisation
vahşi	sauvage
nesil	génération
bayan	manquer
kimyasal	chimique
doktor	docteur
görev	tâche
azaltmak	réduire
getirdi	apporté
egzersiz	exercice
böcek	punaise
garanti	garantie
lider	chef
se	se
süreçler	processus
yumuşak	doux
toplantılar	réunions
saniye	secondes
uçuş	vol
kongre	congrès
yakıt	carburant
yürümek	marche
üretilmiş	produit
aziz	Saint
tartışma	argument
yarışma	compétition
ilaçlar	drogues
ortak	mixte
ödül	prime
taze	Frais
karakterler	personnages
avukat	avocat
di	di
faktör	facteur
binlerce	milliers
km	km
Akış	courant
daireler	appartements
almak	choisir
işitme	audition
doğu	est
terapi	thérapie
girdileri	entrées
imzalı	signé
idari	administratif
ciddi	sérieux
sınır	limite
adımlar	pas
dükkanlar	magasins
esaret	esclavage
del	del
çabaları	efforts
bilgili	informé
ga	Géorgie
düşünceler	pensées
dere	ruisseau
ft	ft
miktar	quantité
gerekli	essentiel
turlar	Tours
yük	charge
hemen	immédiatement
makineler	Machines
belirlenmiş	désigné
ağır	lourd
kapalı	couvert
kurtarma	récupération
entegre	intégré
yapılandırma	configuration
horoz	coq
tüccar	marchande
kapsamlı	complet
uzman	expert
korumak	protéger
katı	solide
sunum	présentation
oldu	devenu
Portakal	Orange
uyma	conformité
tema	thème
zengin	riches
kampanya	campagne
vs	contre
gitar	guitare
bulgu	découverte
örnekler	exemples
ruh	esprit
ar	ar
iddialar	réclamations
kabul	acceptation
stratejiler	stratégies
mo	mo
işler	affaires
istenilen	prévu
sa	sa
hedefleri	buts
kiralama	louer
seçim	élection
önermek	suggérer
şube	branche
servis	servir
bağlı	affiliés
dağ	monter
Latince	Latin
multimedya	multimédia
yönetmek	gérer
köşe	coin
rütbe	rang
eleman	élément
doğum	naissance
virüs	virus
interaktif	interactif
istekler	demandes
ayrı	séparé
çeyrek	trimestre
prosedür	procédure
liderlik	direction
tanımlamak	définir
dini	religieux
Gerçekler	faits
kahvaltı	déjeuner
kolon	colonne
inanç	Foi
Zincir	chaîne
belirlemek	identifier
cadde	rue
eksik	disparu
tavsiyeler	recommandations
taşındı	déplacé
ulaşmak	atteindre
karşılaştırma	Comparaison
an	moment
Genişletilmiş	élargi
sıra	séquence
inç	pouce
saldırı	attaque
merkezleri	centres
açılış	ouverture
laboratuvar	laboratoire
rezerv	réserve
gama	gamma
üretmek	produire
hakikat	vérité
sayaç	compteur
başarısızlık	échec
şu	suit
dolar	dollar
kamp	camp
des	des
filmler	films
köprü	pont
doldurmak	remplir
hareket	mouvement
baskı	impression
taslak	Brouillon
grafik	graphique
Oyunun	joué
kontaklar	Contacts
okuyucular	lecteurs
kulüpleri	clubs
WA	Washington
macera	aventure
teklif	offre
kâr	profit
liderler	dirigeants
afişler	affiches
kurumlar	institutions
asistan	assistant
değişken	variable
dj	dj
otopark	parking
dün	hier
belirlenen	déterminé
atölye	atelier
gitmiş	disparu
kodlar	codes
çeşit	types
uzantı	extension
ifadeleri	déclarations
tamamen	complètement
takımlar	équipes
kale	fort
santimetre	cm
senato	sénat
komik	drôle
gen	gène
dönük	tourné
disk	disque
Desen	modèle
tekne	bateau
tiyatro	théâtre
üreticileri	fabricants
sponsor	parrainer
klasik	classique
ikon	icône
garanti	garantie
adanmış	dévoué
yön	direction
Basketbol	basketball
nesneleri	objets
silmek	effacer
akşam	soir
montaj	Assemblée
nükleer	nucléaire
fare	Souris
işaret	signal
adli	criminel
Veriliş	Publié
güçlü	puissant
rüya	rêver
YANLIŞ	FAUX
da	da
oyuncular	jeter
çiçek	fleur
personel	personnel
geçti	passé
verilen	fourni
düşme	chutes
ruh	âme
desteklemek	promouvoir
belirtilen	déclaré
istatistikler	Statistiques
profesyoneller	professionnels
belirir	apparaît
Taşımak	porter
bayrak	drapeau
kapaklar	couvertures
em	em
avantaj	avantage
Merhaba	Bonjour
tasarımlar	dessins
sürdürmek	maintenir
turizm	tourisme
öncelik	priorité
yetişkinler	adultes
grafik	graphique
atom	atome
ödemeler	Paiements
bağlayıcı	contraignant
kısa	bref
Bitti	terminé
kazanan	gagnant
anonim	anonyme
senaryo	scénario
hizmet	servi
istiyor	veut
hazırlanmış	préparé
geçersiz	vide
etiket	marque
röportaj	entretien
karıştırmak	mélanger
iskelet	cadre
disk	disque
Kurulmuş	installée
kraliçe	reine
kredi	crédits
Açıkça	clairement
düzeltmek	réparer
sap	manipuler
tatlı	doux
kriterleri	Critères
ortak	associer
ne	ne
davranış	comportement
büyütmek	agrandir
ışın	rayon
gelir	revenu
ölçmek	mesure
oy	votes
du	du
görev	devoir
tartışmalar	discussions
ayı	ours
kazanç	Gain
Festival	Festival
laboratuvar	laboratoire
okyanus	océan
uçuşlar	vols
uzmanlar	experts
işaretler	signes
derinlik	profondeur
tren	train
kuru	sec
keşfetmek	explorer
spa	spa
kavram	concept
neredeyse	presque
kullanma	manipulation
Menşei	origine
milyar	milliard
zeka	intelligence
satın	acheté
aleyhte	escroquerie
milletler	nations
rota	route
kırık	cassé
savaş	bataille
konuşmak	parler
protokol	protocole
sorgu	question
ortaklık	Partenariat
ifade	expression
es	es
konuşma	discours
tel	câble
öneri	suggestions
değiştirme	remplacement
bant	ruban
stratejik	stratégique
hakim	juge
asit	acide
bayt	octets
sent	cent
zorunlu	forcé
uyumlu	compatible
apartman	appartement
boş	nul
sıfır	zéro
konuşmacı	orateur
Danışmanlık	consultant
tasarımcı	designer
pr	pr
evlilik	mariage
rulo	rouleau
bankalar	banques
fr	fr
katılımcılar	participants
gizli	secret
negatif	négatif
Favoriler	favoris
tiyatro	théâtre
yaylar	ressorts
var	var
yapmak	effectuer
çeviri	Traduction
tahminler	estimations
hasar	blessure
bakanlık	ministère
sürücüler	conducteurs
avukat	avocat
rakamlar	chiffres
korumalı	protégé
öneri	proposition
paylaşım	partage
kapı	portail
beta	bêta
bedava	gratuitement
karşı	vers
hafifçe	légèrement
yardım	aider
davranış	conduite
içeriyordu	contenu
mevzuat	législation
çağrı	appel
parametreler	paramètres
profiller	profils
hususlar	questions
evler	Maisons
kontroller	contrôles
kombine	combiné
nihai	ultime
temsilci	représentant
küçük	mineur
bölümler	départements
sakinleri	résidents
görüntülenen	affiché
anne	maman
indirimli	réduit
nadir	rare
gerçekleştirilen	réalisée
aşırı	extrême
örnekler	échantillons
Barlar	barres
tahmin	prévoir
çıkarıldı	supprimé
Çevrim	cycle
içermek	contenir
doğruluk	précision
uyku	dormir
mg	mg
kuş	oiseau
eczane	pharmacie
oluşturma	création
statik	statique
avcı	chasseur
adresler	adresses
bayan	Dame
kristal	cristal
ünlü	célèbre
yazar	écrivain
başkan	président
içki	boisson
akademi	académie
dinamik	dynamique
yemek	manger
kalıcı	permanent
temizlik	nettoyage
teşkil	constitue
portföy	portefeuille
pratik	pratique
teslim	livré
altyapı	Infrastructure
renk	Couleur
satıcı	vendeur
Felsefe	philosophie
düzenleme	règlement
görevlileri	officiers
amaç	objectif
teklifleri	offres
beslenme	nutrition
kayıt	enregistrement
genç	junior
les	les
pelerin	cap
halkalar	anneaux
bahşiş	pointe
olağanüstü	formidable
bilet	billet
açıkladı	annoncé
tahmin	deviner
kime	qui
Futbol	football
matematik	math
ithalat	importer
gönderme	affectation
varlık	présence
otomatik	automatique
görüntüleme	visualisation
muhafaza	entretenu
ch	ch
dan	dan
köpekler	chiens
yönetmenler	directeurs
yönleri	aspects
önde	devant
ay	lune
katılım	participation
düzen	schème
sinek	mouche
tavır	manière
matris	matrice
kombinasyon	combinaison
düzeltme	amendement
kuvvet	force
Türkiye	dinde
kütüphaneler	bibliothèques
uygun	correct
derece	degrés
işletmelerin	entreprises
delta	delta
korku	peur
arayan	recherche
inç	pouces
Kongre	convention
hisseleri	actions
asıl	principal
konfor	confort
renkler	couleurs
savaşlar	guerres
sipariş	commande
tuttu	conservé
alfa	alpha
temyiz	charme
seyir	croisière
bonus	prime
Hey	Hey
binalar	bâtiments
özel	promos
dövmek	battre
piller	batteries
olur	devient
sürücüler	disques
silâh	bras
Çay	thé
gelişmiş	amélioré
başarmak	atteindre
pozisyonları	positions
elbise	robe
abone	abonnement
satıcı	Marchand
çağdaş	contemporain
gökyüzü	ciel
ROM	ROM
taşınan	porté
poz	exposition
saklamak	cacher
imza	Signature
değirmenci	meunier
hüküm	disposition
çamaşırlar	vêtements
çerçeveler	cadres
kesinlikle	certainement
gazete	journal
oyuncak	jouet
tabaka	couche
basılı	imprimé
yavaş	lent
uzaklaştırma	suppression
yükümlülük	responsabilité
yazıcılar	imprimantes
ekleme	ajouter
yer	place
harcamak	dépenser
fabrika	usine
iç	intérieur
büyümek	croître
optik	optique
tanıtım	promotion
bağıl	relatif
şaşırtıcı	incroyable
nokta	point
Kimlik	identité
dönüştürme	conversion
duygu	sentiment
gizli	caché
makul	raisonnable
revizyon	révision
etki	influence
oran	rapport
önem	importance
yağmur	pluie
gezegen	planète
kopyalar	copies
izin	permis
görme	voyant
kanıt	preuve
bas	basse
reçete	ordonnance
boş	vide
örnek	exemple
delik	trou
binmek	balade
büro	bureau
koruma	préservation
çift	paire
ideal	idéal
gözlük	spécification
kaydedilmiş	enregistré
don	Don
parçalar	pièces
bitmiş	fini
parklar	parcs
avukatları	avocats
stres	stress
krem	crème
ss	ss
koşar	fonctionne
keşfetmek	découvrir
ap	ap
desenler	modèles
tepeler	collines
mil	nm
danışman	conseiller
farkında	conscient
şekil	forme
evrim	évolution
sertifikalar	certificats
hedefleri	objectifs
istasyonlar	stations
önerdi	suggéré
op	op
kalıntılar	restes
firmalar	entreprises
euro	euro
Şebeke	opérateur
yapıları	structures
genel	générique
ansiklopedi	encyclopédie
kullanım	usage
mürekkep	encre
karışık	mixte
sayım	recensement
tekerlek	roue
tedarikçileri	Fournisseurs
kompakt	compact
şiir	poésie
ışıklar	lumières
izleme	suivi
melek	ange
hazırlık	préparation
girişim	tentative
kabul	recevoir
maçlar	allumettes
uyum	conformité
Genişlik	largeur
motorlar	moteurs
unutmak	oublier
dizi	tableau
tartışılan	discuté
doğru	précis
iklim	climat
Yunan	grec
talimat	instruction
yönetme	gérant
çiğ	brut
farklar	différences
açıklamak	Explique
kurmak	établir
ifade	exprimé
derece	ampleur
keskin	tranchant
ben	ben
paragraf	paragraphe
öldürmek	tuer
matematik	mathématiques
tazminat	compensation
ihracat	exportation
yöneticileri	gestionnaires
modüller	modules
yürütülen	menée
versiyonları	versions
bilir	sait
tanımlamak	décrire
vatandaşlar	citoyens
miras	patrimoine
sorun	difficulté
Koç	entraîneur
tarım	agricole
genişletmek	développer
seyirci	public
atanmış	attribué
koleksiyonları	collections
yaşlar	âge
uzman	spécialiste
pişirmek	cuisinier
etkilemek	affecter
bakire	vierge
deneyimli	expérimenté
soruşturma	enquête
kalkık	relevé
şapka	chapeau
kurum	institution
yönlendirilmiş	dirigée
etkilenmiş	affecté
bisiklet	bicyclette
bütünüyle	totalement
plaka	assiette
giderler	frais
belirtmek	indiquer
sarışın	blond
kovuşturma	procédure
favori	préféré
karakteristikleri	caractéristiques
der	der
kaybetmek	perdre
organik	biologique
aramak	chercher
deneyimler	expériences
albüm	albums
sözleşmeler	contrats
misafir	invités
barındırılan	hébergé
hastalıklar	maladies
ilişkin	concernant
eşdeğer	équivalent
kimya	chimie
kitleri	kits
mantık	logique
prens	prince
daire	cercle
toprak	sol
Psikoloji	psychologie
ıslak	humide
koşullar	conditions
yatırımcı	investisseur
temel	élémentaire
sponsorlar	sponsors
tilki	Renard
sınırsız	illimité
yanıtlamak	répondre
boyutları	tailles
sade	plaine
çıkış	Sortie
kol	bras
anahtarlar	clés
dalga	vague
kutsal	saint
eylemler	actes
rehberlik	orientation
iz	Piste
sembol	symbole
karayolu	Autoroute
gözlenen	observé
dekan	doyen
kurmak	installer
anket	sondage
stilleri	modes
dolu	rempli
bağ	liaison
kanallar	filières
apandis	annexe
çikolata	Chocolat
kısım	portion
kapsam	portée
satıcı	fournisseur
kablolar	câbles
pamuk	coton
gereklilik	exigence
öldürdü	tué
sınır	frontière
eski	ancien
tartışma	débat
temsilcileri	représentants
başlar	départs
gebelik	grossesse
konumlar	attractions
bilgili	appris
işlemler	transactions
kâşif	explorateur
tarihi	historique
koca	mari
yetkili	autorisé
çılgın	fou
yaklaşan	prochain
konser	concert
Skorlar	scores
verim	Efficacité
komedi	comédie
benimsenen	adopté
verimli	efficace
doğrusal	linéaire
taahhüt	engagement
uzmanlık	spécialité
ayılar	ours
atlama	saut
taşıyıcı	transporteur
sabit	constant
Visa	visa
ağız	bouche
metre	mètre
bağlantılı	lié
görüşmeler	interviews
kavramlar	concepts
tabanca	pistolet
yansıtmak	réfléchir
saf	pur
cehennem	enfer
meyve	fruit
başlar	commence
nitelikli	qualifié
reform	réforme
lens	lentille
işlenmiş	traités
keşif	Découverte
çekmek	dessiner
sınıflandırılmış	classifié
üstlenmek	assumer
ittifak	Alliance
onaylamak	confirmer
mühendis	ingénieur
tutarlı	cohérent
değiştirmek	remplacer
Boşluk	dégagement
dönüştürücü	convertisseur
organizasyon	organisation
bebek	bébé
çekler	chèques
ulaştı	atteint
olma	devenir
amaç	objectif
belirtilen	indiqué
şeker	sucre
mürettebat	équipage
bacaklar	jambes
Çubuk	bâton
ilişki	relation
etkin	activée
Tür	genre
gönüllü	bénévole
arka	arrière
demokratik	démocratique
artırmak	améliorer
kesin	exact
ciltli	lié
parametre	paramètre
işlemci	processeur
düğüm	nœud
biçimsel	formel
fırtına	orage
mikro	micro
kolejler	collèges
mil	mile
zorluklar	défis
editörler	éditeurs
yüce	suprême
Kardeşler	frères
tanıma	reconnaissance
ref	ref
tahmin	estimation
çocuk	enfant
teftiş	inspection
tüketicilerin	consommateurs
sınırları	limites
bölge	territoire
silahlar	armes
gecikme	retard
pilot	pilote
katkıları	contributions
sürekli	continu
girişim	initiative
yeni	roman
icra	exécution
sakatlık	invalidité
ultra	ultra
kazanan	gagnant
bölüm	épisode
çömlekçi	potier
tabak	plat
oyunlar	pièces
bülten	bulletin
ia	ia
değiştirmek	modifier
gerçekten	vraiment
Evren	univers
aday	candidat
yarık	fente
ödenmemiş	exceptionnel
Ha	Ha
planlı	prévu
loca	loge
ayna	miroir
turnuva	tournoi
düşünce	considération
oturumları	sessions
çekirdek	noyau
alıcılar	acheteurs
dergi	revues
gri	gris
katalog	catalogue
yüklü	accusé
geniş	vaste
und	und
seçilmiş	choisi
gösteri	demo
nefret	haine
terminal	Terminal
yayıncılar	éditeurs
gece	nuits
sıvı	liquide
pirinç	riz
rezervasyon	réservation
gıdalar	nourriture
bekçi	garde
tasarruf	économie
imparatorluk	Empire
yeni	nouvellement
yükseltmek	élever
yasadışı	illégal
genişleme	expansion
başbakan	premier
yarın	demain
Süt	Lait
dram	drame
ziyaret	visite
yarışma	concours
toplanmış	collectées
bantları	bandes
uygun	adapté
kesinlikle	absolument
denetim	vérification
bölme	chambre
Gine	Guinée
bulgular	résultats
iso	iso
tipik	typique
toplam	somme
tavuk	poulet
geçici	temporaire
katılmak	assister
duş	douche
gönderme	envoi
yeterli	suffisant
kabuk	coquille
il	Province
liberal	catholique
Vali	gouverneur
bira	Bière
katkı	contribution
formül	formule
anayasa	Constitution
paketleme	emballage
dürüst	fiable
şüphe	doute
kazanmak	gagner
dönemleri	périodes
saldırılar	attaques
mal	marchandise
semptomlar	symptômes
anıt	Mémorial
ikiz	double
eklemek	insérer
geçit	passerelle
çizim	dessin
adaylar	candidats
düzenli	commandé
biyolojik	biologique
kavga	combat
geçiş	transition
tercihleri	préférences
casus	espion
romantik	romance
enstrüman	instrument
Bölünmüş	Divisé
temalar	thèmes
güçler	pouvoirs
cennet	paradis
bit	morceaux
hamile	Enceinte
sınıflandırma	classification
odaklı	concentré
doktor	médecin
sormak	demander
bloklar	blocs
bak	lo
manevi	spirituel
diyabet	Diabète
mi	ml
vardiya	décalage
oturmak	asseoir
bedenler	corps
fotoğraflar	photographies
kesim	Coupe
yazarlar	écrivains
esnek	flexible
sevilen	aimé
Favoriler	favoris
haritalama	cartographie
sayısız	nombreux
Nispeten	relativement
temsil	représente
üstün	supérieur
tercihli	préféré
kaydedilmiş	enregistré
entellektüel	intellectuel
verilmiş	accordé
karbon	carbone
rahat	confortable
manyetik	magnétique
etkileşim	interaction
dinleme	écoute
kriz	crise
görünüm	perspective
masif	massif
parlak	brillant
oluşturulan	formé
piyano	piano
Eko	écho
devrim	révolution
görüntüler	affiche
plazma	plasma
kazanç	gains
gizem	mystère
peyzaj	paysage
mekanik	mécanique
seyahat	périple
afiş	bannière
incir	figue
ilçeler	comtés
edinme	acquisition
tanınan	reconnu
rüyalar	rêves
bildirim	notification
kilogram	kg
öğretmek	apprendre
hızlı	rapide
Çek	tirer
ut	Utah
seminer	séminaire
yatırımlar	investissements
tekerlekler	roues
belirtmek	spécifier
hassas	sensible
şablonları	modèles
formatları	formats
tutar	détient
yönlendirici	routeur
beton	béton
si	si
Klasör	dossier
tamamlama	achèvement
nabız	impulsion
teknik	technique
oylama	vote
mahkemeler	tribunaux
dönüştürülmüş	converti
metro	métro
yıldönümü	anniversaire
iyileştirmeler	améliorations
şerit	bande
Şartname	spécification
kaza	accident
Nick	entaille
ulaşılabilir	accessible
oturan	résident
arsa	terrain
tipik	typiquement
temsil	représentation
pompa	pompe
var	existe
düzenlemeler	arrangements
konferanslar	conférences
tüketim	consommation
dar	étroit
tehdit	menace
anketler	enquêtes
oturma	séance
danışman	consultant
kontrolör	manette
komiteler	comités
penis	pénis
kale	Château
bahçeleri	jardins
etiketler	Étiquettes
istekli	prêt
biyo	bio
oyunculuk	agissant
kafaları	têtes
sınav	examen
Konut	résidence
yoğunluk	densité
yüz	cent
garip	étrange
sürdürülebilir	durable
istatistiksel	statistique
Anma	mention
yenilik	innovation
gri	gris
paralel	parallèle
işletmek	fonctionner
fatura	factures
kararlı	stable
tanımlar	définitions
von	von
doktorlar	médecins
ders	leçon
sinema	cinéma
seçimler	élections
reaksiyon	réaction
boş	blanc
gelişmiş	renforcée
adlı	intitulé
şiddetli	sévère
üretmek	produire
gazeteler	journaux
hastaneler	hôpitaux
vi	vi
Mizah	humour
yaşlı	vieilli
monitör	moniteurs
istisna	exception
süre	durée
kütle	masse
ziyaret	visites
yetenekleri	capacités
tavsiye	recommandation
günah	péché
örgütlü	organisé
ba	ba
paragraf	para
Benimseme	adoption
geliştirme	améliorer
pahalı	coûteux
bizon	buffle
organizasyonlar	organisations
uçak	avion
programlar	programmes
mekanizma	mécanisme
ee	ee
işaretlenmiş	marqué
tahrik	poussé
şişe	bouteille
yenilikçi	innovant
masaj	massage
Sonuç	conclusion
kapanış	fermeture
bin	mille
efsane	Légende
villa	villa
kemik	OS
sütunlar	colonnes
bozukluklar	troubles
işbirliği	collaboration
bulma	détection
iç	interne
formasyon	formation
med	med
mühendisler	ingénieurs
varlık	entité
yolculukları	Croisières
kapı	porte
Roma	romain
görevleri	fonctions
erotik	érotique
ton	Ton
ahlâk	éthique
Ejderha	dragon
meşgul	occupé
Kaptan	capitaine
getiriyor	apporte
ısıtma	chauffage
bacak	jambe
boyun	cou
kanat	aile
senaryo	scripts
ABC	abc
döşenmiş	nommé
muamele	transaction
işlemek	commettre
Demiryolu	rail
gezileri	voyages
boşluk	écart
taraf	côtés
tüp	tube
uyan	correspondant
açıklamaları	descriptions
kemer	ceinture
ceket	veste
animasyon	animation
torpil	oracle
er	er
yapımları	productions
havacılık	aviation
gururlu	fier
afet	catastrophe
konsol	console
komutlar	commandes
jr	jr
telekomünikasyon	télécommunications
eğitmen	instructeur
dev	géant
elde	réalisé
yaralanmalar	blessures
yaklaşımlar	approches
olağan	habituel
pullar	timbres
açı	angle
soymak	Rob
tasarımcılar	concepteurs
özgürlük	liberté
çağ	ère
dönüştürmek	convertir
olasılık	possibilité
analist	analyste
tehlikeli	dangereux
güvenilirlik	fiabilité
sırasıyla	respectivement
gönüllüler	bénévoles
türetilmiş	dérivé
Zevk	plaisir
Onur	honneur
yönlü	orienté
kartal	Aigle
namaz	prière
atölyeler	ateliers
kasırga	ouragan
sessiz	silencieux
yapımcı	producteur
temsil	représentée
sorumluluklar	responsabilités
peynir	fromage
dikkatlice	soigneusement
verimlilik	productivité
taç	couronne
eşitlik	par
Teşhis	diagnostic
yapıcı	fabricant
çatlak	fissure
prensip	principe
seçtikleri	choix
çete	gang
fetiş	fétiche
görünüm	apparence
duman	fumée
filtreler	filtres
Anonim	incorporé
zanaat	artisanat
adam	compagnon
kör	aveugle
salon	salon
deli	furieux
algoritma	algorithme
şiddetle	fortement
kafe	café
ken	ken
proteinler	protéines
su	su
tanıdık	familier
yetenekli	capable
kabul	admission
ayakkabı	chaussure
seçildi	élu
taşıma	portant
terörizm	terrorisme
sevinç	joie
sürümleri	éditions
etnik	ethnique
parlamento	parlement
aktör	acteur
buluntular	découvertes
mühür	joint
durumlar	situations
beşinci	cinquième
vatandaş	citoyen
dikey	verticale
düzeltmeler	corrections
açıklar	décrit
engelli	handicapées
madde	substance
yasak	interdit
boru	tuyau
askerler	soldats
Gardiyan	Gardien
ders	conférence
simülasyon	simulation
düzen	disposition
girişimler	initiatives
hasta	mauvais
konsantrasyon	concentration
yatırmak	allonger
yorumlama	interprétation
kirli	sale
öğretilen	enseigné
işçi	ouvrier
optimizasyon	optimisation
tapınak	temple
maddeler	substances
kanıtlamak	prouver
keşfedilen	découvert
kanatlar	ailes
genetik	génétique
kısıtlamalar	restrictions
ince	mince
sergi	exposition
sırt	crête
modem	modem
getiren	apportant
hasta	malade
değerlendirmek	évaluer
tropikal	tropical
toplamak	collecte
vektör	vecteur
kesinlikle	absolument
döndürme	tournant
varoluş	existence
yorum	commentaire
gelişmeler	développements
göç	immigration
yerler	destinations
karşılıklı	mutuel
sözdizimi	syntaxe
li	li
nitelik	attribut
hapis	prison
beceri	compétence
sandalye	chaises
çevreleyen	alentours
dağlar	montagnes
popülerlik	popularité
soruşturma	enquête
kontrol	vérifié
sergi	exposition
atmak	jeter
akım	tendance
kediler	chats
çöl	désert
ya	ya
koordinatör	coordinateur
Merkür	Mercure
yanan	brûlant
kaçış	échapper
alıcı	destinataire
ilerici	progressive
tekneler	bateaux
şampiyonluk	championnat
çarşı	arcade
imkansız	impossible
anlatır	dit
açık	évident
depresyon	dépression
grafik	graphique
kaplama	couvrant
platin	platine
yargı	jugement
görüşmeler	pourparlers
dosyalama	dépôt
beslemek	favoriser
layık	décerné
denemeler	essais
ustaları	maîtrise
kartuş	cartouche
açıklama	explication
org	org
dolandırıcılık	fraude
elektrik	électricité
spektrum	spectre
varış	arrivée
çömlekçilik	poterie
vurgu	accentuation
müthiş	impressionnant
onaylı	confirmé
sayımları	compte
kaza	crash
asansör	ascenseur
arası	entre
yükseklikleri	hauteurs
gölge	ombre
gider	frais
girişim	entreprise
klinik	clinique
şifa	guérison
prenses	Princesse
girme	entrer
paket	paquet
stüdyoları	studios
ilgi	participation
baba	papa
düğmeleri	boutons
yerleştirme	placement
gözlemler	observations
kazananlar	gagnants
yollar	routes
sonraki	subséquent
avlu	Cour
ifşa	divulgation
kuruluş	établissement
hatıralar	souvenirs
te	te
yaratır	crée
yüzleri	visages
turist	touristique
cinayet	meurtre
yeterli	adéquat
senatör	sénateur
sunumlar	présentations
özet	digérer
toz	poussière
wiki	wiki
değiştirilir	remplacé
radar	radar
kayıplar	pertes
savaş	combat
indirgen	réduire
durduruldu	arrêté
Meslek	Occupation
yakından	étroitement
radyasyon	radiation
krallar	rois
çekim	tournage
kulak	oreille
bayraklar	drapeaux
fırıncı	boulanger
muhafazakâr	conservateur
şok	choc
etki	efficacité
kravat	attacher
çatı	toit
göstermek	démontrer
atmosfer	atmosphère
öpücük	baiser
canavar	bête
ra	ra
ameliyat	exploité
deney	expérience
hedefler	cibles
alımları	achats
federasyon	fédération
Pizza	Pizza
davet	invité
atama	affectation
şık	mod
sorguları	requêtes
yokluk	absence
satıcıları	vendeurs
yoga	yoga
vermektedir	sert
sürpriz	surprise
Lamba	lampe
espriler	blagues
danışmanlık	conseils
Saray	palais
memnun	satisfait
kazanç	victoires
depo	entrepôt
sözde	supposé
sıradan	ordinaire
hayalet	fantôme
ihlal	violation
patron	patron
gurur	fierté
beklentiler	attentes
bağımsızlık	indépendance
bilme	connaissance
muhabir	journaliste
metabolizma	métabolisme
şampiyon	champion
Şahsen	personnellement
bol	beaucoup
solo	solo
boğaz	gorge
servet	richesse
vakum	vide
dans	dansant
tanımak	reconnaître
yazıyor	écrit
plaza	place
araştırma	quête
Yayınla	publier
tarama	dépistage
trans	trans
öncü	pionnier
unutulmuş	oublié
akrobat	acrobate
plakalar	plaques
denemeler	essais
davranış	comportement
söylüyorum	récit
oldukça	équitablement
akıllı	intelligent
modları	modes
yükümlülük	obligation
liman	port
gezgin	voyageur
bölüm	segment
düşman	ennemi
bulmaca	puzzle
kuyular	puits
kısıtlı	limité
cumhuriyetçi	républicain
sırlar	secrets
sendrom	syndrome
katılım	présence
ceza	peine
davul	tambour
sağlayan	permet
kurucu	constructeur
manzara	vue
sel	inonder
kolaylaştırmak	facilité
argümanlar	arguments
arena	arène
maceralar	aventures
öğrenciler	élèves
duyuru	annonce
sonuç	résultat
anlamak	apprécier
genişletilmiş	étendu
yetişkin	mûr
güzel	charmant
merkezleri	centres
fıkra	clause
gülümseme	sourire
topraklar	terres
asker	troupes
silâhlı	armé
çam	pin
soğutma	refroidissement
körfez	golfe
kamyonlar	camions
mekanizmalar	mécanismes
boşanma	divorce
gelenek	tradition
haplar	pilules
kaplan	tigre
arkadaşlar	gens
algılayıcı	capteur
maruz	exposé
av	chasse
melekler	anges
milletvekili	adjoint
Tayland	thaïlandais
emisyonları	émissions
hekimler	médecins
şikâyet	plainte
sahneler	scènes
deneyler	expériences
artırmak	renforcer
Yönetim	gouvernance
değirmen	moulin
kurulmuş	fondé
kronik	chronique
den	tanière
parmak	doigt
tutar	garde
pound	livre
yerleştirmek	Localiser
pl	PL
eğitilmiş	qualifié
uygulanması	exécution
ekmek	pain
motorlar	moteurs
sert	dure
olay	incident
dinamik	dynamique
Yalan	mensonge
konuşma	conversation
azaltmak	diminution
ibadet	culte
kabiliyet	aptitude
ak	Alaska
hassas	précision
tazminat	dégâts
rezervler	réserves
çözmek	résoudre
azınlık	minorité
çeşitli	diverse
malzemeler	Ingrédients
Ah	ah
sesleri	tons
rehabilitasyon	réhabilitation
görme	vue
kil	argile
zayıf	faible
bölünmüş	divisé
resepsiyon	accueil
bilge	sage
olasılık	chances
seminer	séminaires
sonuçları	conséquences
vericiler	décideurs
coğrafya	géographie
bütünlük	intégrité
miras	héritage
memnun	heureux
Tehlike	danger
vitamin	vitamine
işlenmiş	traité
ifade	phrase
yükselen	élevage
etkileri	implications
işlevselliği	fonctionnalité
cennet	paradis
melez	hybride
okur	lit
duygusal	émotif
şan	gloire
ja	ja
coğrafi	géographique
aşmak	dépasser
çubuk	barre
ipek	soie
bebekler	bébés
bi	bi
romantik	romantique
ortaya	révélé
uzmanlar	spécialistes
jeneratör	Générateur
süspansiyon	suspension
üzgün	triste
düzeltme	correction
Kurt	Loup
yavaşça	lentement
ek	supplément
bölümleri	portions
bebek	bébé
sektörler	secteurs
akışkan	fluide
zeminler	terrains
yemek	repas
ta	ta
makinalar	machinerie
denklem	équation
sepetler	paniers
olasılık	probabilité
boyut	dimension
okudu	étudié
kar	bénéfices
şeytan	diable
çimen	herbe
resimli	illustré
Kiraz	Cerise
kıta	continental
başarı	réussite
sınırlamaları	limites
cenaze	funérailles
bölümler	chapitres
yolcu	passager
uygun	pratique
Mars	Mars
boy	taille
Yumurta	Oeuf
sinyalleri	signaux
oryantasyon	orientation
Çalınması	vol
çocukluk	enfance
semboller	symboles
lat	lat
meta	méta
analog	analogique
yetenek	Talent
tarihli	daté
bilgelik	sagesse
sınır	frontière
seçkinler	élite
gi	gi
inanır	croit
şiirler	poèmes
yargı	juridiction
robot	robot
sergileyen	visualisation
tanık	témoin
donanımlı	équipé
aşamaları	étapes
sur	sur
Edinilen	acquis
belirlemek	évaluer
yıkama	lavage
Giriş	entrée
deklarasyon	déclaration
kaybetme	perdant
denemeler	tentatives
asil	noble
otomasyon	automatisation
etkiler	impacts
devir	tour
avantajları	avantages
şövalye	Chevalier
Amaçları	objectifs
uzantılar	extensions
itirazlar	appels
hastalık	maladie
ho	ho
alternatifleri	alternatives
sh	sh
sabun	savon
reçel	confiture
olağandışı	inhabituel
cevap	répondu
imha	destruction
göç	migration
düzensizlik	désordre
Konvansiyonel	conventionnel
giyme	portant
eksen	axe
aranan	recherché
genler	gènes
medyan	médian
tarayıcı	scanner
burada	ici
canlandırılmış	Animé
ayarlama	ajustement
kahraman	héros
tedaviler	traitements
tutum	attitude
halı	tapis
lensler	lentilles
katıldı	assisté
zorluk	difficulté
punk	punk
koalisyon	coalition
kayıt	inscription
dük	Duc
hız	rythme
üreticileri	producteurs
yay	arc
arayüzleri	interfaces
Atlas	atlas
gözlem	observation
işkence	torture
silindi	supprimé
ceket	manteau
restorasyon	restauration
Kolaylık	commodité
dönen	retour
muhalefet	opposition
konteyner	récipient
sanık	défendeur
gözetmen	superviseur
kolordu	corps
aktörler	acteurs
karaciğer	foie
sorumlu	assujetti
dilekçe	pétition
anten	antenne
seçilmiş	choisi
inanç	croyance
öldürme	meurtre
omuz	épaule
dekor	décor
iyon	ion
çap	diamètre
podcast	Podcast
etkileşimler	interactions
şarkıcı	chanteur
haberci	héraut
yaşlanma	vieillissement
müdahale	intervention
Eklenti	brancher
cazibe	attraction
dalış	plongée
değişiklik	modification
varsaymak	supposer
kamış	roseau
dahil	impliquer
ılımlı	modérer
fareler	souris
anladım	compris
hızla	rapidement
yasak	interdire
güvence	assurance
olay	événement
Muazzam	vaste
üreticiler	moulins
taslak	contour
aldığı	reçoit
kot	jeans
derleme	compilation
garip	impair
sigma	Sigma
gr	gr
çekici	attrayant
fırsat	occasion
kayıtları	enregistrements
kurban	victime
talepler	demandes
dikkatli	prudent
kiriş	faisceau
Bahçıvanlık	jardinage
yükümlülükleri	obligations
varmak	arrivée
orkestra	orchestre
lisans	Licence
ayarlanabilir	Ajustable
tahsis	allocation
deneme	essai
gösterdi	démontré
diyalog	dialogue
kampları	camps
beyan	déclaré
iz	trace
kapamak	fermer
paketleri	paquets
ge	ge
yükleme	pose
anahtarlar	interrupteurs
gönüllü	volontaire
sen	tu
çokça	très
ng	ng
çoğunlukla	communément
pe	pe
fotoğrafçı	photographe
Ağla	cri
kuantum	quantum
inşa	construit
ilave	additions
gerektiren	exigeant
ok	flèche
nişan	engagement
kaba	rugueux
tuhaf	bizarre
aslan	Lion
düğün	mariages
oksijen	oxygène
kanyon	canyon
metre	mètres
sadece	seulement
takvimler	calendriers
aranjman	arrangement
sonuçlar	conclusions
kaynakça	bibliographie
Işaretçi	aiguille
uygunluk	compatibilité
Uzatmak	étendue
izinler	permis
kooperatif	coopérative
besleme	alimentation
nahiye	canton
sıralamaları	classements
ölçme	mesure
kayış	sangle
kalabalık	foule
transferler	transferts
Olimpiyat	olympique
dönüşüm	transformation
dir	dir
Gümrük	douane
yöneticiler	administrateurs
kişilik	personnalité
kanca	crochet
rulet	roulette
düşüş	déclin
kordon	corde
bulut	nuage
kolaylaştırmak	faciliter
val	val
açıklıyor	explique
ilerlemek	procéder
duygular	sentiments
bıçak	couteau
benimsemek	adopter
inkar	dénié
bağış	don
dış	extérieur
ekin	surgir
nehirler	rivières
düğümleri	nœuds
anılan	cité
merkez	centre
Hedeflenen	ciblée
gerçekleştirilen	réalisé
kurucu	fondateur
onyıl	décennie
ihtilaf	contestation
yorgun	fatigué
ters	négatif
alıntı	extrait
deşarj	décharge
içecekler	boissons
as	as
sesleri	voix
Tırmanmak	escalade
ton	tonnes
parfüm	parfum
tehlikeli	dangereux
geri	restaurer
yığın	empiler
metodoloji	méthodologie
itibar	réputation
demokratlar	démocrates
asmak	pendre
eğri	courbe
yaratıcı	créateur
kehribar	ambre
müzeler	musées
kodlama	codage
takipçi	traqueur
varyasyon	variation
geçit	passage
transfer	transféré
gövde	tronc
fotoğraf	photographier
dalgalar	vagues
deve	chameau
distribütör	distributeur
ki	chi
toplama	rassemblement
projeksiyon	projection
matematiksel	mathématique
mantıksal	logique
Sos	sauce
şöhret	célébrité
uzman	spécialisé
şirketler	sociétés
eleştiri	critique
otomobil	voiture
yargıçlar	juges
Uyarılar	remarques
algılandı	détecté
resimlerinde	peintures
yürüdü	marché
yükselme	découlant
popülasyonları	populations
korkmuş	peur
akustik	acoustique
kaset	cassette
gösterge	indicateur
jpg	jpg
hata	erreur
elemek	éliminer
mineral	minéral
yakut	rubis
boncuklar	perles
servet	fortune
tuval	Toile
eşik	seuil
kilise	paroisse
ekranlar	écrans
mezarlık	cimetière
stadyum	stade
keşif	exploration
dk	minutes
kök	tige
astronomi	astronomie
yarışmalar	concours
grip	grippe
kostüm	costume
bisiklet	vélos
piskopos	évêque
çekti	tiré
Mısır	blé
sıkıştırma	compression
kuran	établissement
çiftçi	agriculteur
teneke	étain
köle	esclave
anında	immédiatement
antrenörlük	encadrement
incelenen	examiné
kodlama	codage
gönderimler	soumissions
kahramanlar	héros
boyalı	peint
portre	portrait
terörist	terroriste
ahlâki	éthique
taşıyıcılar	transporteurs
hareketlilik	mobilité
mücadele	lutte
şemaları	régimes
çile	Souffrance
nötr	neutre
balıkçı	pêcheur
sıçan	rat
mızraklar	lances
birleştirme	joindre
başlık	titre
yapay	artificiel
yatak	palier
muhteşem	spectaculaire
dünyalar	mondes
suçlu	coupable
etkinleştirme	Activation
sığınak	havre
tablet	tablette
jüri	jury
dos	dos
kuyruk	queue
çekicilik	charme
şiddetli	violent
potansiyel	potentiellement
çiftlik	ranch
kısıtlamaları	contraintes
geçit	traversée
dahil	compris
kulübe	chalet
sarhoş	ivre
önemli	considérable
suçları	crimes
kararlı	résolu
bayt	octet
burun	nez
dalları	branches
yabancı	extraterrestre
işlemciler	processeurs
kırdı	cassé
karmaşa	complexité
sürekli	constamment
çözmek	résoudre
bölgeler	territoires
tez	thèse
diskler	disques
sık	fréquent
tavan	plafond
piksel	pixels
gen	gen
elmaslar	diamants
filo	flotte
Demet	bouquet
teorik	théorique
Referans	référence
çıkmak	quitter
protokolleri	protocoles
akciğer	poumon
vekil	remplacer
parlak	brillant
ti	ti
jel	gel
konuşulmuş	parlé
omega	oméga
değerlendirilir	évalué
kaldı	séjourné
görür	voit
sonlandırma	Résiliation
izledi	regardé
hane	ménages
kurtarmak	racheter
tahıl	grain
rejim	régime
Boğa	taureau
mimari	architectural
farklılık	différer
hareketler	mouvements
tamirat	réparations
nefes	souffle
kolaylıklar	équipements
fiilen	virtuellement
çarşı	marché
mum	bougie
asılı	pendaison
renkli	coloré
masal	conte
eskiden	anciennement
projektör	projecteur
bulunan	situé
istiyor	cherche
kesinlikle	strictement
psikolojik	psychologique
vitaminler	vitamines
zarif	élégant
kazançlar	gains
yenileme	renouvellement
şecere	généalogie
sayılır	réputée
puanlama	points
harcama	dépense
eleştirmenler	critiques
algoritmalar	algorithmes
Hacker	pirate
salon	salon
turbo	turbo
Çare	guérir
ni	ni
düşünüyor	pense
öneri	suggestion
asker	soldat
bomba	bombe
zarar	nuire
Aralık	intervalle
aynalar	miroirs
incelemek	enquêter
senin	tes
paneller	panneaux
tekrarlanan	répété
saldırı	agression
geyik	cerf
dil	langue
bowling	bowling
tri	tri
maymun	singe
oran	proportion
etek	jupe
analizleri	analyses
çizimler	dessins
önem	importance
senaryo	scénario
siz	vous
Arapça	arabe
ölçü	jauge
koruyucu	protéger
yüzlü	face
çözme	résolution
üretir	produit
yoğun	intensif
zincirler	Chaînes
altıncı	sixième
tutmak	engager
anahtarlama	commutation
yazışma	correspondance
ithalat	importations
nezaret	surveillance
harcamalar	dépenses
ayırma	séparation
tanıklık	témoignage
şüpheli	suspect
zorunlu	obligatoire
sınırları	limites
kutlama	fête
süzme	filtration
eş	époux
egzotik	exotique
izleyici	téléspectateur
ulaşan	atteindre
gülmek	rire
cerrahi	chirurgical
yıkmak	détruire
alıntı	citation
yo	yo
tesislerinde	locaux
kanıtlanmış	prouvé
saldırgan	offensive
imparatorluk	impérial
düzine	douzaine
yayılma	déploiement
bez	tissu
lotus	lotus
Somon	Saumon
kargo	cargaison
direktif	directif
Dostum	camarade
Tereyağı	beurre
biber	poivre
silah	arme
yük	charge
bantlar	bandes
bölgeler	zones
ada	île
ince	svelte
akçaağaç	érable
Bakkal	épicerie
yöneten	gouvernant
depo	dépôt
alt	alt
turta	tarte
harman	mélange
emisyon	émission
bariz	apparent
eğitici	éducatif
izinler	autorisations
tuvalet	toilette
sıralanmış	classé
rotalar	routes
montaj	montage
bağlı	lié
dengeli	équilibré
gecikmiş	différé
vadi	vallée
hesaplama	calcul
villalar	villas
durumlar	occasions
denklemler	équations
yağlar	huiles
Eylül	septembre
olağanüstü	exceptionnel
kaygı	anxiété
uzaysal	spatial
katılımcıların	répondants
hususlar	considérations
öder	paie
güneşli	ensoleillé
teslim	livre
je	je
kolye	Collier
karma	composite
lang	lang
tiyatro	théâtres
tasarım	conception
umutlar	espoirs
değerlendirmeler	évaluations
diyagram	diagramme
ayakkabı	chaussure
sG	sg
halklar	peuples
galip	Victor
lisansları	licences
aralıklar	gammes
çiftleri	paires
duyarlılık	sensibilité
koruma	préservation
yalıtılmış	isolé
geçici	intérimaire
yardımlı	assisté
ilahi	Divin
onaylamak	approuver
bileşik	composé
yoğunluk	intensité
teknolojik	technologique
kürtaj	Avortement
diyalog	dialogue
mekânları	lieux
üfleme	explosion
adresleme	adressage
kutup	pôle
kalkan	bouclier
zar	membrane
umutsuz	désespéré
anneler	mères
gösteri	manifestation
hükümet	gouvernemental
üretilmiş	fabriqué
mumlar	bougies
varyasyonlar	variations
anneler	mamans
kutsal	sacré
bağımlılık	dépendance
krom	chrome
reddetti	refusé
fren	frein
dış	extérieur
selamlama	salutation
ekoloji	écologie
vadi	glen
işsizlik	chômage
attı	marqué
artırma	renforcement
klon	cloner
hız	rapidité
lambda	lambda
oluşan	composé
gözyaşı	larmes
vaha	oasis
taksi	taxi
fa	FA
toplumlar	sociétés
silikon	silicium
özdeş	identique
petrol	pétrole
yarışmak	rivaliser
ist	ist
sevgili	amoureux
ait	appartenir
dudaklar	lèvres
eskort	escorte
gölet	étang
feribot	traversier
tavşan	lapin
meslek	métier
baraj	barrage
fizyoloji	physiologie
ihracat	exportations
lastik	pneu
katılımcı	participant
elektron	électron
yükler	charges
funda	bruyère
motel	motel
sendikalar	syndicats
hazine	Trésorerie
meşgul	occupé
terazi	Balance
Gerginlik	souche
tutuklandı	arrêté
araştırmalar	enquêtes
kazanmış	gagné
çamaşır	blanchisserie
yerleştirme	placement
ayarlamak	régler
değerlendirilen	évalués
şifreleme	chiffrement
dolgu	remplissage
uygulanan	imposé
Sessizlik	silence
Sovyet	soviétique
mülk	possession
antlaşma	traité
eğitimci	entraîneur
organ	organe
Limon	citron
karanlık	obscurité
karış	envergure
şaka	blague
paketleme	emballage
tüzük	loi
reddedilen	rejeté
barınak	abri
tapınak	chapelle
üretim	fabrication
katmanlar	couches
kutlamak	célébrer
cihaz	appareil
karışım	mélange
binici	cavalier
yarıçap	rayon
etkileyici	impressionnant
koyun	mouton
mimar	architecte
dersler	conférences
şaraplar	vins
bardaklar	tasses
kül	cendre
katkıda	contributeurs
salata	salade
ihlalleri	violations
sıcaklıklar	températures
yarışmalar	compétitions
korumak	préserver
şiir	poème
kalma	rester
Paskalya	Pâques
teoriler	théories
depo	dépôt
akışları	ruisseaux
iniş	atterrissage
infaz	réalisé
müzakereler	négociations
gerçekçi	réaliste
sorar	demande
özet	synopsis
besteci	compositeur
fasulye	haricot
kılıç	épée
modifikasyonlar	modifications
mercan	corail
piksel	pixel
yolları	chemins
kabarcık	bulle
por	por
kazanmak	acquérir
aksi	contraire
tribün	tribune
Gemi	navire
asitler	acides
virüsler	virus
çıkartmalar	autocollants
reaksiyonları	réactions
inançlar	croyances
takım	équipe
çözümlemek	analyser
bölünmeler	divisions
yüzmek	nager
nano	nano
konserler	concerts
erkek	mâles
tutmak	conserver
renkler	couleurs
gerçekleştirmek	exécuter
tünel	tunnel
türler	genres
patent	brevets
buğday	blé
kronikler	chroniques
edinme	obtention
kunduz	castor
kaynaklar	lectures
genişleme	élargissement
kartallar	aigles
bazlar	bases
sanık	accusé
kampanyalar	campagnes
birlik	unité
tanımlar	définit
örnekleri	instances
yerli	indigène
başladı	commencé
paketler	paquets
Çapa	ancre
çorap	chaussettes
tetik	déclencheur
kolesterol	cholestérol
diferansiyel	différentiel
yüzeyler	surfaces
korkunç	terrible
yönlendiriciler	routeurs
saatler	horloges
artrit	arthrite
bios	bios
dişiler	femelles
yansıtır	reflète
vergilendirme	Imposition
ateş	fièvre
mutfak	cuisine
elbette	sûrement
uygulayıcıları	praticiens
teorem	théorème
enflasyon	inflation
sana	te
Bileşikler	composés
davul	tambours
oldukça	raisonnablement
çıplak	nu
radikal	radical
önerir	recommande
kontrol	commander
hazine	Trésor
alev	flamme
çukur	fosse
mono	mono
parçacıklar	particules
yüzer	flottant
koordinat	coordonner
sadece	exclusivement
sınırlama	limitation
vurdu	frappé
örnekleme	illustration
uyarılar	avertissements
kurmak	construction
uygulamaların	applications
Araştırma	enquêtes
ek	annexe
ilham	inspiration
navlun	fret
tutulma	éclipse
etkiler	affecte
tahminleri	prévisions
belirlemek	détecter
aktif	activement
karmaşık	compliqué
yaralı	blessé
ifade	expressions
ton	tonne
kurye	courrier
ipuçları	astuces
gif	gif
çatışmalar	conflits
içecek	boisson
haraç	hommage
bağışık	immunitaire
ormancılık	sylviculture
engeller	barrières
can	pente
nadiren	rarement
teklifleri	offres
bariyer	barrière
bisiklet	vélo
mobilya	mobilier
ortaya	survenir
Kelt	celtique
parçacık	particule
nem	humidité
şişeler	bouteilles
dm	dm
Rönesans	Renaissance
yönetmelik	ordonnance
fotoğrafçılar	photographes
enfeksiyonlar	infections
satranç	échecs
faaliyet	fonctionne
festivaller	festivals
olasılıklar	possibilités
ördek	canard
kanal	canal
katkı	contribuant
inek	vache
analitik	analytique
kostüm	costumes
sıkı	strict
dolaşım	circulation
suç	infraction
varsayım	supposition
hobi	loisir
çalışır	essais
icat	invention
teknisyen	technicien
yöneticiler	cadres
Araştırma	enquêtes
bilişsel	cognitif
keşfetmek	explorant
hile	tour
soruşturma	enquête
kapatma	fermeture
kereste	bois
volt	volt
yoğun	intense
destekçileri	partisans
tüzük	statuts
kaydedilmiş	inscrits
sensörler	capteurs
vida	vis
bakanlar	ministres
alenen	publiquement
acı	souffert
giriş	admission
kelebek	papillon
mekanik	mécanique
başlıkları	têtes
hatalar	erreurs
sayısal	numérique
tanımlarken	définissant
sayma	compte
yansıma	réflexion
davetiye	invitation
sodyum	sodium
hormon	hormone
çocuk	enfants
tuğla	brique
kavrama	poignée
Ortaçağ	médiéval
porselen	porcelaine
yakalanan	capturé
terbiyeli	décent
döküm	fonderie
tercüme	traduit
donna	dona
savaşçı	guerrier
kabin	cabine
tarama	balayage
polo	polo
kopyalama	copier
Boynuz	klaxon
gazetecilik	journalisme
kurbağa	grenouille
dilbilgisi	grammaire
niyet	intention
lastikler	pneus
üstlenilen	entreprise
tehlike	danger
bölüm	épisodes
dairesel	circulaire
öfke	colère
çizimler	illustrations
şansı	chances
mutluluk	bonheur
tuhaf	bizarre
ur	ur
meyve	fruits
tanımlayıcı	identificateur
kurdele	ruban
hesaplamalar	calculs
jpeg	jpeg
başlamak	Commencez
kullanışlı	pratique
takas	échanger
muaf	exempter
bitkileri	cultures
azaltır	réduit
başarılı	accompli
geometri	géométrie
izlenim	impression
lonca	guilde
bağıntı	corrélation
sim	sim
sinir	nerveux
koku	fragrance
kopya	réplique
kabile	tribu
işlemler	métiers
muhteşem	superbe
kurtulmuş	débarrasser
üçlü	trinité
ele	manipulés
efsaneler	légendes
Boom	boom
sakin	calme
şampiyonlar	champions
katlar	étages
seçimleri	sélections
karşılaştıran	comparant
konuşur	parle
mesleki	professionnel
eczaneler	pharmacies
ln	Dans
rulman	rouleau
yığın	lot
düzenlemek	organiser
takdir	apprécié
değiştirmek	modifier
kenarları	bords
karıştırma	mélange
kolları	poignées
armoni	harmonie
seçkin	distingué
astım	asthme
varsayımlar	hypothèses
düzenlenmiş	réglementé
üçgen	Triangle
değiştirmek	modifier
beklenen	anticipé
oryantal	Oriental
ödül	récompense
hidrojen	hydrogène
karşılaştırılabilir	comparable
savunucu	avocat
karışıklık	confusion
girişler	contributions
garantiler	garanties
genom	génome
madalya	médaille
koçlar	entraîneurs
gemiler	navires
liman	port
eko	eco
savunmasız	vulnérable
düzenlemek	organiser
artistik	artistique
onur	honneurs
yansıtılan	reflété
birleşik	unifié
doğurmak	race
detektör	détecteur
ihmal	ignoré
kesin	précis
değerlendirilmesi	évaluer
dudak	lèvre
toplamak	recueillir
şekillendirme	formant
gazeteciler	journalistes
hafif	mince
dolaylı	indirect
arasında	parmi
temeller	fondations
ufuk	horizon
nu	nu
derinden	profondément
yükümlülükler	passif
ödülleri	prix
azalmış	diminué
açıklayan	décrivant
optik	optique
sürdürmek	poursuivre
Şimşek	foudre
ou	OU
alıntılar	citations
müfettiş	inspecteur
yılan	serpent
hatırlatma	rappel
arandı	cherché
ovalar	plaines
anlayışlar	idées
yetenekleri	capacités
başlatılan	initié
karaoke	karaoké
tuzak	piège
yalnız	solitaire
ettik	ve
gözlemek	observer
konteynerler	conteneurs
tutumlar	attitudes
dut	baie
yaka	collier
birleştirmek	intégrer
sosyoloji	sociologie
sergileyen	expositions
kalıp	meurt
teras	terrasse
bakteriler	bactéries
gerektiğini	devrait
lezzetli	délicieux
gelenekler	traditions
sınırlı	fini
gönderir	envoie
dayanıklı	durable
müttefik	allié
nem	humidité
dönüştürmek	transformer
kronometre	minuteur
tabletler	comprimés
kazanılmış	obtenu
eğitimciler	éducateurs
sebze	légume
ayet	verset
bağımsız	indépendamment
rakipler	concurrents
roket	fusée
evet	toujours
mermi	balle
kuleler	tours
görünürlük	visibilité
enlem	latitude
bilinç	conscience
tümör	tumeur
çirkin	laid
mevduat	dépôts
metres	maîtresse
karşılaşma	rencontre
watt	watts
kırk	quarante
borular	tubes
teşebbüs	tentative
rahip	prêtre
analistler	analystes
çekiç	marteau
istila	invasion
koşucu	coureur
satırlar	lignes
uygulanan	administré
kavram	notion
yazım	orthographe
Arktik	Arctique
ödülleri	récompenses
altında	sous
güçlendirmek	renforcer
savunmak	défendre
kızılötesi	infrarouge
yedinci	septième
göbek	ventre
agresif	agressif
reklamlar	annonces
kışla	quarts
çalıntı	volé
belirleyen	détermine
heykel	sculpture
poli	poly
kulaklar	oreilles
yumruk	poing
neo	néo
motivasyon	motivation
yolcular	passagers
sürekli	régulièrement
fazlalık	surplus
kazmak	creuser
taksi	Taxi
takdir	appréciation
om	om
kısıtlama	restriction
gitarlar	guitares
öz	essence
güçlü	puissant
insanlık	humanité
transkripsiyon	transcription
komplikasyonlar	complications
alimler	savants
gökada	galaxie
sempatik	soins
ahit	testament
baskın	dominant
mide	estomac
kısmen	partiellement
küçültmek	minimiser
rütbeler	rangs
ilk	début
nesiller	générations
turnuvalar	tournois
reddetmek	Nier
anatomi	anatomie
kulaklık	écouteurs
kesir	fraction
üçlü	trio
işlem	instance
küp	cube
kusurlar	défauts
belirsizlik	incertitude
Yıkmak	panne
yerleşik	colonisé
aşı	vaccin
kader	sort
rezervasyon	réservations
cumhuriyetçiler	républicains
orman	jungle
Zen	Zen
dis	dis
tahmin	prédiction
ekolojik	écologique
oval	ovale
ima	implique
ser	ser
değerlendirme	évaluation
olasılık	perspective
coğrafi	géographique
verici	donneur
gerginlik	tension
çöp	poubelle
şekiller	formes
aşama	étage
Kont	comte
vatan	patrie
şampiyona	championnats
ırkları	races
disko	disco
aus	aus
bitirme	finition
duygular	émotions
sonsuz	éternel
rotasyon	rotation
nam	nam
üretken	productif
bulvar	boulevard
domuz	porc
metrik	métrique
cezalar	pénalités
çeşitli	varié
grande	grande
aktris	actrice
atamak	attribuer
Karşılamak	accommoder
kaplanlar	tigres
köyler	villages
gölge	ombre
Koro	Refrain
ritim	rythme
hane	chiffre
senfoni	symphonie
ani	soudain
kabul	acceptant
havuzlarda	piscines
lirik	lyrique
izolasyon	isolement
hızlar	vitesses
sürekli	soutenu
eşleşti	appariés
yaklaşık	approximatif
Halat	corde
akılcı	rationnel
programcı	programmeur
savaşçıları	combattants
miras	hérité
tamamlanmamış	incomplet
vokal	voix
Çeşme	Fontaine
meşru	légitime
biyografiler	Biographies
araştırmacı	enquêteur
davacı	demandeur
nazik	doux
layık	digne
mimarlar	architectes
azizler	saints
girişimci	entrepreneur
taşır	porte
düet	duo
aşırı	excessif
kaydeder	sauve
kabul	considéré
değerleme	évaluation
beklenmedik	inattendu
sis	brouillard
karakteristik	caractéristiques
lobi	hall
özetlenen	décrit
muazzam	énorme
karma	karma
oluşmaktadır	consister
kraliçeler	reines
akademisyenler	universitaires
kabileler	tribus
ayrım	distinction
tehlikeler	dangers
muafiyet	exemption
kiracı	locataire
Sürdürülebilirlik	durabilité
dövme	tatouage
cebir	algèbre
gölgeler	ombres
saçma	idiot
serbestçe	librement
hafif	doux
kürk	fourrure
kolayca	facilement
üyelik	affiliation
çit	clôture
sonsuz	infini
klan	clan
devrimci	révolutionnaire
bilezikler	bracelets
çare	remède
nefes	respiration
kısaca	brièvement
kalınlık	épaisseur
grafik	graphique
deha	génie
tartışılması	discuter
savaşçı	combattant
anlamlı	significatif
uyarlanmış	adapté
Emlak	domaines
kilim	couverture
demokrat	démocrate
ilçe	arrondissement
korur	maintient
ka	ka
muhafaza	retenu
mermer	marbre
dem	dem
meditasyon	méditation
mikrofon	microphone
birleştirme	combinant
devleri	géants
düzenleme	organisation
not	note
jambon	jambon
çözülmüş	résolu
gelgit	marée
bölme	cloison
görünmez	invisible
konsolları	consoles
mıknatıs	aimant
çeviriler	traductions
jaguar	jaguar
emtia	marchandise
kilometre	kilomètres
garantiler	garanties
Gotik	gothique
silindir	cylindre
cadı	sorcière
dolar	mâle
düşmanları	ennemis
danışmanlık	Conseil
keyfi	profiter
devriye	patrouille
koku	odeur
karnaval	carnaval
kabaca	grossièrement
etiket	autocollant
sözler	promesses
resif	récif
bölmek	diviser
ardışık	consécutif
bon	bon
gösterimleri	représentations
chan	chan
melodileri	airs
mas	mas
ifadeler	phrases
kai	kai
yarımada	péninsule
sıkıcı	ennuyeuse
dom	dom
konuşmalar	discours
ulaşır	atteint
şema	schéma
kataloglar	catalogues
bakanlıklar	ministères
meclis	parlementaire
önek	préfixe
savan	savane
varil	baril
sinir	nerf
dans	Dans
gezegenler	planètes
açık	déficit
yenilemek	renouveler
bağlanmış	accouplé
devreler	circuits
doku	texture
kabul	reconnaître
çadır	tente
tanımlar	identifie
vasıf	qualification
kilitler	serrures
minyatür	miniature
Euro	euros
korsanlar	pirates
hava	aérien
şahin	faucon
sonuç	conséquence
sistematik	systématique
algılanan	perçue
kökenleri	origines
kiralanmış	embauché
makyaj	maquillage
ui	ui
ağırlıklar	poids
jeolojik	géologique
kalıcı	durable
kötü	méchant
tanıtır	introduit
itilmiş	pressé
ro	ro
eğim	pente
şair	poète
komplo	conspiration
ilahiyat	théologie
çiviler	ongles
belirgin	évident
sürmek	manèges
epik	épique
organizatör	organisateur
alerji	allergie
uğruna	Saké
kombinasyonlar	combinaisons
önceki	précédent
hak	mérite
enzim	enzyme
düzlemler	Avions
diskler	disques
amplifikatör	amplificateur
keyfi	arbitraire
belirgin	important
sans	sans
kurar	construit
temas	contacté
şaft	arbre
yağsız	maigre
nadiren	occasionnel
yenilikler	innovations
gözden	révision
panik	panique
vatandaşlık	citoyenneté
bahane	excuse
reformlar	réformes
soğan	oignon
sandviç	sandwich
alto	alto
hiyerarşi	hiérarchie
terkedilmiş	abandonné
çevreler	cercles
atım	Beats
şen	joyeux
tarikat	culte
tire	tiret
pasif	passif
değerli	estimé
kafes	cage
cesaret	courage
yükseklik	élévation
kucak	tour
kullanım	utilisation
içkiler	boissons
ping	ping
eğlenceli	divertissant
önkoşul	prérequis
sınır	frontière
mülteciler	réfugiés
şövalyeler	chevaliers
hipotez	hypothèse
ilaçlar	médicaments
değişmiş	modifié
doktrin	doctrine
manzara	scénique
geliştirmeleri	améliorations
kesişim	intersection
dikiş	couture
toplayıcıları	collectionneurs
tanınan	reconnu
öfke	rage
prix	prix
astroloji	astrologie
danışmanları	conseillers
köşk	pavillon
taktik	tactique
tamamlayıcı	additionnel
yetenekli	talentueux
yastık	oreiller
yayma	diffusion
taşra	provinces
çalmak	voler
parsel	parcelle
oran	incidence
endişe	craintes
tahmin	prédire
lezzet	saveur
aç	affamé
madeni	métallique
girişim	ingérence
savaşçı	guerriers
atmosferik	atmosphérique
hale	Halo
ebeveyn	parental
başvurulan	référencé
vurur	grèves
karınca	fourmi
önerme	proposition
uygun	apte
ele	traité
tüccar	Commerçant
atılmış	jeté
kriter	critère
rozet	badge
medeniyet	civilisation
funda	bruyère
muazzam	énorme
gerçekleştirir	exécute
Diyar	domaine
düzeltilmiş	corrigée
kask	casque
karşılaşılan	rencontré
tsunami	tsunami
akademisyen	savant
çevrili	entouré
jeoloji	géologie
yaratıklar	créatures
temizlenir	dégagé
başarmak	accomplir
köşeleri	coins
vejetaryen	végétarien
Maya	Levure
pas	pas
araştırılmıştır	enquête
büyükelçi	ambassadeur
kaplanmış	recouvert
kader	condamner
rutinleri	routines
varlıklar	êtres
güven	dépendance
efsane	mythe
dere	ruisseau
fu	fu
fenomen	phénomène
topluluk	ensemble
emin	assuré
bilinçli	conscient
Aksan	accent
eşleri	épouses
yararlanmak	utiliser
rehin	gage
vampir	vampire
rıhtım	Dock
örgütlü	organisé
müzisyen	musicien
sınırlayıcı	limitant
restore	restauré
ipucu	allusion
zırh	armure
düşünce	remarque
onlarca	douzaines
değişir	varie
muhakeme	raisonnement
gardiyanlar	gardes
açıklıklar	ouvertures
yerine	remplaçant
araştırmacı	chercheur
konseyler	conseils
meslekler	professions
tanınan	reconnu
domuz	porc
zu	zu
denge	équilibre
borular	pipes
evler	chalets
birleşmek	fusionner
ayrıcalık	privilège
geliştirir	développe
şasi	châssis
tahmin	estimation
ahır	Grange
don	gel
enstitüleri	instituts
kalıp	moule
kadın	dame
yat	yacht
tercih	préfère
delme	forage
ot	herbe
ihlal	violation
balina	baleine
gezgin	voyageur
ödenek	crédits
şüpheli	soupçonné
domates	tomates
eğitmenler	instructeurs
moment	élan
yüzgeç	ailette
papaz	pasteur
çamur	boue
zümrüt	émeraude
büyür	pousse
sistem	tract
ul	ul
bale	ballet
gazeteci	journaliste
dinler	religions
Sarımsak	Ail
parlaklık	éclat
patlama	explosion
külot	slips
imzalar	signatures
ozon	ozone
disiplinler	disciplines
casa	casa
konuşmaları	conversations
radyolar	radios
tarife	tarif
basitleştirilmiş	simplifié
kaslar	muscles
hızlı	rapide
vajina	vagin
Şampanya	Champagne
sapma	déviation
samba	samba
kullanmak	employer
penguen	manchot
büyülü	magique
etkiler	influences
denetimler	inspections
sulama	irrigation
mucize	miracle
hidrolik	hydraulique
nüfuz	pénétration
yara	blessure
belle	belle
rosa	rosa
mahkumiyet	conviction
tembel	paresseux
nitelikleri	qualités
babalar	ancêtres
doldurma	charge
önemlisi	important
minyon	menue
cihaz	appareil
arazi	terrain
açıklayan	expliquant
şeritler	bandes
adaylık	nomination
deneysel	empirique
solucan	ver
bağımlılık	dépendance
ayrık	discret
acemi	débutant
kapak	couvercle
cinsellik	sexualité
safir	saphir
ayrıcalıkları	privilèges
uzmanlaşmış	spécialisation
işaretleme	marquage
şerif	shérif
reddedildi	diminué
casuslar	espions
motosikletler	motocyclettes
seçilmiş	élire
karayolları	autoroutes
yoğunlaşmak	concentrer
samimi	intime
moleküller	molécules
mermi	tours
buzdolabı	réfrigérateur
aralıkları	intervalles
cümleler	Phrases
soykırım	holocauste
pilot	prospectus
bezelye	pois
dozaj	dosage
varyans	variance
denizci	navigateur
iğne	aiguille
hamam	thermes
frenler	freins
og	og
ko	ko
sahibi	propriétaire
Kader	destin
manzaralar	paysages
hesaplama	calcul
saman	foins
kurtuluş	salut
tahminler	prévisions
öğrenenler	apprenants
jeton	jeton
çinko	zinc
kurban	sacrifice
arayanlar	demandeurs
guru	gourou
uygun	adapté
sayısal	numérique
antropoloji	anthropologie
imparator	empereur
mezun	grad
kemerleri	ceintures
siyahlar	noirs
eğitimli	cultivé
gururla	fièrement
zorunluluk	nécessité
eğrileri	courbes
gezici	tournée
tepe	sommet
domates	tomate
Now	voyages
soluk	pâle
işleyen	fonctionnement
ekonomiler	économies
üstlenmek	entreprendre
bildirmek	déclarer
valfler	vannes
boşluklar	lacunes
başarılar	réalisations
gözyaşı	larme
öğretir	enseigne
sıfır	néant
yabancı	étranger
yuva	nid
mahkeme	tribunal
çizgili	gouverné
emekli	pensions
namaz	prières
polis	flic
genç	adolescent
aday	nominations
muz	banane
tanıtıcı	préliminaire
rezervuar	réservoir
olay	occurrence
idol	idole
kanlı	sanglant
hatırlatmak	rappeler
büyüleyici	charmant
diş	dent
itibarlı	respecté
kalır	séjours
mesele	affaire
kısıtlamak	restreindre
mayınlar	mines
portreler	portraits
yorumlanır	interprété
değerlendirmeler	évaluations
eliminasyon	élimination
metre	mètres
farazi	hypothétique
helikopter	hélicoptère
kalem	crayon
sanatçı	interprète
komisyonlar	commissions
küre	sphère
yosun	mousse
oranlar	rapports
uyum	concorde
mezun	graduée
onaylanan	approuvé
şaşırtıcı	surprenant
mızrak	lance
merdiven	échelle
mantar	Liège
senatörler	sénateurs
kanama	saignement
niteleme	caractérisation
olasılık	probabilité
şerit	voies
temelleri	fondamentaux
bulaşma	contamination
kubbe	dôme
kutsamak	bénir
müzakere	négociation
ibik	crête
rakipler	adversaires
zafer	triomphe
aday	nommé
kaynak	soudage
orgazm	orgasme
alaşım	alliage
araziler	parcelles
nazikçe	doucement
kilitleme	verrouillage
kontrollü	controversé
çizer	dessine
buzdolabı	frigo
bıçaklar	lames
döngüler	boucles
dalgalanma	poussée
travma	traumatisme
ilan	publicité
savunma	défensive
yasak	interdit
vanilya	vanille
programcılar	programmeurs
izlenen	suivi
tesisat	installations
ruhlar	âmes
motive	motivé
dilsiz	stupide
oyuk	creux
tonoz	voûte
oluk	rainure
vahiy	révélation
kovalama	poursuite
delegasyon	délégation
teller	fils
sözlükleri	dictionnaires
şeffaflık	transparence
yörünge	orbite
para	devises
Nijer	Niger
konumlandırma	placement
koloni	colonie
top	canon
sirk	cirque
terfi	promu
alabalık	truite
ustalık	exploit
geçici	temporairement
pişmiş	cuit
iletmek	transmettre
frekansları	fréquences
yansımalar	réflexions
açlık	faim
belediye	municipalité
dedektif	détective
çimento	ciment
yaşandığı	expérience
şömine	cheminée
ciro	approbation
tekstil	textiles
füze	missile
psikiyatri	psychiatrie
asist	aide
denetçi	Auditeur
keman	violon
peygamber	prophète
oksit	oxyde
muhteşem	magnifique
derhal	rapidement
adaptasyon	adaptation
zararlı	nocif
cinsel	sexuellement
kuşatma	enceinte
glikoz	glucose
norm	norme
playback	lecture
kaplumbağa	tortue
mesafeler	distances
emme	absorption
hazineler	trésors
fosil	fossile
kötü	mal
komünist	communiste
girişimciler	entrepreneurs
robotlar	robots
faul	faute
biyoçeşitlilik	biodiversité
heyecan	excitation
sözlü	verbal
denizler	mers
gizemli	mystérieux
yenilik	nouveauté
fayans	carrelage
kütüphaneci	bibliothécaire
anahtarlamalı	commuté
ru	ru
poz	pose
gram	grammes
terapist	thérapeute
bütçeleri	budgets
keçi	chèvre
kılmak	rendre
yelken	voile
komisyon	commissaires
yoğun	dense
cesur	courageux
nakliye	expéditeur
korkunç	terrible
uçak	avion
organizmalar	organismes
teleskop	télescope
asbest	amiante
ilerleme	avancement
Söğüt	saule
özgeçmiş	CV
var	existait
jeneratörler	générateurs
üretir	génère
patates	patates
tam	approfondi
reseptörleri	récepteurs
Optimum	optimum
yaratık	créature
yalnız	seul
ince	subtil
çizgili	rayures
firmware	firmware
çoban	berger
beşik	berceau
rektör	chancelier
un	farine
tartışma	controverse
efsanevi	légendaire
koro	chorale
kaçınma	évitant
güzel	magnifiquement
beklediğini	attend
atlama	sauteur
kumaşlar	textile
polimer	polymère
temizlik	hygiène
Erdem	vertu
cerrahlar	chirurgiens
manda	mandat
külliyat	corpus
terminoloji	terminologie
beyefendi	gentilhomme
suçlu	condamné
jetleri	jets
endeksleri	indices
qui	Qui
tehdit	menaçant
eylemciler	militants
tutsak	prisonnier
teşvik	encourage
birleştirilmiş	assemblé
terminalleri	terminaux
ham	brut
inceler	examine
viking	viking
Temizlemek	nettoyer
şartlı	conditionnel
saldırıya	attaqué
geldiğinde	arrive
çevirmen	traducteur
otomobiller	automobiles
traktör	tracteur
kıta	continent
ücretler	tarifs
boylam	longitude
ümit	espéré
sokma	insertion
kısıtlama	contrainte
güçlendirme	renforcement
isteyen	souhaitant
izolasyon	isolation
ihlal	infraction
kıvrılmış	courbé
öznel	subjectif
canavarlar	monstres
iltica	asile
kazık	pieu
kokteyl	cocktail
çeşitleri	variétés
zehir	poison
hakim	dominé
pahalı	cher
türevler	dérivés
önler	prévient
tüfek	fusil
ırkçılık	racisme
yorumlamak	interpréter
anlaşma	accord
mütevazi	modeste
oyuncular	joueurs
sınıflandırma	tri
irtibat	liaison
ampuller	bulbes
turistler	touristes
davranışlar	comportements
açıklamak	clarifier
bel	taille
atfedilen	attribué
baykuş	hibou
kristaller	cristaux
aşan	dépasse
tamamlayıcı	complémentaire
savaşlar	batailles
acı	amer
muhtıra	mémorandum
ejderha	dragons
gürültü	vacarme
inanılmaz	incroyablement
delegeler	délégués
psikiyatrik	psychiatrique
gençler	adolescents
avlu	Cour
başkanlar	présidents
ayrılmak	partir
açıkça	expressément
zambak	lis
gözetim	surveillance
reçine	résine
Müttefikler	alliés
korunmuş	conservé
çarpı	franchi
yükselen	Ascendant
nominal	nominal
çürüme	pourriture
kuvars	quartz
kayıtlar	registres
sekizinci	huitième
yetkili	autorisé
geliştirir	améliore
savunucuları	défenseurs
fenomenler	phénomènes
eğim	inclinaison
granit	granit
kitleler	masses
atlet	athlète
frank	franc
benzerlik	similarité
sızıntı	fuite
danışman	conseiller
kitapçık	brochure
bekliyor	attendant
devir	rotation
idrar	urine
havlu	serviette
zencefil	gingembre
kromozom	chromosome
als	als
sinekler	mouches
yetki	compétence
ağlayan	pleurs
amatör	amateurs
vinç	grue
soruşturma	enquête
çürük	pourri
alışkanlık	habitude
Onur	honneur
korur	protège
iris	iris
yönetir	gère
erozyon	érosion
marangoz	Charpentier
Kağan	khan
yetersiz	insuffisant
formülasyon	formulation
zeki	intelligent
Lordlar	seigneurs
zevkli	agréable
hilâl	croissant
altmış	soixante
konsantre	concentré
ayırmak	distinguer
ei	ei
projeksiyonlar	projections
kıvılcım	étincelle
sabitleme	fixation
patika	sentier
dedektörler	détecteurs
başak	pointe
bileşen	ingrédient
perde	rideau
ifşa	divulgués
taktik	tactique
pilotlar	pilotes
sefer	expédition
faal	opératoire
Mizah	humour
mol	mol
damga	imprimer
yardım	assistant
kusur	défaut
kötü	pauvrement
tanrıça	déesse
gözlemciler	observateurs
mıknatıslar	aimants
formüller	formules
geniş	spacieux
savunuyor	soutient
topraklar	sols
organlar	organes
det	det
bağlılık	fidélité
sadık	fidèle
suç	infraction
lityum	lithium
sıçrama	saut
kurucu	fondation
kuğu	cygne
Ekim	plantation
antlaşma	engagement
arkeoloji	archéologie
denizci	marin
bakımları	soins
barınak	sanctuaire
heykel	statue
alıntı	citation
binbaşı	majors
hile	manipulation
çanlar	cloches
toksisite	toxicité
verici	émetteur
mahalleler	quartiers
ganimet	trophée
duygu	émotion
manzaraları	spectacles
üniformalar	uniformes
yaralı	blessés
türev	dérivé
işgal	occupation
dozlar	doses
Eğitmek	éduquer
önyargı	préjudice
teknisyenleri	techniciens
muhtemel	probable
yayınlama	émission
dekorasyon	décoration
uyruklu	ressortissants
Truva	troyen
yardımcıları	assistants
danışman	conseiller
yürürlüğe	adopté
kararsız	instable
çağırdı	pressé
yansıtan	reflétant
kazanma	gagnant
kesin	définitive
seyahat	voyagé
uyarlamak	adapter
katılım	accession
regülatör	régulateur
yakıtlar	carburants
soya	soja
temiz	soigné
adlandırma	appellation
kıç	arrière
hazırlanmış	conçu
salak	idiot
oluşan	composé
uzaylılar	extraterrestres
düzenlemeler	modifications
kuzgun	corbeau
Konut	habitation
sembolik	symbolique
açılar	angles
basınçları	pressions
Venüs	Vénus
alevler	flammes
ilkel	primitif
çorap	stockage
ekosistem	écosystème
salonları	salles
basitlik	simplicité
iblis	démon
karşıladı	accueilli
notasyonu	notation
teyze	tante
karga	corbeau
anlamsal	sémantique
durdurulan	abandonnées
karar	décide
küreselleşme	mondialisation
eşekler	ânes
pusula	boussole
gelişti	évolué
piyade	infanterie
ünlü	renommé
koridor	couloir
felsefi	philosophique
gerekçe	justification
boş	vacant
sabitleme	fixation
gram	gramme
gizleme	cache
boya	colorant
alfabe	alphabet
temizlenir	nettoyé
şerefli	honoré
optik	optique
telefonlar	téléphones
günlükler	agendas
keder	douleur
ter	transpiration
Yunus	dauphin
harikaları	merveilles
havalandırma	ventilation
maskeler	masques
büst	buste
geçit	ruelle
yolları	voies
telgraf	télégraphe
anıt	monument
resmen	officiellement
çiy	rosée
çekilmiş	retiré
tartışmalar	débats
kimlikler	identités
eksiklik	carence
sele	selle
sıtma	paludisme
sadık	fidèle
eğilim	tendance
kullanılan	utilisé
ein	ein
dürbün	jumelles
başlatmak	lancer
yalnızca	purement
canlı	vif
iddialar	allégations
tekabül	correspond
şeytan	démon
ünlü	célèbre
avcılar	chasseurs
hareket	agi
katsayı	coefficient
kafatası	crâne
devam	continuation
hizmetçi	serviteur
şahin	faucon
ortaklaşa	conjointement
kaçınılması	éviter
açıklamalar	explications
yenilenmiş	renouvelé
eleştirmen	critique
tortu	sédiment
kareler	carrés
minibüsler	fourgonnettes
koni	cône
hayatta	survécu
yaygınlık	prévalence
fragman	fragment
taahhüt	engage
kobra	cobra
attı	jeta
hoc	hoc
sanatçılar	interprètes
tatlı	dessert
tez	thèse
dokuzuncu	neuvième
coşku	enthousiasme
kutlamaları	célébrations
valiler	gouverneurs
atomları	atomes
Dokular	tissus
rampa	rampe
güzelce	bien
della	della
egemenlik	domination
akor	accords
bozulma	détérioration
molekül	molécule
