arasında	de
için	à
içinde	dans
için	pour
olduğu	est
üzerinde	sur
o	cette
tarafından	par
bu	ce
ile	avec
ben	je
sen	toi
o	il
veya	ou
olmak	être
Hangi	sont
en	à
herşey	tout
var	avoir
yeni	Nouveau
Biz	nous
irade	volonté
ev	maison
bize	nous
hakkında	sur
Eğer	si
sayfa	page
benim	mon
vardır	a
arama	chercher
ücretsiz	gratuit
fakat	mais
bizim	notre
bir	un
diğer	autre
yap	faire
bilgi	information
zaman	temps
o	il
hangi	lequel
onların	leur
haber	nouvelles
kullanım	utilisation
Orada	Là
görmek	voir
yani	alors
kim	qui
ağ	toile
Ayrıca	aussi
almak	obtenir
pm	pm
görünüm	vue
c	c
e	e
ilk	premier
olmuştur	été
olur	aurait
idi	étaient
s	s
sevmek	comme
x	X
göre	que
bulmak	trouver
fiyat	prix
geri	arrière
üst	Haut
insanlar	gens
vardı	avait
liste	liste
isim	prénom
sadece	juste
yıl	an
gün	journée
içine	dans
iki	deux
sağlık	santé
n	n
yeniden	ré
Kullanılmış	utilisé
gitmek	aller
b	b
son	dernier
Yapmak	faire
onları	leur
meli	devrait
ürün	produit
sistem	système
posta	poster
ona	sa
Kent	ville
t	t
politika	politique
numara	nombre
destek	soutien
mesaj	message
sonra	après
sonra	puis
Ocak	jan
iyi	bien
d	ré
nerede	où
bilgi	Info
haklar	droits
kitaplar	livres
yüksek	haute
okul	école
m	m
her	chaque
bağlantılar	liens
o	elle
yıl	années
sipariş	commande
çok	très
kitap	livre
ürün	articles
şirket	compagnie
r	r
okumak	lis
grup	groupe
seks	sexe
çok	beaucoup
kullanıcı	utilisateur
de	de
set	ensemble
genel	général
Araştırma	recherche
Üniversite	Université
Ocak	janvier
posta	courrier
tam	plein
yorumlar	avis
program	programme
bilmek	connaître
oyunlar	Jeux
yol	façon
günler	journées
p	p
Bölüm	partie
could	pourrait
harika	génial
birleşmiş	uni
gerçek	réal
f	F
Uluslararası	international
merkez	centre
seyahat	Voyage
yorumlar	commentaires
yapılmış	fabriqué
gelişme	développement
rapor	rapport
üye	membre
ayrıntılar	détails
hat	ligne
şartlar	termes
önce	avant
oteller	hôtels
did	fait
göndermek	envoyer
sağ	droite
tip	type
yerel	local
bu	ceux
Sonuçlar	résultats
ofis	Bureau
Ulusal	nationale
araba	voiture
dizayn	conception
almak	prendre
gönderildi	posté
adres	adresse
topluluk	communauté
içinde	dans
devletler	États
istemek	vouloir
telefon	téléphone
DVD	DVD
konu	assujettir
arasında	entre
forum	forum
aile	famille
l	l
uzun	longue
w	w
göstermek	montrer
O	o
Üstelik	même
siyah	noir
özel	spécial
indeks	indice
olmak	étant
KADIN	femmes
çok	beaucoup
işaret	signe
dosya	fichier
bağlantı	lien
açık	ouvrir
güney	Sud
dava	Cas
proje	projet
sayfalar	pages
versiyon	version
Bölüm	section
kendi	posséder
ev	maison
güvenlik	Sécurité
g	g
kontluk	comté
Amerikan	américain
Fotoğraf	photo
oyun	Jeu
üyeler	membres
güç	Puissance
ağ	réseau
bilgisayar	ordinateur
sistemler	systèmes
üç	Trois
yer	endroit
son	fin
h	h
onu	lui
başına	par
erişim	accès
düşünmek	pense
kuzeyinde	Nord
kaynaklar	Ressources
şimdiki	actuel
büyük	gros
medya	médias
kanun	loi
kontrol	contrôle
Su	eau
Tarihçe	histoire
boyut	Taille
kişisel	personnel
kılavuz	guider
Dükkan	boutique
rehber	annuaire
değişiklik	changement
beyaz	blanc
Metin	texte
küçük	petit
değerlendirme	évaluation
oran	taux
hükümet	gouvernement
çocuklar	enfants
dönüş	revenir
öğrencilerin	élèves
v	v
hesap	Compte
zamanlar	fois
seviye	niveau
dijital	numérique
profil	profil
önceki	précédent
form	forme
olaylar	événements
Aşk	amour
eski	vieux
John	John
ana	principale
aramak	appel
görüntü	image
Bölüm	département
Başlık	Titre
olmayan	non
k	k
y	y
sigorta	Assurance
acak	doit
özellik	propriété
sınıf	classe
CD	CD
kalite	qualité
her	chaque
listeleme	inscription
içerik	contenu
ülke	pays
küçük	peu
araçlar	outils
düşük	faible
cevap	répondre
müşteri	client
Aralık	décembre
karşılaştırmak	comparer
filmler	films
kolej	Université
değer	valeur
makale	article
adam	homme
Meslekler	emplois
j	j
Gıda	aliments
yazar	auteur
farklı	différent
u	u
öğrenmek	apprendre
satış	vente
baskı	impression
kurs	cours
iş	emploi
oda	chambre
Stok	Stock
Eğitim	entraînement
çok	aussi
kredi	crédit
puan	point
Bilim	science
erkekler	Hommes
kategoriler	catégories
batı	Ouest
bak	Regardez
ingilizce	Anglais
takım	équipe
arazi	biens
Kutu	boîte
koşullar	conditions
fotoğraflar	Photos
eşcinsel	gai
iplik	fil
kategori	Catégorie
Not	Remarque
canlı	vivre
büyük	grand
galeri	Galerie
tablo	table
ancak	toutefois
Haziran	juin
Ekim	octobre
Kasım	novembre
Market	marché
kütüphane	bibliothèque
aksiyon	action
başla	début
dizi	séries
Özellikler	fonctionnalités
hava	air
sanayi	industrie
plan	plan
insan	Humain
Evet	Oui
ikinci	seconde
Sıcak	chaud
maliyet	Coût
film	film
forumlar	forums
Mart	Mars
la	la
Eylül	septembre
söylemek	dire
gidiyor	Aller
tıbbi	médical
arkadaş	ami
Aralık	déc
sunucu	serveur
uygulama	application
Personel	Personnel
oyun	jouer
sorunlar	problèmes
Nisan	avril
kullanıcılar	utilisateurs
sokak	rue
konu	sujet
karşısında	contre
var	eu
Blog	Blog
Parti	fête
ödeme	Paiement
ekipman	équipement
let	laisser
programlar	programmes
yasal	légal
son	récent
park	parc
davranmak	acte
sorun	problème
kırmızı	rouge
vermek	donner
bellek	Mémoire
performans	performance
sosyal	social
q	q
Öykü	récit
satmak	vendre
seçenekleri	Options
deneyim	expérience
anahtar	clé
vücut	corps
genç	Jeune
önemli	important
alan	champ
az	peu
Doğu	est
tek	unique
ii	ii
yaş	âge
kulüp	club
örnek	Exemple
kızlar	filles
z	z
yol	route
hediye	cadeau
soru	question
CA	Californie
zor	difficile
ödeme	Payer
dört	quatre
poker	poker
konu	problème
menzil	gamme
bina	bâtiment
satıcı	vendeur
mahkeme	tribunal
Şubat	février
sonuç	résultat
ışık	lumière
yazmak	écrire
savaş	guerre
teklif	offre
mavi	bleu
gruplar	groupes
ark	Al
kolay	facile
verilmiş	donné
istek	demande
faks	fax
Çin	Chine
yapma	fabrication
resim	image
ihtiyaçlar	Besoins
mümkün	possible
ay	mois
majör	Majeur
star	étoile
gelecek	avenir
uzay	espace
Kurul	Comité
el	main
Güneş	Soleil
kartları	cartes
Londra	Londres
toplantı	réunion
olmak	devenir
çocuk	enfant
Tut	garder
porno	porno
pay	partager
benzer	similaire
Bahçe	jardin
okullar	écoles
milyon	million
katma	ajoutée
referans	référence
şirketler	entreprises
bebek	bébé
öğrenme	apprentissage
enerji	énergie
koşmak	courir
teslim	livraison
popüler	populaire
terim	terme
film	film
hikayeleri	histoires
koymak	mettre
dergi	journal
raporlar	rapports
ko	co
Deneyin	essayer
Görüntüler	images
ihbar	remarquer
Allah	Dieu
orijinal	original
kafa	tête
radyo	radio
hücre	cellule
konsey	conseil
içerir	comprend
Izlemek	Piste
tartışma	discussion
Arşiv	archiver
diğerleri	autres
anlaşma	accord
biçim	format
toplum	société
ay	mois
Emniyet	sécurité
Arkadaş	copains
emin	sûr
baskı	édition
mesajları	messages
pazarlama	commercialisation
söylemek	dire
birleşme	association
sağlar	fournit
eğlence	amusement
zaten	déjà
yeşil	vert
çalışmalar	études
kapat	Fermer
ortak	commun
özel	spécifique
birkaç	nombreuses
yaşam	vivant
Toplamak	collection
denilen	appelé
kısa	court
sanat	lettres
çok	lot
Sor	demander
sınırlı	limité
çözeltiler	solutions
yönetmen	réalisateur
plaj	plage
geçmiş	passé
doğal	Naturel
elektronik	électronique
üzerine	sur
dönem	période
planlama	Planification
diyor	dit
resmi	officiel
mar	mar
tamam	terminé
teknik	technique
pencere	fenêtre
profesyonel	pro
bölge	Région
ada	île
kayıt	record
direkt	direct
konferans	conférence
kayıtlar	archives
st	st
ilçe	district
takvim	calendrier
maliyetler	frais
stil	style
Beyan	déclaration
mil	miles
kaynak	Ressource
uygulamaları	applications
belge	document
sözcük	mot
Eserleri	travaux
malzeme	Matériel
fatura	facture
yazılı	écrit
kurallar	règles
nihai	final
şey	chose
merkez	centre
Gereksinimler	exigences
DOĞRU	VRAI
dakika	minutes
Başka	autre
işaret	marque
Kaya	Roche
kötü	mal
bireysel	individuel
artı	plus
Oto	auto
kapak	couverture
Düzenle	modifier
birlikte	ensemble
videolar	vidéos
hızlı	vite
fonksiyon	fonction
gerçek	fait
alma	obtention
global	global
teknoloji	technologie
karşılamak	rencontrer
uzak	loin
ekonomik	économique
tr	en
oyuncu	joueur
projeler	projets
Miktar	montant
izlemek	regarder
dahil	inclus
hissetmek	ressentir
banka	banque
risk	risque
fırsatlar	offres
çeşitli	divers
kelimeler	mots
üretim	production
ticari	commercial
ağırlık	poids
kalp	cœur
tedavi	traitement
makas	points
bilgi	connaissance
dergi	magazine
hata	Erreur
kamera	caméra
kız	fille
inşaat	construction
oyuncaklar	jouets
kayıtlı	inscrit
domain	domaine
yöntemleri	méthodes
bölüm	chapitre
koruma	protection
politikaları	politiques
geniş	large
güzellik	beauté
müdür	directeur
Hindistan	Inde
pozisyon	position
alınmış	pris
çeşit	Trier
listeleri	annonces
bilinen	connu
yarım	moitié
vakalar	cas
adım	étape
mühendislik	ingénierie
basit	simple
hızlı	rapide
lisans	Licence
göl	Lac
bütün	entier
yıllık	annuel
yayınlanan	publié
kilise	église
yöntem	méthode
aktif	actif
tepki	réponse
şekil	figure
malzemeler	matériaux
yeterli	assez
tasarlanmış	conçu
arasında	parmi
ölüm	décès
kayıp	perte
yüz	visage
marka	marque
indirim	remise
Etkileri	effets
oluşturulan	créé
standartlar	normes
bit	bit
siyasi	politique
krallık	Royaume
baz	base
iş	Faire
krediler	prêts
ayakkabı	chaussures
giriş	entrée
kalmak	rester
emirler	ordres
kullanılabilirlik	disponibilité
özet	résumé
dönüş	tour
büyüme	croissance
Ajans	agence
kral	Roi
Avrupa	européen
aktivite	activité
kopya	copie
batı	occidental
Kuvvet	Obliger
iş	emploi
Defne	baie
nehir	rivière
komisyon	commission
paket	paquet
görüldü	vu
oyuncu	joueurs
motor	moteur
Liman	Port
albüm	album
bölgesel	régional
durdurmak	Arrêtez
başladı	commencé
yönetim	administration
bar	bar
enstitü	institut
görünümler	vues
çift	double
köpek	chien
yakında	bientôt
hatlar	lignes
elektronik	électronique
faydaları	avantages
gerekli	nécessaire
yazıcı	imprimante
şart	condition
etkili	efficace
inanmak	croyez
organizasyon	organisation
Efekt	effet
us	esprit
seçim	sélection
kumarhane	casino
pdf	pdf
tur	tour
çapraz	traverser
umut	espérer
şirket	société
dilek	souhait
çözüm	Solution
olgun	mature
rol	rôle
haftalar	semaines
belli	certain
alt	inférieur
gerekli	nécessaire
Birlik	syndicat
Pazartesi	lun
com	com
belirli	particulier
ince	bien
saat	heure
gaz	gaz
becerileri	compétences
altı	six
çalı	buisson
adaları	îles
tavsiye	Conseil
kariyer	carrière
karar	décision
ayrılmak	laisser
önceden	pré
Kocaman	énorme
Kadın	femme
tesisler	installations
teklif	offre
orta	milieu
kablo	câble
fırsatlar	Opportunités
alma	prise
değerler	valeurs
bölünme	division
gelecek	arrivant
nesne	objet
lezbiyen	lesbienne
uygun	approprié
makine	machine
logo	logo
uzunluk	longueur
Güzel	agréable
Gol	But
istatistik	statistiques
müşteri	client
Numune	échantillon
yatırım	investissement
gönderilen	envoyé
gösterilen	montré
Noel	Noël
kültür	Culture
flaş	flash
MS	Mme
seçim	choix
dersler	cours
tüketici	consommateur
Merhaba	salut
yabancı	étranger
sanatçı	artiste
mobilya	meubles
kanal	canal
mektup	lettre
kip	mode
telefonlar	Téléphones
fikirler	idées
yapı	structure
derece	degré
sözleşme	Contrat
Süper	super
erkek	mâle
madde	matière
neredeyse	presque
bulunan	situé
çoklu	plusieurs
dağıtım	Distribution
editör	éditeur
Han	auberge
Sanayi	industriel
potansiyel	potentiel
şarkı	chanson
los	los
düşmek	tomber
Fikir	idée
Odalar	pièces
iletişim	communications
kazanmak	gagner
birincil	primaire
kanser	cancer
sayılar	Nombres
neden	raison
araç	outil
bahar	printemps
vakıf	fondation
Cevap	répondre
ses	voix
program	programme
evraklar	documents
amaç	objectif
özellik	fonctionnalité
yatak	lit
geliyor	vient
polis	police
bağımsız	indépendant
yaklaşım	approche
kahverengi	marron
fiziksel	physique
Tepe	colline
haritalar	Plans
ambar	tenir
derecelendirme	évaluations
mutlu	content
demirci	forgeron
gelişmiş	développé
teşekkür	remercier
kasa	sûr
benzersiz	unique
anket	enquête
önceki	avant
telefon	Téléphone
spor	sport
hazır	prêt
hayvan	animal
kaynaklar	sources
nüfus	population
baba	Pennsylvanie
düzenli	ordinaire
güvenli	garantir
operasyonlar	opérations
basitçe	simplement
kanıt	preuve
istasyon	gare
anlama	comprendre
seçenek	option
vadi	vallée
muhtemelen	Probablement
deniz	mer
yayınlar	publications
iyileştirmek	améliorer
bağ	connexion
Yayımcı	éditeur
salon	salle
anti	anti
ağlar	réseaux
toprak	Terre
ebeveyn	Parents
darbe	impact
Aktar	transfert
Giriş	introduction
mutfak	cuisine
kuvvetli	fort
düğün	mariage
özellikleri	Propriétés
hastane	hôpital
zemin	sol
gemi	navire
Konaklama	hébergement
hastalık	maladie
mükemmel	excellent
mükemmel	parfait
saç	cheveux
fırsat	opportunité
malzeme	trousse
klasik	classique
temel	base
komuta	commander
şehirler	villes
ekspres	Express
ödül	prix
mesafe	distance
ağaç	arbre
değerlendirme	évaluation
duvar	mur
ilgili	impliqué
el	el
ekstra	supplémentaire
özellikle	notamment
bütçe	budget
kılavuzlar	guides
başarı	Succès
maksimum	maximum
anne	mère
operasyon	opération
mevcut	existant
oldukça	assez
seçilmiş	choisi
oğlan	garçon
restoranlar	Restaurants
güzel	beau
uyarı	Attention
yerleri	Emplacements
at	cheval
oy	vote
Çiçekler	fleurs
yıldızlar	étoiles
listeleri	listes
sahip	propriétaire
hayvanlar	animaux
yolları	façons
oğul	fils
sağlama	fournir
kural	règle
Konut	logement
alır	prend
getirmek	apporter
katalog	catalogue
maksimum	max
anne	mère
yetki	autorité
söyledi	Raconté
program	programme
katıldı	relié
giriş	contribution
strateji	stratégie
ayaklar	pieds
ajan	agent
geçerli	valide
modern	moderne
kıdemli	Sénior
seksi	sexy
öğretim	enseignement
kapı	porte
büyük	grandiose
Deneme	procès
birimler	unités
güzel	cool
normal	Ordinaire
kuruluş	entreprise
gemiler	navires
tüm	tout
pozitif	positif
Fitness	aptitude
Çince	chinois
görüş	opinion
Futbol	Football
soyut	abstrait
çıktı	sortie
para	fonds
Bay	M
muhtemelen	probable
geliştirmek	développer
sanatçılar	artistes
alternatif	alternative
sorumluluk	responsabilité
java	Java
konuk	client
yayın	publication
pas	passer
ilişkiler	rapports
güven	confiance
kamyonet	van
içeren	contient
çok	multi
cumhuriyet	république
harç	honoraires
bileşenler	Composants
tatil	vacances
yüzyıl	siècle
akademik	académique
yardım	assistance
tamamlanan	terminé
cilt	peau
grafik	graphique
Hintli	Indien
halka	bague
sınıf	qualité
dağ	Montagne
organizasyonlar	organisations
filtre	filtre
panel	panneau
zemin	sol
alış	achat
maç	rencontre
önerilen	proposé
gerektirir	exiger
çocuklar	garçons
sabah	Matin
verir	permet
protein	protéine
bitki	plante
rapor	signalé
vurmak	frappé
aa	mm
havuz	bassin
mini	mini
siyaset	politique
ortak	partenaire
yazarlar	auteurs
panoları	planches
balık	poisson
üyelik	adhésion
misyon	mission
göz	œil
sicim	chaîne
duyu	sens
değiştirilmiş	modifié
yayınlandı	libéré
evre	étape
iç	interne
doğmuş	née
detaylı	détaillé
