of	из
että	в
sisään	в
varten	для
on	является
päällä	на
että	что
mennessä	от
Tämä	это
kanssa	с
minä	я
sinä	вы
se	Это
tai	или
olla	быть
olemme	находятся
at	в
kaikki	все
omistaa	иметь
Uusi	новый
me	мы
tahtoa	будем
Koti	Главная
meille	нас
noin	около
jos	если
sivu	страница
minun	мой
on	имеет
Hae	поиск
vapaa	свободно
mutta	но
meidän	наш
yksi	один
muut	Другие
tehdä	делать
tiedot	Информация
aika	время
hän	он
joka	который
heidän	их
uutiset	Новости
käyttää	использование
siellä	там
nähdä	видеть
niin	так
Kuka	кто
verkko	Web
myös	также
saada	получить
pm	вечера
näkymä	Посмотреть
C	с
e	е
ensimmäinen	первый
ollut	было
olisi	бы
olivat	мы
s	s
Kuten	как
x	Икс
kuin	чем
löytö	найти
hinta	цена
takaisin	назад
ylin	Вверх
ihmiset	люди
oli	имел
lista	список
nimi	имя
vain	просто
vuosi	год
päivä	день
osaksi	в
kaksi	два
terveys	здоровье
n	N
re	ре
käytetty	используемый
mennä	идти
b	б
kestää	последний
tehdä	делать
niitä	их
pitäisi	должен
tuote	продукт
järjestelmä	система
lähettää	после
hänen	ее
kaupunki	город
T	T
politiikka	политика
määrä	номер
tuki	поддержка
viesti	сообщение
jälkeen	после
sitten	тогда
tammikuu	январь
hyvä	хорошо
d	d
missä	где
tiedot	Информация
oikeudet	права
kirjat	книги
korkea	высокая
koulu	школа
m	м
kukin	каждый
linkit	связи
hän	она
vuotta	лет
tilata	заказ
erittäin	очень
kirja	книга
kohdetta	Предметы
yhtiö	Компания
R	р
lukea	читать
ryhmä	группа
sukupuoli	секс
monet	многие
käyttäjä	пользователь
de	де
sarja	задавать
yleinen	Генеральная
tutkimus	исследование
yliopisto	Университет
tammikuu	январь
posti	почта
koko	полный
arvostelut	отзывы
ohjelmoida	программа
tietää	знать
pelit	игры
tapa	путь
päivää	дней
p	п
osa	часть
voisi	мог
loistava	Великий
yhdistynyt	единый
todellinen	реальный
f	е
kansainvälinen	Международный
keskusta	центр
matkustaa	путешествовать
kommentit	Комментарии
tehty	сделал
kehitys	развитие
raportti	доклад
jäsen	член
yksityiskohdat	Детали
linja	линия
ehdot	сроки
ennen	до
hotellit	отели
teki	сделал
lähettää	Отправить
oikea	правильно
tyyppi	тип
paikallinen	местный
nuo	те
tulokset	Результаты
toimisto	офис
kansallinen	национальный
auto	автомобиль
design	дизайн
ottaa	принимать
lähetetty	отправил
osoite	адрес
Yhteisö	сообщество
sisällä	в
valtiot	состояния
haluta	хотеть
puhelin	Телефон
DVD	DVD
aihe	предмет
välillä	между
foorumi	Форум
perhe	семья
l	L
pitkä	длинный
w	вес
show	показать
O	о
jopa	даже
musta	черный
erityinen	особый
indeksi	индекс
ollessa	являющийся
naiset	женщины
paljon	много
merkki	знак
tiedosto	файл
linkki	ссылка
avata	открытый
etelä	юг
tapaus	дело
projekti	проект
sivut	страницы
versio	версия
jakso	раздел
oma	своя
talo	дом
turvallisuus	безопасность
g	г
lääni	округ
amerikkalainen	американский
kuva	Фото
peli	игра
jäsenet	члены
teho	мощность
verkko	сеть
tietokone	компьютер
järjestelmät	системы
kolme	три
paikka	место
pää	конец
h	час
häntä	его
kohti	в
pääsy	доступ
ajatella	думать
pohjoinen	север
voimavarat	Ресурсы
nykyinen	текущий
iso	большой
tiedotusvälineet	СМИ
laki	закон
ohjaus	контроль
vesi	воды
historia	история
koko	размер
henkilökohtainen	личный
opas	руководство
myymälä	магазин
hakemisto	каталог
muuttaa	изменение
valkoinen	белый
teksti	текст
pieni	маленький
luokitus	рейтинг
nopeus	ставка
hallitus	правительство
lapset	дети
palata	вернуть
opiskelijoille	студенты
v	v
tili	Счет
ajat	раз
taso	уровень
digitaalinen	цифровой
profiili	профиль
Edellinen	предыдущий
muoto	форма
Tapahtumat	Мероприятия
rakkaus	люблю
vanha	старый
Johannes	Джон
tärkein	главный
puhelu	вызов
kuva	образ
osasto	отдел
otsikko	заглавие
ei	не
K	К
y	Y
vakuutus	страхование
on	должен
omaisuus	имущество
luokka	класс
CD	CD
laatu	качественный
joka	каждый
listaus	список
pitoisuus	содержание
maa	страна
vähän	немного
Työkalut	инструменты
matala	низкий
Vastaa	Ответить
asiakas	клиент
joulukuu	Декабрь
vertailla	сравнить
elokuvat	кино
college	колледж
arvo	стоимость
artikla	статья
mies	человек
työpaikkaa	работы
j	J
ruoka	питание
kirjailija	автор
eri	другой
U	U
oppia	учить
myynti	продажа
Tulosta	Распечатать
kurssi	курс
Job	работа
huone	комната
kalusto	акции
koulutus	обучение
liian	слишком
luotto	кредит
kohta	точка
tiede	наука
miehet	люди
luokat	категории
länsi	запад
Katso	смотреть
Englanti	английский
tiimi	команда
omaisuus	имущество
laatikko	коробка
olosuhteet	условия
Valokuvat	фото
homo	гей
lanka	нить
kategoria	категория
Huomautus	заметка
elää	жить
suuri	большой
galleria	галерея
pöytä	Таблица
kuitenkin	Однако
kesäkuu	июнь
lokakuu	октябрь
marraskuu	ноябрь
markkinoida	рынок
kirjasto	библиотека
toiminta	действие
alkaa	Начало
sarja	серии
ominaisuudet	функции
ilma	воздух
ala	промышленность
suunnitelma	план
ihmisen	человек
Joo	да
toinen	второй
kuuma	горячий
kustannus	Стоимость
elokuva	кино
foorumit	форумы
maaliskuu	Март
la	ля
syyskuu	сентябрь
sanoa	сказать
menossa	собирается
lääketieteellinen	медицинская
ystävä	друг
joulukuu	декабрь
palvelin	сервер
hakemus	заявление
henkilöstö	сотрудники
pelata	играть
kysymykset	вопросы
huhtikuu	апрель
käyttäjät	пользователи
katu	улица
aihe	тема
vastaan	против
sai	получил
blogi	блог
juhla	вечеринка
maksu	оплата
laitteet	оборудование
antaa	позволять
ohjelmat	программы
oikeudellinen	правовой
viimeaikainen	недавний
pysäköidä	парк
toimia	акт
ongelma	проблема
punainen	красный
antaa	дайте
muisti	Память
esitys	представление
sosiaalinen	Социальное
q	Q
tarina	история
myydä	продавать
vaihtoehtoja	опции
kokea	опыт
avain	ключ
ruumis	тело
nuori	молодой
tärkeä	важный
ala	поле
harvat	мало
itään	восток
yksittäinen	Один
ii	б
ikä	возраст
klubi	клуб
esimerkki	пример
tytöt	девочки
z	Z
tie	Дорога
lahja	подарок
kysymys	вопрос
ca	Калифорния
kova	жесткий
maksaa	платить
neljä	четыре
pokeri	покер
ongelma	вопрос
alue	ассортимент
rakennus	здание
myyjä	продавец
tuomioistuin	суд
helmikuu	февраль
tulos	результат
valo	легкий
kirjoittaa	записывать
sota	война
tarjous	предлагает
sininen	синий
ryhmät	группы
ai	аль
helppo	легко
tietty	данный
pyyntö	запрос
faksi	факс
Kiina	Китай
tehdä	изготовление
kuva	картина
tarpeisiin	потребности
mahdollinen	возможное
kuukausi	месяц
suuri	главный
tähti	звезда
tulevaisuus	будущее
tila	пространство
komitea	комитет
käsi	рука
aurinko	солнце
kortit	карты
Lontoo	Лондон
tapaaminen	встреча
tulla	стали
lapsi	ребенок
pitää	держать
porno	порно
Jaa	доля
samankaltainen	аналогичный
puutarha	сад
koulut	школы
miljoona	миллиона
lisättyä	добавленной
viite	Справка
yritykset	компании
vauva	детка
oppiminen	обучение
energia	энергия
juosta	бег
toimitus	Доставка
suosittu	популярный
termi	срок
elokuva	фильм
tarinoita	истории
laittaa	положил
päiväkirja	журнал
raporttien	отчеты
co	Колорадо
yrittää	пытаться
kuvien	изображений
ilmoitus	уведомление
Jumala	Бог
alkuperäinen	оригинал
pää	глава
radio	радио
solu	клетка
neuvosto	совет
sisältää	включает
seurata	трек
keskustelu	обсуждение
arkisto	архив
toiset	другие
sopimus	соглашение
muoto	формат
yhteiskunta	общество
kuukaudet	месяцы
turvallisuus	безопасность
ystävät	друзья
varma	конечно
painos	издание
viestien	Сообщения
markkinointi	маркетинг
kertoa	рассказать
yhdistys	ассоциация
tarjoaa	обеспечивает
hauska	весело
jo	уже
vihreä	зеленый
opinnot	исследования
kiinni	Закрыть
yhteinen	общий
erityinen	конкретный
useat	несколько
elävä	живой
kokoelma	коллекция
nimeltään	называется
lyhyt	короткая
arts	искусства
erä	много
kysyä	просить
rajallinen	ограниченное
ratkaisut	решения
johtaja	директор
ranta	пляж
menneisyys	мимо
luonnollinen	натуральный
elektroniikka	электроника
päälle	на
aika	период
suunnittelu	планирование
sanoo	говорит
virallinen	официальный
maaliskuu	март
tehty	сделанный
tekninen	технический
ikkuna	окно
ammattilainen	профессионал
alue	область
saari	остров
ennätys	запись
suoraan	непосредственный
konferenssi	конференция
asiakirjat	учет
st	улица
piiri	район
kalenteri	календарь
kustannukset	расходы
tyyli	стиль
selvitys	заявление
mailia	миль
resurssi	ресурс
sovellukset	Приложения
asiakirja	документ
sana	слово
teokset	работает
materiaali	материал
laskuttaa	законопроект
kirjallinen	написано
säännöt	правила
lopullinen	окончательный
asia	вещь
keskusta	центр
vaatimuksista	требования
TOTTA	ПРАВДА
minuutit	минут
muu	еще
merkki	отметка
rock	камень
huono	Плохо
yksilö	индивидуальный
plus	плюс
auto	авто
peite	обложка
muokata	редактировать
yhdessä	вместе
Videot	видео
nopeasti	быстро
toiminto	функция
tosiasia	факт
saada	получение
maailmanlaajuinen	Глобальный
teknologia	тек
tavata	встретить
pitkälle	далеко
taloudellinen	экономической
fi	ан
pelaaja	игрок
hankkeet	проектов
määrä	количество
katsella	смотреть
Sisältää	включены
tuntea	Чувствовать
pankki	банка
riski	риск
tarjoukset	предложения
eri	различный
sanat	слова
tuotanto	производство
kaupallinen	коммерческая
paino	вес
sydän	сердце
hoito	лечение
pistettä	точки
tuntemus	знание
aikakauslehti	журнал
virhe	ошибка
kamera	камера
tyttö	девушка
rakentaminen	строительство
lelut	игрушки
kirjattu	зарегистрированный
verkkotunnuksen	домен
menetelmät	методы
luku	глава
suojaus	защита
politiikkaa	полисы
leveä	широкий
kauneus	красота
johtaja	менеджер
Intia	Индия
asento	должность
otettu	взятый
järjestellä	Сортировать
listat	объявления
tunnettu	известен
puoli	половина
tapauksissa	случаи
vaihe	шаг
tekniikka	инжиниринг
yksinkertainen	просто
nopea	быстро
lisenssi	лицензия
järvi	озеро
koko	все
vuotuinen	годовой
julkaistu	опубликованный
kirkko	церковь
menetelmä	метод
aktiivinen	активный
vastaus	ответ
kuva	фигура
tarvikkeet	материалы
tarpeeksi	достаточно
suunnitellut	предназначенный
keskuudessa	среди
kuolema	смерть
menetys	потеря
kasvot	лицо
brändi	марка
alennus	скидка
tehosteet	последствия
luotu	созданный
standardit	стандарты
bitti	немного
poliittinen	политическая
kuningaskunta	Королевство
pohja	база
tekemässä	дела
lainat	кредитование
kengät	обувь
merkintä	запись
pysyä	оставаться
tilaukset	заказы
saatavuus	доступность
yhteenveto	резюме
vuoro	очередь
kasvu	рост
toimisto	агентство
kuningas	король
eurooppalainen	Европейская
aktiviteetti	Мероприятия
kopio	копия
Läntinen	вестерн
pakottaa	сила
työllisyys	занятость
lahti	залив
joki	река
komissio	комиссия
paketti	пакет
nähdään	видели
pelaajat	игроки
moottori	двигатель
portti	порт
albumi	альбом
alueellinen	региональный
Stop	стоп
aloitti	начал
antaminen	администрация
baari	бар
instituutti	институт
näkymät	Просмотры
kaksinkertainen	двойной
koira	собака
pian	скоро
linjat	линии
elektroninen	электронный
hyötyjä	выгоды
tarvittu	необходимый
kirjoitin	принтер
kunto	состояние
tehokas	эффективный
uskoa	верить
organisaatio	организация
vaikutus	эффект
mieli	разум
valinta	выбор
kasino	казино
PDF	PDF
kiertue	тур
ylittää	пересекать
toivoa	надежда
yhtiö	корпорация
toive	желание
ratkaisu	решение
kypsä	зрелый
rooli	роль
viikkoa	недель
tietty	определенный
alempi	ниже
välttämätön	необходимо
liitto	союз
mon	понедельник
com	ком
tietty	конкретный
hieno	отлично
tunnin	час
kaasu	газ
taidot	навыки
kuusi	шесть
Puska	куст
saaret	острова
neuvot	совет
ura	карьера
päätös	решение
jättää	оставлять
pre	до
valtava	огромный
nainen	женщина
laitteisto	оборудование
tarjous	предложение
keskimmäinen	средний
kaapeli	кабель
mahdollisuudet	возможности
ottaen	принятие
arvot	значения
jako	деление
tuleva	приход
esine	объект
lesbo	лесбиянка
sopiva	подходящее
kone	машина
logo	логотип
pituus	длина
kiva	хороший
pisteet	Гол
tilasto	статистика
asiakas	клиент
näyte	образец
investointi	инвестиции
lähetetty	послал
esitetty	показанный
joulu	рождество
kulttuuri	культура
salama	вспышка
neiti	Миз
valinta	выбор
kurssit	курсы
kuluttaja	потребитель
Moi	Здравствуй
ulkomainen	иностранные
taiteilija	художник
huonekalut	мебель
kanava	канал
kirje	письмо
tila	Режим
puhelimet	телефоны
ideoita	идеи
rakenne	состав
aste	степень
sopimus	контракт
Super	супер
Uros	мужской
asia	дело
melkein	почти
sijaitsevat	располагается
moninkertainen	множественный
jakelu	распределение
toimittaja	редактор
majatalo	гостиница
teollinen	промышленные
mahdollinen	потенциал
laulu	песня
los	лос
pudota	падать
ajatus	идея
Huoneet	номера
viestintä	связь
voittaa	выиграть
ensisijainen	первичный
syöpä	рак
numerot	чисел
syy	причина
työkalu	инструмент
kevät	весна
perusta	Фонд
vastaus	ответ
ääni	голос
ajoittaa	график
asiakirjat	документы
tarkoitus	цель
ominaisuus	особенность
sänky	постель
tulee	выходит
Poliisi	полиция
itsenäinen	независимый
lähestyä	подход
ruskea	коричневый
fyysinen	физическое
mäki	холм
kartat	карты
pitää	держать
luokitukset	рейтинги
onnellinen	счастливый
seppä	кузнец
kehittyneillä	развитая
kiittää	спасибо
turvallinen	безопасно
ainutlaatuinen	уникальный
tutkimus	опрос
ennen	предшествующий
puhelin	телефон
Urheilu	спорт
valmis	готов
eläin	животное
lähteet	источники
väestö	Население
pa	папа
säännöllinen	регулярный
turvallinen	безопасный
toiminnot	операции
yksinkertaisesti	просто
näyttö	доказательства
asema	станция
ymmärtää	Понимаю
vaihtoehto	вариант
laakso	долина
todennäköisesti	вероятно
meri	море
Julkaisut	публикации
parantaa	улучшать
yhteys	соединение
kustantaja	издатель
sali	зал
anti	анти
verkot	сети
maa	Земля
vanhemmat	родители
vaikutus	влияние
siirtää	перевод
esittely	введение
keittiö	кухня
vahva	сильный
häät	свадьба
ominaisuudet	свойства
sairaala	больница
maa	земля
alus	корабль
majoitus	жилье
tauti	болезнь
erinomainen	отлично
täydellinen	идеально
hiukset	волосы
tilaisuus	возможность
pakki	Комплект
klassikko	классический
perusta	основа
komento	команда
kaupungit	города
ilmaista	экспресс
myöntää	награда
etäisyys	расстояние
puu	дерево
arviointi	оценка
seinä	стена
osallistuva	участвует
el	эль
ylimääräinen	дополнительный
erityisesti	особенно
talousarvio	бюджет
oppaita	направляющие
menestys	успех
enimmäismäärä	максимальная
äiti	мама
operaatio	операция
nykyinen	существующий
melko	довольно
valittu	выбранный
poika	мальчик
ravintolat	ресторан
kaunis	красивая
Varoitus	предупреждение
sijainnit	места
hevonen	лошадь
äänestys	голос
kukat	цветы
tähdet	звезды
luettelot	списки
omistaja	владелец
eläimet	животные
tapoja	пути
poika	сын
tarjoaminen	обеспечение
sääntö	правило
kotelo	Корпус
kestää	принимает
tuoda	приносить
luettelo	каталог
max	Максимум
äiti	мама
auktoriteetti	власть
kertoi	сказал
ohjelmoida	программа
liittyi	присоединился
panos	вход
strategia	стратегия
jalkaa	ноги
agentti	агент
pätevä	действительный
moderni	современное
vanhempi	старшая
seksikäs	сексуальный
opetus	обучение
ovi	дверь
suuri	большой
oikeudenkäynti	испытание
yksiköt	единицы
viileä	круто
normaali	нормальный
yritys	предприятие
laivat	судов
koko	все
positiivinen	положительный
kunto	фитнес
Kiinalainen	Китайский
lausunto	мнение
jalkapallo	футбол
abstrakti	Абстрактные
ulostulo	вывод
varat	фонды
Herra	Мистер
todennäköisesti	вероятно
kehittää	развивать
Taiteilijat	художники
vaihtoehto	альтернатива
vastuu	обязанность
Jaava	Ява
vieras	гость
julkaisu	публикация
kulkea	проходить
suhteet	связи
luottamus	доверять
pakettiauto	фургон
sisältää	содержит
multi	много
tasavalta	республика
palkkiot	сборы
komponentit	компоненты
loma	отпуск
vuosisata	века
akateeminen	академический
apu	помощь
valmistunut	завершено
iho	кожа
grafiikka	графика
intialainen	индийский
rengas	кольцо
arvosana	класс
vuori	гора
organisaatioiden	организации
suodattaa	фильтр
paneeli	панель
lattia	пол
ostaminen	покупка
ottelu	совпадение
ehdotettu	предложенный
vaatia	требовать
pojat	мальчиков
aamu	утро
sallii	позволяет
proteiini	белок
kasvi	растение
raportoitu	сообщается
osuma	удар
mm	мм
pool	бассейн
mini	мини
politiikka	политика
kumppani	партнер
kirjoittajat	авторы
levyt	доски
kalastaa	рыба
jäsenyys	членство
tehtävä	миссия
silmä	глаз
jono	строка
tunne	смысл
muokattu	модифицированный
julkaisi	выпущенный
vaihe	сцена
sisäinen	внутренний
syntynyt	Родился
yksityiskohtainen	подробный
japanilainen	Японский
rotu	раса
hyväksytty	утвержденный
kohde	цель
paitsi	Кроме
merkki	персонаж
ylläpito	поддержание
kyky	способность
toim	издание
raiskata	изнасилование
akku	аккумулятор
nuoret	молодежь
paine	давление
toimitettu	Отправлено
velka	долг
keskikokoinen	средний
televisio	телевидение
kiinnostunut	заинтересованный
ydin	ядро
tauko	ломать
tarkoituksiin	цели
setit	наборы
tanssi	танец
puu	дерево
määritellyt	определенный
paperit	документы
palkinnot	награды
maksu	плата
studio	студия
lukija	читатель
laite	устройство
perusti	установленный
vastauksia	ответы
vuokrata	аренда
las	лас
tumma	темно
ulkoinen	внешний
omena	яблоко
le	ле
ohjeet	инструкции
min	мин
tarjotaan	предложенный
teoria	теория
poistaa	Удалить
apu	помощь
visuaalinen	визуальный
isäntä	хозяин
lajike	разнообразие
opettajat	учителей
manuaalinen	руководство
lohko	блок
aiheita	предметы
aineet	агенты
korjaus	ремонт
oikeudenmukainen	Справедливая
teräs	стали
ymmärtäminen	понимание
lauluja	песни
kiinteä	исправлено
väärä	неправильно
alku	начало
käsissä	Руки
az	Аризона
Pariisi	Париж
saa	получает
sektori	сектор
kapasiteetti	вместимость
un	ООН
rasva	жир
isä	отец
sähköinen	электрический
näin	увидел
välineet	инструменты
upseeri	сотрудник
kuljettaja	Водитель
yritykset	бизнес
kuollut	мертвый
tuntematon	неизвестный
ravintola	ресторан
mikrofoni	Майк
matka	поездка
mi	ми
huono	бедные
yhteys	отношения
työntekijöiden	рабочие
rauha	мир
perinteinen	традиционный
osoittavat	показ
luova	творческий
rannikko	берег
hyöty	выгода
rahoitus	финансирование
laitteet	приборы
herra	господин
myöntää	даровать
sub	суб
kaunokirjallisuus	фантастика
kellot	часы
uraa	карьера
menee	идет
led	светодиод
museo	музей
tuuletin	поклонник
kuljetus	транспорт
mielenkiintoista	интересно
blogit	блоги
arviointi	оценка
entinen	бывший
vyöhyke	зона
monimutkainen	сложный
th	го
kissa	Кот
kuolla	умереть
esittelyyn	представленный
tasainen	квартира
virtaus	течь
virastojen	агентства
kirjallisuus	литература
vanhempi	родитель
asetus	установка
DR	доктор
asteikko	масштаб
talous	экономика
hyödyllinen	полезный
kuukausittain	ежемесячно
kriittinen	критический
kehys	Рамка
musikaali	музыкальный
määritelmä	определение
sihteeri	секретарь
polku	дорожка
päällikkö	главный
antaa	дает
paketit	пакеты
yksityiskohta	подробно
lait	законы
muutettu	изменено
alkaa	начать
kuninkaallinen	королевский
puhdas	чистый
kaveri	парень
otsikot	названия
merkityksellinen	Соответствующий
oikeudenmukaisuus	справедливость
kytkeä	соединять
kuppi	кружка
kori	корзина
soveltava	прикладная
viikoittain	еженедельно
vol	об
asennus	монтаж
pp	стр
huomio	внимание
edetä	продвижение
hyppiä	пропускать
ruokavalio	диета
armeija	армия
vaihde	шестерня
ero	разница
sallittu	позволил
oikea	верный
kansakunta	нация
myynti	продажа
paljon	много
pala	кусок
arkki	лист
yritys	фирма
seitsemän	Семь
elementtejä	элементы
laji	вид
hypätä	Прыгать
solut	ячейки
moduuli	модуль
lomakeskus	курорт
todistus	сертификат
ministeri	министр
liike	движение
muoti	мода
ohjeet	направления
vierailijat	посетители
dokumentointi	документация
kaupankäynti	торговый
metsä	лес
puhelut	звонки
kattavuus	покрытие
pari	пара
antaminen	дающий
mahdollisuus	шанс
näkemys	видение
pallo	мяч
pääte	окончание
asiakkaat	клиенты
toimet	действия
keskustella	обсуждать
tavoite	Цель
onnistunut	успешный
myyty	продан
tuuli	ветер
yhteisöt	сообщества
kliininen	клиническая
tilanne	ситуация
markkinat	рынки
kustannustoiminta	издательский
ilmestyä	появиться
kehittämällä	развивающийся
elämää	жизни
määrittää	определить
lämpötila	температура
ilmoitukset	объявления
potilas	пациент
todellinen	фактический
historiallinen	исторический
kivi	камень
Bob	боб
kaupankäynti	коммерция
henkilöt	лиц
vaikea	сложно
tieteellinen	научный
satelliitti	спутник
testit	тесты
kylä	деревня
tilit	Счета
amatööri	любитель
entinen	бывший
tavannut	встретил
kipu	боль
tekijät	факторы
kahvi	кофе
ostaja	покупатель
juliste	плакат
reuna	край
toiminnallinen	функциональная
juuri	корень
fi	фи
suljettu	закрыто
juhlapäivät	каникулы
vaaleanpunainen	розовый
saldo	баланс
seuranta	мониторинг
vastaukset	ответы
laukaus	выстрел
alkukirjain	начальная
etiketti	метка
sec	сек
kaanon	канон
liiga	лига
jätteet	отходы
minuutti	минут
bussi	автобус
toimittaja	поставщик
sanakirja	Словарь
kirjanpito	учет
valmistus	производство
osiot	разделы
tuoli	стул
ponnistus	усилие
vaihe	фаза
fantasia	фантазия
po	ро
va	в
professori	профессор
Asentaa	устанавливать
paita	Рубашка
vaatteet	одежда
jalka	фут
rinta	грудь
tekniikat	методы
dollaria	долларов
uskonto	религия
lupa	разрешение
villi	дикий
sukupolvi	поколение
neiti	Мисс
kemiallinen	химическая
lääkäri	врач
tehtävä	задача
vähentää	уменьшить
toi	привел
liikunta	упражнение
vika	ошибка
takuu	гарантия
johtaja	лидер
SE	се
prosessit	процессы
pehmeä	мягкий
kokoukset	встречи
sekuntia	секунд
lento	рейс
kongressi	конгресс
polttoaine	топливо
kävellä	ходить
valmistettu	произведенный
pyhimys	святой
Perustelu	аргумент
kilpailu	соревнование
huumeita	наркотики
yhteinen	совместный
palkkio	премия
tuore	свежий
merkkiä	персонажи
asianajaja	адвокат
di	ди
tekijä	фактор
tuhansia	тысячи
km	км
virta	поток
huoneisto	апартаменты
valita	выбирать
kuulo	слух
itäinen	восточный
terapia	терапия
merkinnät	записи
allekirjoitettu	подписанный
hallinnollinen	административный
vakava	серьезный
raja	предел
askeleet	меры
kaupat	магазины
orjuus	зависимость
del	дель
pyrkimyksiä	усилия
ilmoitti	проинформировал
ga	Джорджия
ajatuksia	мысли
puro	ручей
ft	фут
määrä	количество
olennainen	существенный
matkat	туры
ladata	нагрузка
heti	немедленно
koneet	машины
nimetty	назначенный
raskas	тяжелый
katettu	покрытый
elpyminen	восстановление
integroitu	интегрированный
kokoonpano	конфигурация
kukko	петух
kauppias	торговец
kattava	комплексный
asiantuntija	эксперт
suojella	защищать
vankka	твердый
esittely	презентация
tuli	стал
oranssi	оранжевый
noudattaminen	соблюдение
teema	тема
rikas	богатые
kampanja	кампания
vs	против
kitara	гитара
havainto	обнаружение
esimerkkejä	Примеры
henki	дух
ar	Арканзас
vaatimukset	требования
hyväksyminen	принятие
strategiat	стратегии
mo	мо
asioihin	дела
tarkoitettu	предназначена
sa	са
tavoitteet	цели
vuokraus	Наем
vaalit	выборы
ehdottaa	предлагать
haara	филиал
palvella	обслуживать
Kumppanit	филиалы
asentaa	крепление
Latina	латинский
multimedia	мультимедиа
hoitaa	управлять
kulma	угол
arvo	ранг
elementti	элемент
syntymä	рождение
virus	вирус
interaktiivinen	интерактивный
pyynnöt	Запросы
erillinen	отдельный
neljännes	четверть
menettely	процедура
johto	руководство
määritellä	определять
uskonnollinen	религиозная
tosiasiat	факты
aamiainen	завтрак
sarake	колонка
usko	вера
ketju	цепь
tunnistaa	идентифицировать
katu	проспект
puuttuva	отсутствует
suosituksia	рекомендации
siirretty	переехал
saavuttaa	достичь
vertailu	сравнение
hetki	момент
laajennettu	расширенный
jakso	последовательность
tuuma	дюймовый
hyökkäys	атака
keskuksissa	центры
aukko	открытие
laboratorio	лаборатория
varata	резерв
gamma	гамма
tuottaa	производить
totuus	правда
laskuri	счетчик
vika	отказ
seuraa	следует
dollari	доллар
leiri	лагерь
des	дез
elokuvat	фильмы
silta	мост
täyttää	заполнить
liike	движение
painaminen	печать
luonnos	проект
kartoittaa	диаграмма
pelataan	играл
yhteystiedot	контакты
lukijoita	читатели
risti	клубы
wa	Вашингтон
seikkailu	приключение
uhri	предложение
voitto	прибыль
johtajat	лидеры
Julisteet	плакаты
laitokset	учреждения
avustaja	помощник
muuttuja	переменная
dj	диджей
pysäköinti	стоянка
eilen	вчера
määritetty	определенный
työpaja	мастерская
mennyt	прошло
koodit	коды
Erilaisia	виды
laajentaminen	расширение
lausuntoja	заявления
täysin	полностью
joukkueet	команды
linnake	форт
cm	см
senaatti	сенат
hauska	веселая
geeni	ген
kääntyi	оказалось
levy	диск
kuvio	шаблон
vene	лодка
teatteri	театр
valmistajat	производители
sponsori	спонсор
klassinen	классический
ikoni	значок
takuu	гарантия
omistautunut	преданный
suunta	направление
koripallo	баскетбол
esineet	объекты
poistaa	Удалить
ilta	вечер
kokoonpano	сборка
ydinaseiden	ядерной
hiiri	мышь
signaali	сигнал
rikollinen	преступник
annettu	выпущен
voimakas	мощный
unelma	мечта
VÄÄRÄ	ЛОЖНЫЙ
da	да
heittää	бросать
kukka	цветок
henkilöstö	персонал
läpäissyt	прошло
toimitetaan	поставляется
Falls	падения
sielu	душа
edistää	содействовать
totesi	заявил
tilastot	статистика
ammattilaisten	профессионалов
näyttää	появляется
kuljettaa	нести
lippu	флаг
kannet	крышки
em	Эм
etu	преимущество
Hei	Здравствуйте
malleja	конструкции
ylläpitää	поддерживать
matkailu	туризм
prioriteetti	приоритет
aikuiset	Взрослые
graafinen	графический
atomi	атом
maksut	платежи
sitova	переплет
lyhyt	краткое
päättyi	закончился
voittoisa	выигрыш
anonyymi	анонимный
käsikirjoitus	скрипт
palveli	служил
haluaa	хочет
valmis	подготовленный
mitätön	недействительным
tag	тег
haastatella	интервью
sekoittaa	смешивание
puitteet	фреймворк
levy	диск
asennetut	установлен
kuningatar	Королева
ov	кредиты
selvästi	явно
korjata	фиксировать
kahva	ручка
makea	милая
kriteeri	критерии
kumppani	ассоциировать
NE	Небраска
käytös	поведение
suurentaa	увеличить
säde	луч
tulot	доход
mitata	измерение
ääntä	голосов
du	дю
velvollisuus	обязанность
keskustelut	обсуждение
karhu	медведь
saada	усиление
festivaali	фестиваль
laboratorio	лаборатория
valtameri	океан
lennot	рейсы
asiantuntijat	эксперты
merkkejä	знаки
syvyys	глубина
kouluttaa	поезд
kuiva	сухой
tutkia	исследовать
kylpylä	спа
konsepti	концепция
lähes	около
käsittely	обращение
alkuperä	происхождения
miljardi	миллиард
älykkyys	интеллект
ostettu	купил
huijaus	против
kansakunnat	нации
reitti	маршрут
rikki	сломанный
taistelu	боевой
puhua	говорить
protokolla	протокол
tiedustelu	запрос
kumppanuus	партнерство
ilmaisu	выражение
es	эс
puhe	речь
johdin	провод
ehdotukset	предложения
korvaus	замена
nauha	лента
strateginen	стратегическое
tuomari	судья
happo	кислота
tavua	байтов
sentti	цент
pakko	принудительный
yhteensopiva	совместимый
huoneisto	квартира
tyhjä	ноль
nolla	нуль
kaiutin	оратор
konsultointi	консалтинг
suunnittelija	дизайнер
PR	пр
avioliitto	брак
rulla	рулон
pankit	банки
FR	фр
osallistujaa	участники
salaisuus	секрет
negatiivinen	отрицательный
suosikit	избранное
teatteri	театр
jouset	пружины
var	вар
suorittaa	выполнять
käännös	перевод
arvioiden	оценки
vahinko	травма
ministeriö	министерство
kuljettajat	водители
lakimies	адвокат
luvut	цифры
suojattu	защищенный
ehdotus	предложение
jakaminen	разделение
portaali	портал
beeta	бета
ilmaiseksi	бесплатно
kohti	к
hieman	немного
avustaa	помощь
käytös	поведение
sisälsi	содержащиеся
lainsäädäntö	законодательство
kutsumus	призвание
parametrit	параметры
profiilit	профили
asioissa	вопросы
talot	дома
ohjaimet	управления
Yhdistetty	комбинированный
perimmäinen	окончательный
edustaja	представитель
vähäinen	незначительный
osastot	ведомства
asukkaat	жители
näyttöön	отображается
äiti	Мама
pelkistetty	уменьшенный
harvinainen	редкий
suoritettu	выполнено
äärimmäinen	экстремальный
näytteet	образцы
baarit	брусья
ennuste	прогноз
poistettu	удален
sykli	цикл
sisältää	содержать
tarkkuus	точность
nukkua	спать
mg	мг
lintu	птица
apteekki	аптека
luominen	создание
staattinen	статический
metsästäjä	охотник
osoitteet	адреса
nainen	леди
kristalli	кристалл
kuuluisa	известный
kirjailija	писатель
puheenjohtaja	председатель
juoda	напиток
akatemia	академия
dynaaminen	динамический
syödä	есть
pysyvä	постоянный
puhdistus	уборка
muodostaa	составляет
salkku	портфолио
käytännöllinen	практическое
toimitetaan	доставлен
infrastruktuuri	инфраструктура
väri	цвет
myyjä	продавец
filosofia	философия
säätö	регулирование
upseerit	офицеры
tavoite	цель
tarjouksia	предложения
ravitsemus	питание
äänite	запись
nuorempi	младший
les	ле
viitta	мыс
renkaat	кольца
kärki	наконечник
ihana	замечательно
lippu	билет
ilmoitti	объявленный
arvaus	Угадай
ketä	кого
jalkapallo	футбольный
matematiikka	математический
tuonti	Импортировать
komennus	проводка
läsnäolo	присутствие
Automaattinen	автоматический
katselu	просмотр
säilyy	поддерживается
ch	ч
dan	Дан
koirat	собаки
johtajat	директора
näkökohdat	аспекты
eteenpäin	впереди
kuu	Луна
osallistumista	участие
ohjelma	схема
lentää	летать
tapa	манера
matriisi	матрица
yhdistelmä	сочетание
muutos	поправка
vahvuus	прочность
Turkki	Турция
kirjastot	библиотеки
asianmukainen	правильный
astetta	степени
yrityksille	предприятия
delta	дельта
pelko	страх
etsiä	Ищу
tuumaa	дюймов
sopimus	условность
osakkeiden	акции
pääasiallinen	главный
mukavuus	комфорт
värit	цвета
sodat	войны
tilaaminen	заказ
säilytetään	хранится
alfa	альфа
valitus	обращение
risteily	круиз
bonus	бонус
Hei	Привет
rakennukset	здания
tarjoukset	скидки
lyödä	бить
akut	батареи
tulee	становится
asemat	диски
aseet	оружие
tee	чай
parantunut	улучшен
saavuttaa	достигать
kannat	позиции
pukeutua	платье
tilaus	подписка
jakaja	дилер
nykyajan	современный
taivas	небо
rom	ПЗУ
kuljettaa	осуществляется
valotus	воздействие
piilottaa	скрывать
allekirjoitus	подпись
mylläri	мельник
säännös	обеспечение
vaatteet	одежда
kehyksiä	кадры
varmasti	безусловно
sanomalehti	газета
lelu	игрушка
kerros	слой
painettu	печатные
hidas	медленный
poistaminen	удаление
vastuu	ответственность
tulostimet	принтеры
lisäämällä	добавление
täplä	место
viettää	проводить
tehdas	завод
sisusta	интерьер
kasvaa	расти
optinen	оптический
edistäminen	продвижение
suhteellinen	относительный
hämmästyttävä	удивительно
piste	точка
identiteetti	идентичность
muuntaminen	преобразование
tunne	чувство
kätketty	скрытый
kohtuullinen	разумный
tarkistus	пересмотр
vaikutus	влияние
suhde	соотношение
merkitys	важность
sade	дождь
planeetta	планета
kappaletta	копии
lupa	разрешать
koska	видя
todiste	доказательство
basso	бас
resepti	рецепт
tyhjä	пустой
ilmentymä	пример
reikä	дыра
ratsastaa	поездка
toimisto	бюро
säilyttäminen	сохранение
pari	пара
ihanteellinen	идеальный
silmälasit	функции
tallennettu	записанный
Don	дон
kappaletta	куски
päättynyt	законченный
puistot	парки
lakimiehet	адвокаты
stressi	стресс
kerma	крем
ss	сс
ajot	работает
löytää	обнаружить
ap	ар
kuviot	узоры
Hills	холмы
nm	нм
neuvonantaja	консультант
tietoinen	знать
muoto	форма
evoluutio	эволюция
todistukset	сертификаты
tavoitteet	цели
asemat	станций
ehdotti	предложенный
op	оп
jäännökset	остатки
yritykset	фирмы
euro	евро
operaattori	оператор
rakenteet	сооружения
yleinen	общий
tietosanakirja	энциклопедия
käyttö	Применение
muste	чернила
sekoitettu	смешанный
väestönlaskenta	перепись
pyörä	колесо
toimittajat	поставщики
kompakti	компактный
runous	поэзия
valot	огни
seuranta	отслеживание
enkeli	ангел
valmistautuminen	подготовка
yrittää	попытка
vastaanotetaan	получение
Ottelut	Матчи
mukaisesti	соответствие
leveys	ширина
moottorit	двигатели
unohtaa	забывать
ryhmä	массив
keskusteltiin	обсуждается
tarkka	точный
ilmasto	климат
kreikkalainen	греческий
ohje	инструкция
hallinnassa	управление
raaka	сырье
erot	различия
selittää	объяснять
perustaa	установить
ilmaisi	выраженный
laajuus	степень
terävä	острый
ben	Бен
kohta	параграф
tappaa	убийство
matematiikka	математика
korvaus	компенсация
viedä	экспорт
johtajat	менеджеры
moduulit	модули
suoritettu	проведены
versiot	версии
tietää	знает
kuvata	описывать
kansalaiset	граждане
perintö	наследие
vaivata	беда
valmentaja	тренер
maatalous	сельскохозяйственное
laajentaa	расширять
yleisö	аудитория
osoitettu	назначенный
kokoelmat	коллекции
iät	возраст
asiantuntija	специалист
kokki	готовить
vaikuttaa	аффект
Neitsyt	девственница
kokenut	опытный
tutkimus	расследование
nosti	поднятый
hattu	шапка
instituutio	учреждение
suunnattu	направленный
vaikuttaa	пострадавших
pyörä	велосипед
täysin	полностью
levy	пластина
kulut	затраты
osoittaa	указывать
vaalea	блондинка
menettely	производство
suosikki	любимый
ominaisuudet	характеристики
der	дер
menettää	потерять
orgaaninen	органический
etsiä	искать
kokemukset	опыт
albumit	альбомы
sopimuksia	контракты
vieraita	гости
isännöi	состоялся
sairaudet	болезни
koskevat	относительно
vastaava	эквивалент
kemia	химия
sarjat	комплекты
logiikka	логика
prinssi	принц
ympyrä	круг
maaperä	почва
psykologia	психология
märkä	влажный
olosuhteet	обстоятельства
sijoittaja	инвестор
perus	элементарный
sponsorit	спонсоры
kettu	лиса
rajoittamaton	неограниченный
vastata	отвечать
koot	размеры
tavallinen	гладкий
poistuminen	Выход
käsivarsi	рука
näppäimet	ключи
Aalto	волна
pyhä	святой
säädökset	акты
opastus	руководство
polku	след
symboli	символ
valtatie	шоссе
havaitun	наблюдаемый
dekaani	декан
perustaa	настроить
äänestys	голосование
tyylit	стили
täynnä	заполненный
side	связь
kanavat	каналы
liite	приложение
suklaa	шоколад
osa	часть
laajuus	объем
toimittaja	поставщик
kaapelit	кабели
puuvilla	хлопок
vaatimus	требование
surmattu	убитый
reunus	граница
muinainen	древний
keskustelu	обсуждение
edustajia	представители
alkaa	начинается
raskaus	беременность
nähtävyydet	достопримечательности
oppinut	научился
liiketoimet	операции
tutkimusmatkailija	исследователь
historiallinen	исторический
aviomies	муж
valtuutettu	уполномоченный
hullu	псих
tuleva	предстоящий
konsertti	концерт
tulokset	множество
tehokkuus	эффективность
komedia	комедия
hyväksyttiin	принят
tehokas	эффективное
lineaarinen	линейный
sitoutuminen	обязательство
erikoisuus	специальность
karhut	медведи
hypätä	хмель
kantaja	перевозчик
jatkuva	постоянная
Visa	виза
suu	рот
mittari	метр
sidoksissa	связанный
haastattelut	интервью
käsitteet	концепции
ase	пистолет
heijastaa	отражать
puhdas	чистый
helvetti	ад
hedelmä	фрукты
alkaa	начинается
pätevä	квалифицированный
uudistaa	реформа
linssi	объектив
käsitelty	обрабатывали
löytö	открытие
piirtää	привлечь
luokiteltu	объявление
olettaa	предполагать
liitto	союз
vahvistaa	подтвердить
insinööri	инженер
johdonmukainen	последовательный
korvata	замещать
raivaaminen	зазор
muunnin	конвертер
organisaatio	организация
tyttö	младенец
tarkastuksia	проверки
saavuttanut	достиг
tulossa	становление
tavoite	задача
osoitettu	указанный
sokeri	сахар
miehistö	экипаж
jalat	ноги
tikku	придерживаться
suhde	связь
käytössä	включен
laji	жанр
vapaaehtoinen	доброволец
takaosa	задний
demokraattinen	демократической
parantaa	усилить
tarkka	точный
sidottu	связанный
parametri	параметр
suoritin	процессор
solmu	узел
muodollinen	формальный
myrsky	буря
mikro	микро
oppilaitokset	колледжи
maili	мили
haasteet	проблемы
Editors	редакторы
ylin	высший
veljet	братья
tunnustus	признание
viite	ссылка
arvio	оценить
lapsi	дитя
tarkastus	осмотр
kuluttajien	потребители
rajoja	пределы
alue	территория
aseet	оружие
viive	задержка
lentäjä	пилот
maksut	взносы
jatkuva	непрерывный
aloite	инициатива
uusi	роман
suoritus	выполнение
vammaisuus	инвалидность
ultra	ультра
voittaja	победитель
episodi	эпизод
savenvalaja	гончар
ruokalaji	блюдо
pelaa	игры
tiedotuslehti	бюллетень
ia	Айова
muuttaa	модифицировать
todella	действительно
maailmankaikkeus	вселенная
ehdokas	кандидат
aukko	слот
maksamatta	выдающийся
ha	ха
suunnitellut	планируемый
jättää	домик
peili	зеркало
turnaus	турнир
harkinta	рассмотрение
istuntoja	сессий
ydin	ядро
ostajien	покупатели
lehdet	журналы
harmaa	серый
luettelo	каталог
peritään	заряженный
laaja	широкий
und	унд
valittu	выбранный
esittely	демонстрация
vihata	ненавидеть
pääte	Терминал
julkaisijat	издатели
öisin	ночью
neste	жидкость
riisi	рис
varaus	бронирование
elintarvikkeet	продукты
vartija	охрана
tallentaa	экономия
imperiumi	империя
hiljattain	вновь
nostaa	повышение
laiton	нелегальный
laajeneminen	расширение
johtava	премьер
huomenna	завтра
maito	молоко
draama	драма
vierailevat	посещение
kilpailu	конкурс
koottu	собранный
bändejä	группы
sopiva	подходящее
ehdottomasti	абсолютно
tarkastaa	аудит
kammio	камера
Guinea	Гвинея
tulokset	Выводы
ISO	ISO
tyypillinen	типичный
summa	сумма
kana	курица
tilapäinen	временный
käydä	посещать
suihku	душ
lähettäminen	отправка
riittävä	достаточно
kuori	оболочка
maakunta	провинция
katolinen	католик
kuvernööri	губернатор
olut	пиво
panos	вклад
kaava	формула
perustuslaki	конституции
pakkaus	упаковка
luotettava	надежный
epäillä	сомнение
ansaita	зарабатывать
aikoja	периодов
iskut	нападки
kauppatavara	товар
oireet	симптомы
muistomerkki	мемориал
twin	близнец
lisätä	вставить
portti	шлюз
piirustus	Рисование
ehdokkaat	кандидаты
tilasi	приказал
biologinen	биологический
taistelevat	борьба
siirtyminen	переход
mieltymykset	предпочтения
vakooja	шпион
romanssi	романс
väline	инструмент
jakaa	Трещина
teemat	темы
valtuudet	полномочия
taivas	небо
bitit	биты
raskaana	беременная
luokittelu	классификация
keskittynyt	сосредоточены
lääkäri	врач
pyytäminen	просить
lohkot	блоки
katso	вот
hengellinen	духовный
diabetes	диабет
ml	мл
siirtää	сдвиг
istua	сидеть
elinten	тела
valokuvat	фотографии
leikkaus	резка
kirjailijat	писатели
joustava	гибкий
rakastettu	любимый
suosikit	избранное
kartoitus	отображение
useat	многочисленные
suhteellisesti	относительно
edustaa	представляет
esimies	превосходящий
edullinen	предпочтительным
tallennettu	сохранены
älyllinen	интеллектуальной
myönnetty	предоставляется
hiili	углерод
mukava	удобный
magneettinen	магнитные
vuorovaikutus	взаимодействие
kuuntelee	прослушивание
kriisi	кризис
näkymät	прогноз
massiivinen	массивный
kirkas	яркий
muodostettu	сформированный
piano	пианино
kaiku	эхо
vallankumous	революция
näytöt	дисплеи
plasma	плазма
tulot	прибыль
mysteeri	тайна
maisema	пейзаж
mekaaninen	механический
matka	поездка
lippu	баннер
kuva	инжир
maakunnat	графств
hankinta	получение
tunnistettu	признанное
unelmat	мечты
ilmoitus	уведомление
kg	кг
opettaa	учат
nopea	быстрый
Vedä	вытащить
ut	Юта
seminaari	семинар
investoinnit	вложения
pyörät	колеса
eritellä	указывать
herkkä	чувствительный
malleja	шаблоны
formaatit	форматы
pitää	держит
reititin	маршрутизатор
betoni	бетон
si	си
kansio	папка
valmistuminen	завершение
pulssi	пульс
tekniikka	техника
äänestys	голосование
tuomioistuimet	суды
muunnettu	переоборудованный
metro	метро
vuosipäivä	Годовщина
parannuksia	улучшения
kaistale	полоса
määrittely	Спецификация
onnettomuus	авария
lovi	Ник
saatavilla	доступной
asukas	резидент
juoni	сюжет
tyypillisesti	типично
edustus	представление
pumppu	насос
olemassa	существует
järjestelyt	договоренности
konferenssit	конференций
kulutus	потребление
kapea	узкий
uhkaus	угроза
tutkimukset	опросы
istuva	сидящий
konsultti	консультант
ohjain	контроллер
valiokunnat	комитеты
penis	пенис
linna	замок
puutarhat	сады
tarrat	этикетки
halukas	готовы
bio	био
näytteleminen	действующий
päät	руководители
koe	экзамен
asuinpaikka	резиденция
tiheys	плотность
sata	сто
outo	странный
kestävä	устойчивый
tilastollinen	статистический
mainita	упомянуть
innovaatio	инновация
harmaa	серый
rinnakkainen	параллельно
toimia	работать
setelit	банкноты
vakaa	стабильный
määritelmät	определения
von	фон
lääkärit	врачи
oppitunti	урок
elokuva	кино
vaalit	выборы
reaktio	реакция
tyhjä	пустой
tehostettu	повышенная
oikeutettu	озаглавленный
vaikea	серьезный
Tuottaa	генерировать
sanomalehdet	газеты
sairaalat	больницы
vi	VI
huumori	юмор
ikäinen	престарелый
näytöt	мониторы
poikkeus	исключение
kesto	продолжительность
pääosa	насыпной
käyntiä	посещения
kyvyt	возможности
suositus	рекомендация
synti	грех
järjestetty	организованная
ba	ба
kappale	пункт
hyväksyminen	принятие
parantaminen	улучшение
kallis	дорогая
puhveli	буйвол
organisaatioiden	организации
kone	самолет
ohjelmat	программы
mekanismi	механизм
ee	й
merkitty	отмеченный
ajettu	управляемый
pullo	бутылка
innovatiivinen	инновационный
hieronta	массаж
johtopäätös	вывод
sulkeminen	закрытие
tuhat	тысяча
legenda	легенда
huvila	вилла
luu	кость
pylväät	столбцы
häiriöt	расстройства
yhteistyö	сотрудничество
havaitseminen	обнаружение
sisäinen	внутренний
muodostus	образование
med	мед
insinöörien	инженеры
kokonaisuus	организация
risteilyt	круизы
portti	Ворота
roomalainen	Римский
tehtävät	обязанности
eroottinen	эротический
sävy	тон
etiikka	этика
lohikäärme	Дракон
kiireinen	занятый
kapteeni	капитан
tuo	приносит
lämmitys	обогрев
jalka	ножка
niska	шея
siipi	крыло
skriptejä	скрипты
ABC	азбука
nimitetty	назначенный
tekemisissä	дело
sitoutumaan	совершить
kisko	рельс
matkat	поездки
aukko	разрыв
sivut	стороны
putki	трубка
vastaava	соответствующий
kuvaukset	описания
vyö	ремень
takki	куртка
animaatio	анимация
oraakkeli	оракул
er	эр
tuotannot	производства
ilmailu	авиация
ylpeä	гордый
katastrofi	катастрофа
konsoli	консоль
komennot	команды
jr	младший
tietoliikenne	связь
ohjaaja	инструктор
jättiläinen	гигант
saavutettu	достигнутый
vammat	травмы
lähestymistavat	подходы
tavallinen	обычный
postimerkkejä	Марки
kulma	угол
ryöstää	грабить
suunnittelijat	дизайнеры
vapaus	свобода
aikakausi	эпоха
muuntaa	конвертировать
mahdollisuus	возможность
analyytikko	аналитик
vaarallinen	опасно
luotettavuus	надежность
vastaavasti	соответственно
vapaaehtoiset	добровольцы
johdettu	полученный
ilo	удовольствие
kunnia	честь
suuntautunut	ориентированного
kotka	орел
rukous	молитва
työpajat	мастерские
Hurrikaani	ураган
hiljainen	тихо
tuottaja	режиссер
edustettuina	представленный
vastuut	обязанности
juusto	сыр
huolellisesti	внимательно
tuottavuus	производительность
kruunu	корона
par	паритет
diagnoosi	диагностика
valmistaja	производитель
crack	трещина
periaate	принцип
poimii	кирки
jengi	банда
fetissi	фетиш
ulkomuoto	появление
savu	дым
suodattimet	фильтры
yhdistetty	включенный
alus	ремесло
kaveri	человек
sokea	слепой
aula	гостиная
hullu	Сумасшедший
algoritmi	алгоритм
voimakkaasti	сильно
kahvila	кафе
ken	кругозор
proteiineja	белки
su	су
tuttu	знакомые
kykenevä	способный
pääsy	вход
kenkä	башмак
valittiin	избран
kuljettaa	проведение
terrorismi	терроризм
ilo	радость
painokset	издания
etninen	этнической
eduskunta	парламент
näyttelijä	актер
löydöt	находки
tiiviste	печать
tilanteita	ситуации
viides	пятый
kansalainen	гражданин
pystysuora	вертикальный
korjaukset	поправки
kuvailee	описывает
vammaiset	инвалидов
aine	вещество
kielletty	запрещено
putki	труба
sotilaat	солдаты
holhooja	опекун
luento	лекция
simulointi	моделирование
layout	расположение
aloitteita	инициативы
sairas	больной
keskittyminen	концентрация
asettaa	прокладывать
tulkinta	интерпретация
likainen	грязный
opettanut	учил
työntekijä	работник
optimointi	оптимизация
temppeli	храм
aineet	вещества
todistaa	доказывать
löydetty	обнаруженный
siivet	крылья
geneettinen	генетический
rajoituksia	ограничения
ohut	тонкий
näyttely	выставка
harjanne	хребет
modeemi	модем
tuoden	приведение
sairas	больной
arvioida	оценивать
trooppinen	тропический
kerätä	собирать
vektori	вектор
ehdottomasti	определенно
kääntyminen	превращение
olemassaolo	существование
selostus	комментарий
kehitys	события
maahanmuutto	иммиграция
kohteet	направления
keskinäinen	взаимное
syntaksi	синтаксис
li	литий
ominaisuus	атрибут
vankila	тюрьма
taito	умение
tuolit	стулья
ympäröivä	окружающих
vuoret	горы
suosio	популярность
tiedustelu	запрос
tarkistettu	проверено
näyttely	экспонат
heittää	бросать
trendi	тенденция
kissat	коты
aavikko	пустыня
ya	я
koordinaattori	координатор
elohopea	Меркурий
palaa	сжигание
paeta	побег
vastaanotin	получатель
etenevä	прогрессирующий
veneet	лодки
mestaruus	чемпионат
arkadi	аркада
mahdoton	невозможно
kertoo	говорит
ilmeinen	очевидный
masennus	депрессия
kaavio	график
päällyste	покрытие
platina	платина
tuomio	суждение
neuvottelut	переговоры
arkistointi	подача
edistää	способствовать
palkittiin	награжден
tutkimuksissa	испытания
Masters	мастера
patruuna	картридж
selitys	объяснение
Org	организация
petos	мошенничество
sähkö	электричество
spektri	спектр
saapuminen	прибытие
keramiikka	керамика
painotus	акцент
mahtava	здорово
vahvistettu	подтвердил
laskee	счетчики
romahdus	авария
hissi	лифт
inter	между
korkeudet	высоты
varjo	тень
kulu	расходы
hanke	предприятие
klinikka	клиника
paranemista	исцеление
prinsessa	принцесса
kirjoittamalla	входящий
paketti	пакет
studiot	студии
osallistuminen	участие
isä	папа
painikkeet	кнопки
sijoitus	размещение
havainnot	наблюдения
voittajat	победители
tiet	дороги
myöhempi	последующий
piha	двор
julkistaminen	раскрытие
perustaminen	создание
muistoja	воспоминания
te	тэ
luo	создает
kasvoja	лица
turisti	турист
murhata	убийство
riittävä	адекватный
senaattori	сенатор
esitykset	презентации
sulattaa	дайджест
pöly	пыли
wiki	вики
vaihdettu	заменены
tutka	радиолокационный
tappiot	потери
taistelu	бой
vähentäminen	сокращение
pysäytetty	остановился
ammatti	занятие
tarkasti	тесно
säteily	излучение
kuninkaat	короли
ammunta	стрельба
korva	ухо
liput	флаги
leipuri	пекарь
konservatiivinen	консервативный
järkyttää	шок
tehokkuuden	эффективность
solmio	галстук
katto	крыша
osoittaa	демонстрировать
ilmapiiri	атмосфера
suudella	поцелуй
peto	зверь
ra	ра
toimi	управляемый
koe	эксперимент
tavoitteet	цели
ostot	покупки
liittovaltio	федерация
pizza	пицца
kutsuttu	приглашенный
toimeksianto	назначение
mod	модификация
kyselyt	запросы
poissaolo	отсутствие
myyjät	поставщики
jooga	йога
palvelee	служит
yllätys	сюрприз
lamppu	лампа
vitsit	шутки
neuvonta	консультирование
palatsi	дворец
vakuuttunut	доволен
voittoa	победы
varasto	склад
oletettu	предполагаемый
tavallinen	обычный
aave	призрак
rikkominen	нарушение
pomo	босс
ylpeys	гордость
odotukset	ожидания
itsenäisyys	независимость
tietäen	знание
reportteri	репортер
aineenvaihdunta	метаболизм
mestari	чемпион
henkilökohtaisesti	лично
paljon	много
soolo	соло
kurkku	горло
rikkaus	богатство
tyhjiö	вакуум
tanssi	танцы
tunnistaa	признать
kirjoittaa	пишет
aukio	площадь
etsintä	поиск
julkaista	публиковать
seulonta	скрининг
trans	транс
pioneeri	пионер
unohdettu	забытый
akrobaatti	акробат
levyt	тарелки
esseitä	эссе
käytös	поведение
kertominen	говоря
melko	довольно
älykäs	умный
tilat	режимы
vaatimus	обязательство
satama	гавань
matkustaja	путешественник
segmentti	сегмент
vihollinen	враг
palapeli	головоломка
kaivot	углубления
rajoitettu	ограниченный
tasavaltalainen	республиканец
salaisuudet	секреты
oireyhtymä	синдром
läsnäolo	посещаемость
rangaistus	штраф
rumpu	барабан
mahdollistaa	позволяет
rakentaja	строитель
näköala	перспектива
tulva	наводнение
helppous	легкость
argumentit	аргументы
areena	арена
seikkailuja	приключения
oppilaat	зрачки
ilmoitus	объявление
tulokset	исход
arvostaa	ценить
laajennettu	расширенный
täysikasvuinen	взрослый
ihana	прекрасный
keskuksissa	центры
lauseke	пункт
hymy	улыбка
maat	земли
joukot	войска
aseistettu	вооруженный
mänty	сосна
jäähdytys	охлаждение
kuilu	залив
autot	грузовики
mekanismit	механизмы
avioero	развод
perinne	традиция
pillereitä	таблетки
tiikeri	тигр
ihmiset	люди
sensori	датчик
avoin	подвергаются
metsästää	охота
enkelit	ангелы
sijainen	заместитель
thaimaalainen	тайский
päästöt	выбросы
lääkärit	врачи
valitus	жалоба
kohtaukset	сцены
kokeiluja	эксперименты
edistää	увеличение
hallintotavan	управление
mylly	мельница
perustettu	основанный
krooninen	хронический
den	логово
sormi	Палец
pitää	держит
punta	фунт
paikantaa	разместить
pl	пл
koulutettu	обученный
toteuttamisessa	реализации
leipä	хлеб
moottorit	моторы
kova	жесткий
tapaus	инцидент
dynamiikka	динамика
valehdella	ложь
keskustelu	разговор
pienentää	снижение
palvonta	поклонение
valmiudet	возможность
ak	Аляска
tarkkuus	точность
vahingonkorvaus	убытки
varaukset	резервы
ratkaista	решать
vähemmistö	меньшинство
monipuolinen	разнообразный
ainekset	ингредиенты
Ah	ах
sävyt	тоны
kuntoutus	реабилитация
näky	взгляд
savi	глина
heikko	слабый
jaettu	разделенный
vastaanotto	прием
viisas	мудрый
todennäköisyys	шансы
seminaarit	семинары
seuraukset	последствия
päättäjille	производители
maantiede	география
eheys	целостность
perintö	наследие
tyytyväinen	довольный
vaara	Опасность
vitamiini	витамин
jalostettu	обработанный
fraasi	фраза
nostaminen	привлечение
vaikutukset	последствия
toiminnallisuus	функциональность
paratiisi	рай
hybridi	гибридный
lukee	читает
tunteellinen	эмоциональный
kunnia	слава
ja	JA
maantieteellinen	географический
ylittää	превышать
sauva	стержень
silkki	шелк
vauvat	дети
bi	би
romanttinen	романтик
paljastui	показал
asiantuntijat	специалисты
generaattori	генератор
jousitus	подвеска
surullinen	грустный
korjaus	коррекция
susi	волк
hitaasti	медленно
täydentää	дополнение
osat	участки
pikkulasten	младенец
aloilla	секторов
neste	жидкость
perusteet	основания
ateria	еда
ta	та
koneet	машины
yhtälö	уравнение
korit	корзины
todennäköisyys	вероятность
ulottuvuus	измерение
tutkittu	изучал
voitot	доходы
paholainen	дьявол
ruoho	трава
kuvitettu	иллюстрированный
kirsikka	вишня
mannermainen	континентальный
saavutus	достижение
rajoituksia	ограничения
hautajaiset	похороны
luvuissa	главы
matkustaja	пассажир
mukava	удобный
Mars	Марс
kokoinen	размера
muna	яйцо
signaalit	сигналы
suuntautuminen	ориентация
varkaus	кража
lapsuus	детство
symbolit	символы
lat	Lat
meta	мета
analoginen	аналоговый
lahjakkuus	талант
päivätty	датированный
viisaus	мудрость
raja	граница
eliitti	элита
gi	солдат
uskoo	считает
runoja	стихи
toimivalta	юрисдикция
robotti	робот
näyttämällä	отображение
todistaja	свидетель
varustettu	оборудованный
vaiheet	этапы
sur	сюр
hankittu	приобретенный
arvioida	оценить
pestä	мыть
Sisäänkäynti	вход
ilmoitus	декларация
menettää	проигрыш
yrityksiä	попытки
jalo	благородный
automaatio	автоматизация
vaikutukset	воздействие
kierros	оборот
edut	преимущества
ritari	рыцарь
tavoitteet	цели
laajennukset	расширения
valitukset	апелляции
sairaus	болезнь
ho	эй
vaihtoehtoja	альтернативы
sh	ш
saippua	мыло
hillo	варенье
epätavallinen	необычный
vastasi	ответил
tuho	разрушение
muutto	миграция
häiriö	расстройство
tavanomainen	обычный
yllään	носить
akseli	ось
pyrittiin	искать
geenit	гены
mediaani	медиана
skanneri	сканер
tässä	здесь
eloisa	мультипликационный
säätö	регулировка
sankari	герой
hoidot	лечение
asenne	отношение
matto	ковер
linssit	линзы
osallistui	участие
vaikeus	трудность
punk	панк
koalitio	коалиция
rekisteröinti	регистрация
herttua	герцог
vauhti	темп
tuottajia	производители
kaari	дуга
rajapinnat	интерфейсы
kartasto	атлас
havainto	наблюдение
kiduttaa	пытки
Poistetaan	удаленный
takki	Пальто
entisöinti	восстановление
sopivuus	удобство
palaavat	возврате
oppositio	оппозиция
kontti	контейнер
vastaaja	ответчик
valvoja	руководитель
joukot	корпус
toimijoiden	актеры
maksa	печень
velvollinen	подлежащий
adressi	петиция
antenni	антенна
poimitaan	выбрал
uskomus	вера
tappaminen	убийство
olkapää	плечо
sisustus	оформление
ioni	ион
halkaisija	диаметр
podcast	подкаст
vuorovaikutukset	взаимодействия
laulaja	певец
airut	вестник
vanheneminen	старение
interventio	вмешательство
kytkeä	плагин
vetovoima	Привлечение
sukellus	дайвинг
muutos	модификация
olettaa	предполагать
ruoko	тростник
sisältää	включать
kohtalainen	умеренный
hiiret	мышей
ymmärsi	понимать
nopeasti	быстро
kieltää	запрет
varmuus	гарантия
happening	происходит
valtava	огромный
myllyt	мельницы
ääriviivat	контур
vastaanottaa	получает
farkut	джинсы
kokoelma	сборник
outo	странный
sigma	сигма
gr	гр
viehättävä	привлекательный
tilaisuus	повод
tallenteet	записи
uhri	жертва
vaatii	требования
varovainen	осторожный
palkki	луч
puutarhanhoito	садоводство
velvoitteet	обязательства
saapua	прибыть
orkesteri	оркестр
lisenssi	лицензия
säädettävä	регулируемый
jako	распределение
essee	сочинение
osoittivat	продемонстрировал
vuoropuhelu	диалог
leirit	лагеря
julistettu	объявленный
jäljittää	след
sulkea	закрыть
pakkauksissa	пакеты
ge	GE
asennus	установка
kytkimet	переключатели
vapaaehtoinen	добровольный
sinä	ты
suuresti	значительно
ng	нг
yleisesti	обычно
pe	ре
valokuvaaja	фотограф
itkeä	плакать
kvantti	квант
rakennettava	построенный
lisäykset	дополнения
edellyttävät	требующий
nuoli	стрела
sitoumus	помолвка
karkea	грубый
outo	странный
leijona	лев
häät	свадьбы
happi	кислород
kanjoni	каньон
metriä	метры
vain	просто
kalenterit	календари
järjestely	договоренность
päätelmät	выводы
bibliografia	Библиография
osoitin	указатель
yhteensopivuus	совместимость
venyttää	протяжение
luvat	разрешения
osuuskunta	кооператив
ruokinta	кормление
kauppala	городок
rankingissa	рейтинги
mittaus	измерения
hihna	ремень
väkijoukko	толпа
siirrot	переводы
olympia	олимпийский
muutos	преобразование
dir	реж
tulli	обычаи
ylläpitäjät	администраторы
persoonallisuus	личность
koukku	крюк
ruletti	рулетка
aleneminen	снижение
johto	шнур
pilvi	облако
helpottaa	содействовать
Val	вал
selittää	объясняет
edetä	продолжить
tunteet	чувства
veitsi	нож
hyväksyä	принять
evätty	отказано
lahjoitus	пожертвование
ulompi	внешний
sato	культура
joet	реки
solmut	узлы
mainittu	цитируется
napa	хаб
kohdennettu	целевое
tajusi	понял
perustaja	основатель
vuosikymmen	десятилетие
riita	спор
väsynyt	устала
haitallinen	неблагоприятный
ote	выдержка
purkaa	разряд
juomat	напитки
ässä	туз
äänet	голоса
kiipeily	альпинизм
tonnia	тонны
hajuvesi	духи
vaarallinen	опасный
palauttaa	восстановить
pino	стек
metodologia	методология
maine	репутации
demokraatteja	демократы
ripustaa	вешать
käyrä	кривая
luoja	создатель
keltainen	янтарный
museot	музеи
koodaus	кодирование
seuraaja	трекер
vaihtelu	изменение
kulku	прохождение
siirretty	переданы
runko	хобот
valokuva	фотография
aallot	волны
kameli	верблюд
jakelija	распределитель
chi	чи
keräys	сбор
projektio	проекция
matemaattinen	математическая
looginen	логический
kastike	соус
kuuluisuus	известность
erikoistunut	специализированный
yritykset	корпорации
kritiikki	критика
auto	автомобиль
tuomarit	судьи
huomautukset	замечания
havaittu	обнаруженный
maalaukset	картины
käveli	ходил
aiheutuvat	возникающий
populaatiot	популяции
peloissaan	боюсь
akustinen	акустическое
kasetti	кассета
indikaattori	индикатор
jpg	JPG
virhe	ошибка
poistaa	Устранить
mineraali	минеральная
rubiini	Рубин
helmet	бисер
onni	состояние
kangas	холст
kynnys	порог
seurakunta	приход
näytöt	экраны
hautausmaa	кладбище
stadion	стадион
tutkiminen	исследование
min	мин
varsi	стебель
tähtitiede	астрономия
kilpailut	конкурсы
flunssa	грипп
puku	костюм
polkupyörää	велосипеды
piispa	епископ
veti	вытащил
maissi	кукуруза
puristus	компрессия
perustamisesta	налаживание
viljelijä	фермер
tina	банка
orja	рабыня
heti	немедленно
valmennus	тренировка
tutkitaan	рассмотрел
koodaus	кодирование
huomautukset	Доводы
sankareita	герои
maalannut	окрашенный
muotokuva	портрет
terroristi	террорист
eettinen	этический
harjoittajat	носители
liikkuvuus	мобильность
taistelu	борьба
järjestelmiä	схемы
kärsimys	страдающий
neutraali	нейтральный
kalastaja	рыболов
rotta	крыса
keihäitä	копья
tuloaan	присоединение
otsikko	заголовок
keinotekoinen	искусственный
laakeri	подшипник
mahtava	захватывающий
maailmoja	миры
syyllinen	виновный
aktivointi	активация
satama	убежище
tabletti	таблетка
tuomaristo	жюри
dos	DOS
pyrstö	хвост
viehätys	очарование
väkivaltainen	насильственный
mahdollisesti	потенциально
karjatila	ранчо
rajoitteet	ограничения
ylitys	скрещивание
täydellinen	включительно
mökki	коттедж
humalassa	пьяный
huomattava	значительный
rikokset	преступления
ratkaistu	решены
tavu	байт
nenä	нос
oksat	ветви
ulkomaalainen	инопланетянин
prosessorit	процессоры
mursi	сломал
monimutkaisuus	сложность
alituisesti	постоянно
ratkaista	разрешить
alueiden	территории
tutkielma	Тезис
levyt	диски
tiheä	частый
katto	потолок
pikseliä	пикселей
gen	поколения
ruutu	бриллианты
laivasto	флот
kimppu	гроздь
teoreettinen	теоретический
lähete	направления
lopettaa	уволиться
protokollat	протоколы
keuhko	легкое
korvike	замена
loistava	блестящий
ti	ти
geeli	гель
puhuttu	разговорный
omega	омега
arvioitu	оценивали
jäi	остались
näkee	видит
päättyminen	прекращение
katsoi	смотрели
kotitalouksien	домохозяйства
lunastaa	выкупать
jyvä	зерно
järjestelmä	режим
sonni	бык
arkkitehtoninen	архитектурный
erota	отличаться
liikkeet	движения
korjaus	ремонт
hengitys	дыхание
palveluihin	услуги
käytännössä	фактически
kauppapaikka	рынок
kynttilä	свеча
riippuva	подвешивание
värillinen	цветной
tarina	рассказ
ennen	раньше
projektori	проектор
sijaitseva	расположенный
etsii	стремится
tiukasti	строго
psykologinen	психологический
vitamiinit	витамины
tyylikäs	элегантный
voitto	доходы
uusiminen	обновление
sukututkimus	генеалогия
katsotaan	считается
pisteytys	счет
menot	расход
kriitikot	критики
algoritmit	алгоритмы
hakkeri	хакер
salonki	салон
turbo	турбо
parantaa	лечение
ni	п
ajattelee	думает
ehdotus	предложение
sotilas	солдат
pommi	бомбить
vahingoittaa	вред
aikaväli	интервал
peilit	зеркала
tutkia	исследовать
sinun	твой
paneelit	панели
toistettu	повторный
hyökkäys	нападение
Peura	олень
kieli	язык
keilailu	боулинг
tri	три
apina	обезьяна
osa	доля
hame	юбка
analyysit	анализы
piirustukset	рисунки
merkitys	значение
skenaario	сценарий
te	вы
arabialainen	арабский
arvioida	калибр
suojaava	защищающий
kohtasi	сталкиваются
ratkaiseminen	решение
tuottaa	производит
intensiivinen	интенсивный
kahleet	цепи
kuudes	шестой
sitoutua	заниматься
kytkentä	переключение
kirjeenvaihto	переписка
tuonti	импорт
valvonta	надзор
menot	Расходы
erottaminen	разделение
todistus	свидетельство
epäilty	подозреваемый
pakollinen	обязательное
rajoja	границы
juhla	праздник
suodatus	фильтрация
puoliso	супруг
eksoottinen	экзотический
katsoja	зритель
päästäisiin	достижения
nauraa	смех
kirurginen	хирургический
tuhota	уничтожить
lainaus	цитата
yo	Эй
tilat	предпосылки
osoittautui	доказано
hyökkäys	наступление
keisarillinen	имперский
tusina	дюжина
käyttöönotto	развертывание
kangas	ткань
lootus	лотос
lohi	лосось
lasti	грузовой
direktiivi	директива
perämies	приятель
voi	масло
pippuri	перец
ase	оружие
taakka	бремя
nauhat	ленты
vyöhykkeet	зон
saari	островной
hoikka	стройное
vaahtera	кленовый
ruokakauppa	продуктовый
hallitseva	руководящий
varikko	депо
alt	альт
piirakka	пирог
sekoitus	смесь
päästö	излучение
näennäinen	очевидный
neuvonta	учебный
käyttöoikeudet	разрешений
WC	туалет
sijoittui	занимает
reitit	маршруты
asennus	монтаж
sidottu	связанный
tasapainoinen	сбалансированный
myöhässä	задерживается
laakso	дол
laskeminen	расчет
huvilat	виллы
Tilaisuudet	случаи
yhtälöt	уравнения
öljyt	масла
syyskuu	сентябре
poikkeuksellinen	исключительный
levottomuus	тревожность
tila	пространственный
vastaajat	респондентов
näkökohdat	соображения
maksaa	платит
aurinkoinen	солнечно
toimittaa	обеспечивает
je	JE
kaulakoru	ожерелье
yhdistelmä	композитный
lang	языки
teatterit	театры
suunnittelu	проектирование
toivoo	надеется
arvioinnit	оценки
kaavio	диаграмма
jalkineet	обувь
SG	SG
kansojen	народов
voittaja	Виктор
lisenssejä	лицензии
vaihtelee	диапазоны
paria	пары
herkkyys	чувствительность
säilytys	сохранение
yksittäinen	изолированный
väliaikainen	промежуточный
avustaa	помощь
jumalallinen	божественный
hyväksyä	одобрить
yhdiste	соединение
intensiteetti	интенсивность
teknologinen	технологический
abortti	аборт
dialogi	диалог
tapahtumapaikat	центры
räjähdys	взрыв
käsitellään	адресация
napa	столб
kilpi	щит
kalvo	мембрана
epätoivoinen	отчаянный
äidit	матери
esittely	демонстрация
valtiosta	правительственный
valmistettu	изготовлен
kynttilät	свечи
muunnelmat	вариации
äidit	мамы
pyhä	священный
riippuvuus	зависимость
kromi	хром
kieltäytyi	отказалась
jarru	тормоз
ulkopuoli	экстерьер
tervehdys	приветствие
ekologia	экология
laakso	лощина
työttömyys	безработица
sijoitettiin	забил
lisälaite	усиление
klooni	клон
nopeus	скорость
lambda	лямбда
kokoonpanossa	состоящий
kyyneleet	слезы
keidas	оазис
ohjaamo	такси
fa	фа
yhteiskunnissa	общества
pii	кремний
identtinen	идентичный
maaöljy	нефть
kilpailla	конкурировать
ist	IST
rakastaja	любовник
kuulua	принадлежать
huulet	губы
saattaja	эскорт
lampi	пруд
lautta	паром
kani	кролик
ammatti	профессия
pato	дамба
fysiologia	физиология
vientiä	экспорт
Rengas	шина
osallistuja	участник
elektroni	электрон
kuormat	грузы
kanerva	вереск
motelli	мотель
ammattiliitot	союзы
valtiovarainministeriö	казначейство
miehitetty	занятый
asteikot	Весы
rasitus	напряжение
pidätetty	арестованный
tutkimuksia	исследования
sai	получили
pesula	прачечная
saattamisesta	размещение
säätää	регулировать
arvioitu	оценивается
salaus	шифрование
täyte	заполнение
määrätty	наложенный
hiljaisuus	тишина
Neuvostoliiton	советский
hallinta	владение
sopimus	договор
kouluttaja	тренер
urut	орган
sitruuna	лимон
pimeys	темнота
jänneväli	пролет
vitsi	шутка
pakkaus	упаковка
säädös	статут
hylätty	отвергнуто
suoja	укрытие
kappeli	часовня
valmistus	производство
kerroksia	слои
juhlia	праздновать
laite	прибор
seos	смесь
ratsastaja	наездник
säde	радиус
vaikuttava	впечатляющий
lammas	овца
arkkitehti	архитектор
luennot	лекции
viinit	вина
kupit	чашки
tuhka	ясень
avustajat	авторы
salaatti	салат
rikkomuksia	нарушения
lämpötilat	температура
kilpailut	соревнования
säilyttää	сохранять
runo	стих
pysyminen	пребывание
pääsiäinen	Пасха
teoriat	теории
säilytyspaikka	хранилище
virtoja	потоки
lasku	посадка
teloitettiin	выполненный
neuvottelut	переговоры
realistinen	реалистический
kysyy	спрашивает
tiivistelmä	конспект
säveltäjä	композитор
papu	боб
miekka	меч
muutoksia	изменения
koralli	коралловый
pikselin	пиксель
polut	пути
kupla	пузырь
por	Пор
hankkia	приобретать
päinvastainen	вопреки
Tribune	трибуна
alus	судно
hapot	кислоты
virukset	вирусы
tarroja	наклейки
reaktiot	реакции
uskomukset	убеждения
ryhmä	команда
analysoida	анализировать
alueet	подразделения
uida	плавать
nano	нано
konsertit	концерты
urokset	мужчины
säilyttää	сохранить
värit	цвета
suorittaa	выполнять
tunneli	тоннель
tyylilajit	жанры
patentit	патенты
vehnä	пшеница
aikakirjat	летописи
saada	получение
majava	бобр
lukemat	чтения
laajennus	укрупнение
Eagles	орлов
emäkset	основы
syytetty	обвиняемый
kampanjat	кампании
yhtenäisyys	единство
määritellään	определяет
tapauksissa	экземпляры
kotoperäinen	местный
alkaneet	начатый
paketit	пакеты
ankkuri	якорь
sukat	носки
laukaista	вызывать
kolesteroli	холестерин
ero	дифференциал
pinnat	поверхности
kauhea	ужасный
reitittimet	маршрутизаторы
kellot	часы
niveltulehdus	артрит
BIOS	BIOS
naaraat	женщины
heijastaa	отражает
verotus	налогообложение
kuume	лихорадка
keittiö	кухня
varmasti	конечно
harjoittajat	практики
lause	теорема
inflaatio	инфляция
sinua	тебя
yhdisteet	соединений
rummut	барабаны
kohtuullisen	разумно
paljas	голый
radikaali	радикал
suosittelee	рекомендует
valvontaan	управление
aarre	сокровище
liekki	пламя
kuoppa	яма
mono	моно
hiukkasia	частицы
kelluva	плавающий
koordinoida	координировать
yksinomaan	исключительно
rajoitus	ограничение
iski	пораженный
kuva	иллюстрация
varoitukset	предупреждения
rakentaa	сооружать
sovellukset	Программы
kyselyt	запросы
liite	приложение
inspiraatio	вдохновение
rahti	грузовой
pimennys	затмение
vaikuttaa	влияет
ennusteet	прогнозы
havaita	обнаружить
aktiivisesti	активно
monimutkainen	сложно
loukkaantunut	пострадавший
ilmauksia	выражения
tonni	тонна
kuriiri	курьер
vihjeitä	Рекомендации
gif	GIF
konfliktit	конфликты
juoma	напиток
kunnianosoitus	дань
immuuni	иммунный
metsänhoito	лесоводство
rajat	барьеры
kallistus	косяк
harvoin	редко
tarjoukset	предложения
este	барьер
polkupyörä	велосипед
kalusteet	обстановка
nousta	возникать
kelttiläinen	кельтская
hiukkanen	частица
kosteus	влажность
pullot	бутылки
dm	дм
renessanssi	Ренессанс
määräys	постановление
valokuvaajat	фотографы
infektiot	инфекции
shakki	шахматы
toimii	работает
festivaalit	фестивали
mahdollisuuksia	возможности
Ankka	утка
kanava	канал
myötävaikuttaa	способствуя
lehmä	корова
analyyttinen	аналитический
puvut	костюмы
tiukka	строгий
verenkierto	циркуляция
rikkomus	преступление
olettamus	предположение
harraste	хобби
yrittää	пытается
keksintö	изобретение
teknikko	техник
johtajat	руководство
kyselyt	запросы
kognitiivinen	познавательный
tutkia	исследование
temppu	трюк
tiedustelu	запрос
päättäminen	закрытие
puutavara	лесоматериалы
voltti	вольт
voimakas	интенсивный
kannattajat	сторонников
säädökset	статуты
kirjoilla	зачислен
anturit	датчиков
ruuvi	винт
ministerit	министры
julkisesti	публично
kärsi	пострадали
otto	потребление
perhonen	бабочка
mekaniikka	механика
otsikot	заголовки
virheitä	ошибки
numeerinen	численный
määrittelemällä	определяющий
laskenta	подсчет
heijastus	отражение
kutsu	приглашение
natrium	натрий
hormoni	гормон
lasten	детская
tiili	кирпич
pito	рукоятка
keskiaikainen	средневековый
posliini	фарфор
kaapattu	захваченный
kunnollinen	порядочный
valu	Кастинг
käännetty	переведенный
donna	Донна
soturi	воин
hytti	кабина
skannaus	сканирование
poolo	поло
kopiointi	копирование
sarvi	рог
journalismi	журналистика
sammakko	лягушка
kielioppi	грамматика
tarkoitus	намерение
renkaat	шины
toteutetut	проведены
vaara	опасность
jaksot	эпизоды
pyöreä	круговой
suututtaa	гнев
kuvitukset	иллюстрации
mahdollisuudet	шансы
onnellisuus	счастье
outo	эксцентричный
Ur	ур
hedelmät	фрукты
tunnisteen	идентификатор
nauha	лента
laskelmat	вычисления
jpeg	JPEG
aloittaa	запускать
kätevä	удобный
vaihtaa	замена
vapauttaa	освобожденный
viljelykasvien	культуры
vähentää	уменьшает
aikaan	осуществляется
geometria	геометрия
vaikutus	впечатление
kilta	гильдия
korrelaatio	корреляция
sim	сим
hermostunut	нервное
tuoksu	аромат
kopio	копия
heimo	племя
kaupat	сделки
loistava	превосходный
eroon	избавиться
kolminaisuus	Троица
käsiteltävä	обрабатываются
legendoja	легенды
puomi	бум
rauhoittaa	спокойный
Mestarien	чемпионы
lattiat	этажей
valinnat	выборы
verrataan	Сравнение
puhuu	говорит
ammatillinen	профессиональное
apteekit	аптеки
ln	пер
rulla	ролик
erä	партия
järjestää	организовать
Ymmärretään	оценили
muuttaa	изменять
reunat	края
sekoittaminen	смешивание
kahvat	ручки
harmonia	гармония
hienostunut	выдающийся
astma	астма
oletukset	допущения
säännelty	регулируется
kolmio	треугольник
muuttaa	изменить
ennakoitua	ожидаемый
itämainen	восточный
palkinto	награда
vety	водород
vertailukelpoinen	сравнимый
puolestapuhuja	адвокат
sekaannus	путаница
tulot	входные
takuut	гарантии
perimä	геном
mitali	медаль
valmentajat	тренеры
alukset	суд
satama	гавань
Eco	эко
haavoittuva	уязвимый
järjestää	организовать
taiteellinen	художественный
kunnianosoitukset	почести
heijastunut	отраженный
yhdistynyt	унифицированный
rotu	разводить
ilmaisin	детектор
huomiotta	игнорируются
täsmällinen	точный
arviointiin	оценки
huuli	губа
kerätä	собирать
muodostaen	формирование
toimittajat	журналисты
hienoinen	незначительный
epäsuora	косвенный
keskuudessa	среди
perustukset	устои
horisontti	горизонт
nu	ню
syvään	глубоко
velat	обязательства
palkinnot	призы
vähentynyt	снизилась
kuvaava	описывающее
optiikka	оптика
jatkaa	преследовать
salama	молния
ou	ОУ
lainaukset	цитаты
tarkastaja	инспектор
käärme	змея
muistutus	напоминание
etsinyt	поиск
Plains	равнины
oivalluksia	понимание
kyvyt	способности
aloitettu	начатый
karaoke	караоке
ansa	ловушка
yksinäinen	Одинокий
ve	ве
tarkkailla	наблюдать
kontit	контейнеры
asenteet	отношения
marja	ягода
kaulus	воротник
yhdistää	интегрировать
sosiologia	социология
näytteille	экспонаты
kuolee	умирает
terassi	терраса
bakteerit	бактерии
pitäisi	должен
herkullinen	вкусно
perinteet	традиции
rajallinen	конечный
lähettää	посылает
kestävä	прочный
liittoutunut	союзный
kosteus	влажность
muuttaa	преобразование
ajastin	таймер
tabletit	таблетки
saatu	полученный
kasvattajat	воспитатели
vihannes	овощной
jae	стих
itsenäisesti	независимо
kilpailijat	конкуренты
raketti	ракета
kyllä	да
luoti	пуля
tornit	башни
näkyvyys	видимость
leveysaste	широта
tajunta	сознание
kasvain	опухоль
ruma	уродливый
talletukset	депозиты
emäntä	госпожа
kohdata	столкновение
wattia	Вт
neljäkymmentä	сорок
putket	трубы
yritettiin	попытка
pappi	священник
analyytikot	аналитики
vasara	молоток
invaasio	вторжение
juoksija	бегун
riviä	строки
annettuna	вводить
käsite	понятие
oikeinkirjoitus	написание
arktinen	Арктический
palkintoja	награды
alla	под
vahvistaa	укреплять
puolustaa	защищать
infrapuna	инфракрасный
seitsemäs	седьмой
vatsa	живот
aggressiivinen	агрессивный
mainoksia	объявления
neljäsosaa	помещение
varastettu	похищенный
määrittää	определяет
veistos	скульптура
poly	поли
korvat	уши
nyrkki	кулак
neo	нео
motivaatio	мотивация
matkustajien	пассажиров
johdonmukaisesti	последовательно
ylijäämä	избыток
kaivaa	копать
Taksi	такси
arvostus	признательность
om	ом
rajoitus	ограничение
kitarat	гитары
olemus	сущность
mahtava	могущественный
ihmiskunta	человечество
transkriptio	транскрипция
komplikaatioita	осложнения
tutkijat	ученые
galaksi	галактика
huolehtiva	заботливая
testamentti	завещание
hallitseva	доминирующий
vatsa	желудок
osittain	частично
minimoida	минимизировать
rivit	ряды
debyytti	дебют
sukupolvet	поколения
turnaukset	турниры
kieltää	Отрицать
anatomia	анатомия
kuulokkeet	наушники
jae	доля
trio	трио
menettely	судопроизводство
kuutio	куб
vikoja	дефекты
epävarmuus	неопределенность
hajota	сломать
ratkaistu	решен
rokote	вакцина
kohtalo	судьба
varaukset	бронирование
republikaanit	республиканцы
viidakko	джунгли
zen	Дзэн
dIS	дис
ennustus	прогнозирование
ekologinen	экологический
soikea	овальный
viittaa	подразумевает
ser	сер
arviointi	оценка
näkymä	перспектива
maantieteellinen	географический
luovuttaja	донор
jännitys	напряженность
roska	мусор
muodot	формы
porras	ярус
jaarli	граф
kotimaa	Родина
mestaruutta	чемпионаты
rodut	породы
disko	дискотека
aus	AUS
viimeistely	отделка
tunteet	эмоции
ikuinen	вечный
kierto	вращение
nam	Нама
tuottava	продуктивный
bulevardi	бульвар
sika	свинья
metrinen	метрический
seuraamukset	штрафы
monipuolinen	разнообразный
grande	Гранди
näyttelijä	актриса
luovuttaa	назначать
majoittaa	вмещать
Tiikerit	тигры
kyliä	деревни
sävy	тень
kertosäe	хор
rytmi	ритм
numero	цифра
sinfonia	симфония
äkillinen	внезапно
hyväksymisestä	принимающий
altaat	бассейны
lyyrinen	лирический
eristäminen	изоляция
nopeudet	скорость
jatkuva	устойчивый
Hyväksytty	соответствие
lähentää	приближенный
köysi	веревка
järkevä	рациональный
ohjelmoija	программист
taistelijat	боевики
peritty	унаследованный
epätäydellinen	неполный
laulu	вокал
suihkulähde	фонтан
laillinen	законный
elämäkerrat	биографии
tutkija	следователь
kantaja	истец
lempeä	нежный
arvokas	достойный
arkkitehdit	архитекторы
pyhimykset	святые
yrittäjä	предприниматель
kuljettaa	осуществляет
duo	дуэт
liiallinen	чрезмерное
säästää	экономит
pitää	рассматривать
arvostus	оценка
odottamaton	неожиданный
sumu	туман
luonteenomainen	характеристика
aula	лобби
hahmoteltu	изложены
valtava	огромный
karma	карма
muodostuvat	состоять
kuningattaret	Квинс
tutkijoita	ученые
heimot	племена
ero	различие
vaarat	опасность
vapautus	освобождение
vuokralainen	арендатор
kestävyys	устойчивость
tatuointi	тату
algebra	алгебра
varjot	тени
typerä	глупый
vapaasti	свободно
lievä	мягкий
turkis	мех
helposti	легко
kuuluminen	присоединение
aita	забор
ääretön	бесконечный
klaani	клан
vallankumouksellinen	революционер
ranneketta	браслеты
parannuskeino	средство
hengittäminen	дыхание
lyhyesti	кратко
paksuus	толщина
graafinen	графический
nero	гениальность
keskustella	обсуждение
taistelija	истребитель
mielekäs	значимым
muokattu	адаптированный
säädyt	усадеб
matto	коврик
demokraatti	демократ
kauppala	район
ylläpitää	поддерживает
ka	ка
säilytetään	сохраняется
marmori	мрамор
dem	дем
meditaatio	медитация
mikrofoni	микрофон
Yhdistämällä	объединение
jättiläiset	гиганты
organisointi	организация
muistio	меморандум
kinkku	ветчина
ratkaistu	решена
vuorovesi	волна
väliseinä	раздел
näkymätön	невидимый
konsolit	консоли
magneetti	магнит
käännökset	переводы
jaguaari	ягуар
hyödyke	товар
kilometriä	километров
takeita	гарантии
gotiikka	готика
sylinteri	цилиндр
noita	ведьма
pukki	доллар
viholliset	враги
konsultointi	консультирование
nauttii	наслаждаясь
partio	патруль
haju	запах
karnevaali	карнавал
karkeasti	грубо
tarra	наклейка
lupauksia	обещания
riutta	риф
jakaa	делить
peräkkäinen	последовательный
Bon	бон
esitykset	представления
chan	чан
sävelet	мелодии
mas	Рождество
lausekkeet	фразы
kai	кай
niemimaa	полуостров
tylsää	скучный
dom	дом
puheet	речи
saavuttaa	достигает
kaavio	схема
luettelot	каталоги
ministeriöiden	министерства
parlamentin	парламентский
etuliite	префикс
savanni	саванна
tynnyri	бочка
hermo	нерв
dans	данс
planeetat	планеты
alijäämä	дефицит
uudistaa	возобновлять
kytketty	соединенный
piirit	схемы
rakenne	текстура
tunnustaa	признавать
teltta	палатка
tunnistaa	определяет
pätevyys	квалификация
lukot	замки
miniatyyri	миниатюрный
euroa	евро
merirosvot	пираты
antenni	антенна
haukka	ястреб
seuraus	следствие
systemaattinen	систематическая
koettu	воспринимается
alkuperä	происхождения
palkattu	наемный
meikki	составить
ui	щ
painot	веса
geologinen	геологический
kestävä	прочный
paha	злой
esittelee	вводит
työntää	толкнул
ro	ро
rinne	скат
runoilija	поэт
salaliitto	заговор
teologia	теология
kynnet	ногти
ilmeinen	очевидный
ratsastaa	аттракционы
eeppinen	эпический
järjestäjä	организатор
allergia	аллергия
vuoksi	ради
yhdistelmät	комбинации
edeltävä	предшествующий
ansio	заслуга
entsyymi	фермент
lentokoneita	самолеты
levyt	диски
vahvistin	усилитель
mielivaltainen	произвольный
näkyvä	видный
sans	без
rakentaa	строит
yhteyttä	связаться
akseli	вал
nojata	опираться
satunnainen	случайный
innovaatiot	инновации
tarkistetaan	рассмотрение
paniikki	паника
kansalaisuus	гражданство
tekosyy	оправдание
uudistuksia	реформы
sipuli	лук
voileipä	сэндвич
altto	альт
hierarkia	иерархия
hylätty	заброшенный
piireissä	круги
lyöntiä	биения
iloinen	веселый
kultti	культ
kojelauta	тир
passiivinen	пассивный
arvostettu	ценный
häkki	клетка
rohkeus	мужество
korkeus	высота
kierros	круг
käyttö	использование
juomat	напитки
ping	пинг
viihteellinen	развлекательный
edellytys	предпосылка
raja	граница
pakolaisten	беженцы
ritarit	рыцари
hypoteesi	гипотеза
lääkkeet	медикаменты
muuttunut	изменено
oppi	учение
luonnonkaunis	сценический
parannuksia	улучшения
leikkauspiste	пересечение
ompelu	шитье
keräilijät	коллекторы
tunnistettu	признанное
raivo	ярость
prix	Приза
astrologia	астрология
neuvonantajat	консультанты
paviljonki	павильон
taktiikka	тактика
täydentäviä	дополнительный
lahjakas	талантливый
tyyny	подушка
leviäminen	распространение
maakunnat	провинция
varastaa	украсть
paketti	пакет
esiintyvyys	падение
pelot	боится
ennustaa	прогнозировать
maku	аромат
nälkäinen	голодный
metallinen	металлический
häiriö	интерференция
soturit	воины
ilmakehän	атмосферный
sädekehä	гало
vanhempien	родительский
viitattu	ссылка
lakkoja	забастовки
muurahainen	муравей
ehdotus	предложение
osuva	склонный
käsitelty	дело
kauppias	трейдер
heitetään	выброшены
kriteeri	критерий
kunniamerkki	значок
sivistys	цивилизация
nummi	вереск
valtava	огромный
suorittaa	выполняет
valtakunta	область
korjattu	исправленный
kypärä	шлем
kohdanneet	встречается
tsunami	цунами
tutkija	ученый
ympäröimä	окруженный
geologia	геология
oliot	существа
selvitetty	очищается
suorittaa	выполнять
kulmat	углы
kasvissyöjä	вегетарианец
hiiva	дрожжи
pas	па
tutkitaan	исследовалась
suurlähettiläs	посол
päällystetty	покрытый
tuho	гибель
rutiinit	подпрограммы
olentoja	существа
riippuvuus	опора
myytti	миф
puro	ручей
fu	марихуана
ilmiö	явление
kokonaisuus	ансамбль
varma	уверенный
tajuissaan	сознательный
aksentti	акцент
vaimot	жены
käyttää	использовать
pantti	залог
vampyyri	вампир
telakka	док
järjestetty	организованная
muusikko	музыкант
rajoittamalla	ограничения
palautettu	восстановлен
vihje	намек
panssari	броня
huomautus	замечание
kymmeniä	множество
vaihtelee	меняется
perustelut	рассуждения
vartijat	гвардия
aukot	отверстия
korvaa	замена
tutkija	Исследователь
valtuustot	советы
Ammatit	профессий
tunnustettu	признанный
sianliha	свинина
zu	цу
tasapaino	равновесие
putket	трубы
mökit	коттеджи
yhdistää	сливаться
etuoikeus	привилегия
kehittyy	развивается
alusta	шасси
arvio	оценка
lato	сарай
halla	мороз
laitokset	институты
muotti	плесень
rouva	дама
jahti	яхта
mieluummin	предпочитает
poraus	бурение
yrtti	трава
rikkominen	нарушение
valas	кит
matkustaja	путешественник
määrärahat	ассигнования
epäillään	подозреваемый
tomaatit	помидоры
ohjaajien	инструкторы
vauhti	импульс
evä	плавник
pastori	пастор
muta	грязи
smaragdi	изумруд
kasvaa	растет
alue	тракт
ul	уль
baletti	балет
toimittaja	журналист
uskonnot	религии
valkosipuli	чеснок
paistaa	блеск
räjähdys	взрыв
alushousut	трусы
allekirjoituksia	подписи
otsoni	озон
tieteenalojen	дисциплины
Casa	Каса
keskustelut	разговоры
radiot	радио
tulli	тариф
yksinkertaistettu	упрощенный
lihakset	мышцы
nopea	быстрый
emätin	влагалище
samppanja	шампанское
poikkeama	отклонение
samba	самба
käyttää	использовать
pingviini	пингвин
maaginen	волшебный
vaikutteita	влияет
tarkastukset	инспекции
kastelu	орошение
ihme	чудо
hydraulinen	гидравлический
tunkeutuminen	проникновение
haava	рана
kaunotar	красавица
rosa	Роза
vakaumus	убеждение
laiska	ленивый
ominaisuudet	качества
isät	отцы
latauksen	зарядка
merkittävästi	важно
siro	маленькая
laitteet	устройство
maasto	местность
selitetään	объясняя
nauhat	полоски
nimitys	назначение
empiirinen	эмпирический
mato	червь
riippuvuus	зависимость
erillinen	дискретный
aloittelija	начинающий
kansi	крышка
seksuaalisuus	сексуальность
safiiri	сапфир
etuoikeudet	привилегии
erikoistunut	специализация
merkki	маркировка
seriffi	шериф
vähentynyt	отказался
vakoojia	шпионы
moottoripyörät	мотоциклы
valita	избранные
valtatiet	шоссе
keskittää	концентрат
intiimi	интимный
molekyylit	молекулы
kierrosta	туры
jääkaappi	холодильник
väliajoin	интервалы
lauseet	предложения
holokausti	истребление
lentäjä	листовка
herneet	горох
annostus	дозировка
vaihtelu	дисперсия
Navigator	навигатор
neula	игла
kylpylä	баня
jarrut	тормоза
og	ог
tyrmäys	ко
omistaa	владеет
kohtalo	судьба
Maisemat	пейзажи
laskeminen	вычисление
heinä	сено
pelastus	спасение
ennustukset	прогнозы
oppijat	учащихся
symbolinen	знак
sinkki	цинк
uhrata	жертва
etsijät	искатели
guru	гуру
sopiva	подходящий
numeerinen	числовой
antropologia	антропология
keisari	император
Grad	град
vyöt	ремни
mustat	негры
sivistynyt	образованный
ylpeänä	гордо
välttämättömyys	необходимость
käyrät	кривые
farmari	туризм
kärki	вершина
tomaatti	помидор
matkustaa	путешествия
kalpea	бледный
toiminta	функционирование
talouksien	экономики
sitoutuvat	предпринимать
julistaa	объявлять
venttiilit	клапаны
aukkoja	пробелы
saavutukset	достижения
repiä	слеза
opettaa	учит
nolla	ноль
muukalainen	незнакомец
pesä	гнездо
tuomioistuin	суд
sulkea	правил
eläkkeet	пенсии
rukoukset	молитвы
poliisi	полицейский
nuori	подросток
ehdokkaat	номинации
banaani	банан
alustava	вводный
varasto	резервуар
esiintyminen	вхождение
idoli	идол
verinen	кровавый
muistuttaa	напоминать
viehättävä	обаятельный
hammas	зуб
arvostettu	уважаемый
pysyy	остается
asia	дело
rajoittaa	ограничивать
kaivokset	мины
muotokuvia	портреты
tulkita	интерпретированы
arvioinnit	оценки
eliminointi	устранение
metriä	метры
hypoteettinen	гипотетический
helikopteri	вертолет
lyijykynä	карандаш
esiintyjä	исполнитель
palkkiot	комиссии
pallo	сфера
sammal	мох
suhteet	коэффициенты
sopu	созвучие
porrastettu	закончил
hyväksyttiin	одобрил
yllättävä	удивительный
peitsi	копье
tikapuut	лестница
korkki	пробка
senaattorit	сенаторы
verenvuoto	кровотечение
luonnehdinta	характеристика
todennäköisyys	вероятность
kaistat	полосы
perusteet	основы
saastuminen	загрязнение
kupoli	купол
siunata	благословить
neuvottelu	Переговоры
harja	гребень
vastustajat	соперники
riemuvoitto	триумф
nimitetty	номинирована
hitsaus	сварка
orgasmi	оргазм
metalliseos	сплав
tontteja	участки
kevyesti	осторожно
lukitus	блокировка
kiistanalainen	спорный
kiinnittää	рисует
jääkaappi	холодильник
terät	лезвия
silmukoita	петли
aalto	волна
trauma	травма
ilmoitus	объявление
puolustava	оборонительный
kielletty	запрещено
vanilja	ваниль
ohjelmoijat	программисты
seurataan	контролируемый
laitteistot	сооружения
sielut	души
motivoitunut	мотивировано
tyhmä	тупой
ontto	полый
holvi	свод
ura	паз
paljastus	откровение
pyrkimys	преследование
valtuuskunta	делегация
johdot	провода
sanakirjoja	словари
läpinäkyvyys	прозрачность
kiertorata	орбита
valuutat	валюты
Niger	Нигер
paikannus	позиционирование
siirtomaa	колония
tykki	пушка
sirkus	цирк
ylennetty	способствовало
taimen	форель
saavutus	подвиг
väliaikaisesti	временно
valmistettu	приготовленный
lähettää	передавать
taajuudet	частоты
ajatukset	размышления
nälkä	голод
kunta	муниципалитет
etsivä	детектив
sementti	цемент
kokee	испытывают
takka	камин
merkintä	поддержка
tekstiilit	текстиль
ohjus	ракета
psykiatria	психиатрия
avustaa	помогает
tilintarkastaja	аудитор
viulu	скрипка
profeetta	пророк
oksidi	окись
upea	великолепный
viipymättä	быстро
sovittaminen	приспособление
haitallinen	вредный
seksuaalisesti	сексуально
liite	ограда
glukoosi	глюкоза
normi	норма
toisto	воспроизведение
kilpikonna	черепаха
etäisyydet	расстояния
imeytyminen	поглощение
aarteita	сокровища
fossiili	ископаемое
huonosti	плохо
kommunistinen	коммунист
yrittäjät	предприниматели
robotit	роботы
virhe	фол
biodiversiteetti	биоразнообразия
jännitys	волнение
sanallinen	словесный
meret	моря
salaperäinen	загадочный
uutuus	новинка
laatat	плитка
kirjastonhoitaja	библиотекарь
kytketty	переключился
ru	RU
aiheuttaa	поза
grammaa	граммов
terapeutti	Терапевт
budjetit	бюджеты
vuohi	козел
tehdä	оказывать
purjehtia	паруса
komissaarit	комиссары
tiheä	плотный
urhea	Храбрый
huolinta	пересылка
hirveä	ужасный
lentokone	самолет
organismit	микроорганизмы
teleskooppi	телескоп
asbesti	асбест
edistäminen	продвижение
paju	ива
jatkuu	резюме
olemassa	существовавший
generaattorit	генераторы
synnyttää	генерирует
perunat	картофель
perusteellinen	тщательный
reseptorit	рецепторы
optimaalinen	оптимальный
olento	существо
yksinäinen	одинокий
hienovarainen	тонкий
raidat	полосы
firmware	прошивка
paimen	пасти
kehto	колыбель
liittokansleri	канцлер
jauhot	мука
kiista	полемика
legendaarinen	легендарный
kuoro	хор
välttää	избегая
kauniisti	красиво
odottaa	надеется
hyppy	прыжки
kankaat	ткань
polymeeri	полимер
hygienia	гигиена
hyve	добродетель
kirurgit	хирурги
mandaatti	мандат
corpus	тело
terminologia	терминология
herrasmies	джентльмен
tuomittu	осужденный
suihkukoneet	струи
indeksit	индексы
qui	Квай
uhkaava	угрожающий
aktivistit	активисты
vanki	заключенный
kannustaa	призывает
koolla	собранный
terminaalit	терминалы
raaka	сырой
tutkii	осматривает
viikinki	викинг
siivota	уборка
ehdollinen	условный
hyökkäsi	атакован
saapuu	прибывает
kääntäjä	переводчик
autojen	автомобили
traktori	трактор
maanosa	континент
hintoja	тарифы
pituusaste	долгота
toivoneet	надеялся
lisäys	вставка
rajoite	ограничение
vahvistaminen	укрепление
haluaa	желающих
eristys	изоляция
rikkominen	нарушение
taipunut	изогнутый
subjektiivinen	субъективный
hirviöt	монстры
turvapaikka	убежище
panos	доля
cocktail	коктейль
lajikkeet	сорта
myrkyttää	яд
hallitsi	доминировал
kallis	дорогостоящий
johdannaiset	производные
estää	предотвращает
kivääri	винтовка
rasismi	расизм
tulkita	интерпретировать
sopimus	согласие
vaatimaton	скромный
pelaajat	геймеров
lajittelu	сортировка
yhteys	связь
sipulit	луковицы
turistit	туристы
käyttäytymistä	поведения
selventää	прояснить
vyötärö	Талия
johtuvan	приписаны
pöllö	сова
kiteet	кристаллы
ylittää	превышает
täydentävä	дополнительный
taistelut	сражения
katkera	горький
muistio	меморандум
lohikäärmeitä	драконы
melu	шум
uskomattoman	невероятно
osanottajaa	делегаты
psykiatrinen	психиатрический
nuoret	подростков
piha	двор
presidentit	президенты
lähteä	отходить
nimenomaan	специально
lilja	Лили
erehdys	надзор
hartsi	смола
liittoutuneet	союзники
säilytetty	сохраняется
ristissä	пересекла
nouseva	Восходящий
nimellinen	номинальный
rappeutuminen	распад
kvartsi	кварц
rekisterit	регистры
kahdeksas	восьмой
valtuutettu	уполномоченный
parantaa	улучшает
kannattaa	адвокаты
ilmiöitä	явления
kallistaa	наклон
graniitti	гранит
massat	массы
urheilija	спортсмен
frangi	франк
samankaltaisuus	сходство
vuotaa	утечка
neuvonantaja	консультант
kirjanen	буклет
odottaa	ожидая
liikevaihto	оборот
virtsa	моча
pyyhe	полотенце
inkivääri	имбирь
kromosomi	хромосома
als	ALS
kärpäset	летит
pätevyys	компетентность
huutava	плач
amatöörit	любители
nosturi	кран
tutkii	расследование
mätä	гнилой
tapa	привычка
kunnia	честь
suojaa	защищает
iiris	Ирис
hallinnoi	управляет
eroosio	эрозия
puuseppä	столяр
kaani	хан
riittämätön	недостаточное
muotoilu	формулировка
taitava	умная
ylähuone	лорды
nautittava	приятный
puolikuu	полумесяц
kuusikymmentä	шестьдесят
keskitetty	концентрированный
erottaa	выделить
EI	й
ennusteet	прогнозы
kipinä	искра
turvaaminen	обеспечение
polku	путь
ilmaisimet	детекторы
piikki	колос
ainesosa	ингредиент
verho	занавес
julkaisussa	раскрытый
taktinen	тактический
lentäjät	пилоты
retkikunta	экспедиция
operatiivinen	оперативный
huumori	юмор
mol	моль
jälki	отпечаток
avustaminen	содействие
vika	дефект
huonosti	плохо
jumalatar	богиня
tarkkailijat	наблюдателей
magneetit	магниты
kaavat	формулы
tilava	просторный
väittää	утверждает
maaperä	почвы
elimet	органы
det	йе
uskollisuus	лояльность
luotettava	верный
rikkomus	преступление
litium	литий
harppaus	прыжок
perustamisen	учредительный
joutsen	лебедь
istutus	насаждение
liitto	завет
arkeologia	археология
merimies	матрос
huolet	заботы
pyhäkkö	святилище
patsas	статуя
lainaus	цитата
suurten	майоров
manipulointi	манипуляция
kelloja	колокольчики
myrkyllisyys	токсичность
lähetin	передатчик
lähiöissä	окрестности
palkinto	трофей
tunne	эмоция
nähtävyydet	Достопримечательности
univormut	униформа
haavoittunut	раненый
johdannainen	производное
käyttöaste	размещение
annokset	дозы
kouluttaa	воспитывать
ennakkoluulo	предубеждение
teknikot	техники
todennäköinen	вероятный
liikkeeseen	выдача
koriste	украшение
kansalaisten	граждане
troijalainen	троянский
avustajat	ассистенты
neuvonantaja	консультант
sääti	принятый
epävakaa	неустойчивый
kehotti	настоятельно
heijastava	отражающий
saamassa	получение
lopullinen	окончательный
matkusti	путешествовал
sopeuttaa	адаптироваться
liittymistä	присоединение
säädin	регулятор
polttoaineet	топливо
soija	соя
siisti	аккуратный
nimeäminen	именование
perä	кормовой
muotoillun	проработаны
idiootti	идиот
käsitti	состоит
ulkomaalaisten	инопланетяне
muokkaukset	правки
korppi	вороной
asunto	жилье
symbolinen	символический
kulmat	углы
paineet	давление
Venus	Венера
liekit	огонь
primitiivinen	примитивный
sukka	чулок
ekosysteemi	экосистема
hallit	залы
yksinkertaisuus	простота
demoni	демон
tyytyväinen	приветствовал
merkintätapa	обозначение
täti	тетка
varis	ворона
semanttinen	семантический
lopetettu	прекращено
päättää	решает
globalisaatio	глобализация
aasit	ослы
kompassi	компас
kehittynyt	эволюционировали
jalkaväki	пехота
kuuluisa	прославленный
käytävä	коридор
filosofinen	философский
oikeutus	обоснование
vapaa	вакантный
vahvistamisesta	фиксация
gramma	грамм
piilossa	прячется
väriaine	краситель
aakkoset	алфавит
puhdistettu	очищенный
kunnioitettava	заслуженный
optinen	оптический
puhelimet	телефоны
päiväkirjat	дневников
suru	горе
hiki	пот
delfiini	дельфин
ihmeitä	чудеса
ilmanvaihto	вентиляция
maskit	маски
rintakuva	бюст
kuja	аллея
reittejä	путей
lennätin	телеграф
monumentti	памятник
muodollisesti	формально
kaste	роса
peruutettu	отозваны
keskustelut	дебаты
identiteetit	тождества
puute	дефицит
satula	седло
malaria	малярия
uskollinen	верный
suuntaus	тенденция
hyödynnetty	используется
ein	Эйн
kiikari	бинокль
aloittaa	инициировать
puhtaasti	чисто
eloisa	яркий
väitteitä	утверждения
vastaa	соответствует
demoni	демон
juhlittu	знаменитый
metsästäjät	охотники
toimi	действовал
kerroin	коэффициент
kallo	череп
jatkaminen	продолжение
palvelija	служащий
haukka	сокол
yhdessä	совместно
välttää	избегать
selitykset	объяснения
uudistunut	обновленный
kriitikko	критик
sedimentti	отстой
neliöt	квадраты
pakettiautot	фургоны
kartio	конус
selviytyi	переживший
yleisyys	распространенность
kappale	фрагмент
sitoutuu	совершает
kobra	кобра
heitti	бросил
hoc	специальная
esiintyjät	исполнители
jälkiruoka	Десерт
väitöskirja	диссертация
yhdeksäs	девятый
innostusta	энтузиазм
juhlia	празднования
kuvernöörit	губернаторы
atomia	атомы
kudokset	тканей
ramppi	скат
kauniisti	мило
della	делла
ylivalta	доминирование
sointuja	аккорды
vajaatoiminta	нарушение
molekyyli	молекула
